,合约,日期,前收盘价,前结算价,开盘价,最高价,最低价,收盘价,结算价,涨跌1,涨跌2,成交量,成交金额,持仓量
1,p1501,20150105,4898,4852,4880,4880,4800,4816,4828,-36,-24,1262,60954560,15166
2,p1501,20150106,4816,4828,0,0,0,4828,4828,0,0,0,0,15166
3,p1501,20150107,4828,4828,4820,4832,4820,4824,4828,-4,0,222,10720520,15004
4,p1501,20150108,4824,4828,4828,4906,4828,4906,4884,78,56,100,4884840,15004
5,p1501,20150109,4906,4884,4830,4900,4830,4900,4894,16,10,162,7928760,14842
6,p1501,20150112,4900,4894,0,0,0,4894,4894,0,0,0,0,14842
7,p1501,20150113,4894,4894,0,0,0,4894,4894,0,0,0,0,14842
8,p1501,20150114,4894,4894,4820,4820,4820,4820,4820,-74,-74,230,11086000,14842
9,p1501,20150115,4820,4820,4760,4760,4760,4760,4760,-60,-60,2,95200,14840
10,p1501,20150116,4760,4760,4756,4756,4756,4756,4836,-4,76,14,665840,0
11,p1502,20150105,4996,4996,0,0,0,4972,4972,-24,-24,0,0,6
12,p1502,20150106,4972,4972,0,0,0,4972,4972,0,0,0,0,6
13,p1502,20150107,4972,4972,5162,5162,4852,5012,5012,40,40,8,400960,6
14,p1502,20150108,5012,5012,0,0,0,5070,5070,58,58,0,0,6
15,p1502,20150109,5070,5070,0,0,0,5080,5080,10,10,0,0,6
16,p1502,20150112,5080,5080,5240,5240,5240,5240,5240,160,160,2,104800,6
17,p1502,20150113,5240,5240,5032,5032,5032,5032,5032,-208,-208,2,100640,6
18,p1502,20150114,5032,5032,5028,5028,4832,4832,4930,-200,-102,8,394400,2
19,p1502,20150115,4832,4930,4746,4746,4746,4746,4746,-184,-184,2,94920,2
20,p1502,20150116,4746,4746,0,0,0,4820,4820,74,74,0,0,2
21,p1502,20150119,4820,4820,5010,5010,5010,5010,5010,190,190,2,100200,0
22,p1502,20150120,5010,5010,0,0,0,5010,5010,0,0,0,0,0
23,p1502,20150121,5010,5010,0,0,0,5010,5010,0,0,0,0,0
24,p1502,20150122,5010,5010,0,0,0,5010,5010,0,0,0,0,0
25,p1502,20150123,5010,5010,0,0,0,5010,5010,0,0,0,0,0
26,p1502,20150126,5010,5010,0,0,0,5010,5010,0,0,0,0,0
27,p1502,20150127,5010,5010,0,0,0,5010,5010,0,0,0,0,0
28,p1502,20150128,5010,5010,0,0,0,5010,5010,0,0,0,0,0
29,p1502,20150129,5010,5010,0,0,0,5010,5010,0,0,0,0,0
30,p1502,20150130,5010,5010,0,0,0,5010,5010,0,0,0,0,0
31,p1502,20150202,5010,5010,0,0,0,5010,5010,0,0,0,0,0
32,p1502,20150203,5010,5010,0,0,0,5010,5010,0,0,0,0,0
33,p1502,20150204,5010,5010,0,0,0,5010,5010,0,0,0,0,0
34,p1502,20150205,5010,5010,0,0,0,5010,5010,0,0,0,0,0
35,p1502,20150206,5010,5010,0,0,0,5010,5010,0,0,0,0,0
36,p1502,20150209,5010,5010,0,0,0,5010,5010,0,0,0,0,0
37,p1502,20150210,5010,5010,0,0,0,5010,5010,0,0,0,0,0
38,p1502,20150211,5010,5010,0,0,0,5010,5010,0,0,0,0,0
39,p1502,20150212,5010,5010,0,0,0,5010,5010,0,0,0,0,0
40,p1502,20150213,5010,5010,0,0,0,5010,5010,0,0,0,0,0
41,p1503,20150105,5084,5084,0,0,0,5060,5060,-24,-24,0,0,14
42,p1503,20150106,5060,5060,0,0,0,5060,5060,0,0,0,0,14
43,p1503,20150107,5060,5060,0,0,0,5100,5100,40,40,0,0,14
44,p1503,20150108,5100,5100,0,0,0,5158,5158,58,58,0,0,14
45,p1503,20150109,5158,5158,0,0,0,5168,5168,10,10,0,0,14
46,p1503,20150112,5168,5168,0,0,0,5330,5330,162,162,0,0,14
47,p1503,20150113,5330,5330,5118,5118,5118,5118,5118,-212,-212,2,102360,14
48,p1503,20150114,5118,5118,0,0,0,5016,5016,-102,-102,0,0,14
49,p1503,20150115,5016,5016,0,0,0,4830,4830,-186,-186,0,0,14
50,p1503,20150116,4830,4830,0,0,0,4946,4946,116,116,0,0,14
51,p1503,20150119,4946,4946,0,0,0,5140,5140,194,194,0,0,14
52,p1503,20150120,5140,5140,4960,4960,4960,4960,4960,-180,-180,2,99200,14
53,p1503,20150121,4960,4960,0,0,0,4960,4960,0,0,0,0,14
54,p1503,20150122,4960,4960,0,0,0,4960,4960,0,0,0,0,14
55,p1503,20150123,4960,4960,5076,5076,5004,5004,5040,44,80,4,201600,18
56,p1503,20150126,5004,5040,4984,4984,4984,4984,4984,-56,-56,2,99680,18
57,p1503,20150127,4984,4984,4962,5038,4960,5030,4996,46,12,8,399800,16
58,p1503,20150128,5030,4996,4900,4900,4900,4900,4900,-96,-96,2,98000,16
59,p1503,20150129,4900,4900,0,0,0,4900,4900,0,0,0,0,16
60,p1503,20150130,4900,4900,4720,4758,4720,4748,4742,-152,-158,6,284520,14
61,p1503,20150202,4748,4742,4796,4796,4796,4796,4796,54,54,2,95920,14
62,p1503,20150203,4796,4796,0,0,0,4846,4846,50,50,0,0,14
63,p1503,20150204,4846,4846,0,0,0,4856,4856,10,10,0,0,14
64,p1503,20150205,4856,4856,0,0,0,4910,4910,54,54,0,0,14
65,p1503,20150206,4910,4910,5048,5050,5008,5050,5034,140,124,6,302120,10
66,p1503,20150209,5050,5034,0,0,0,5034,5034,0,0,0,0,10
67,p1503,20150210,5034,5034,5034,5034,5032,5032,5032,-2,-2,10,503360,14
68,p1503,20150211,5032,5032,0,0,0,5032,5032,0,0,0,0,14
69,p1503,20150212,5032,5032,0,0,0,5032,5032,0,0,0,0,14
70,p1503,20150213,5032,5032,0,0,0,5032,5032,0,0,0,0,14
71,p1503,20150216,5032,5032,0,0,0,5032,5032,0,0,0,0,14
72,p1503,20150217,5032,5032,0,0,0,5032,5032,0,0,0,0,14
73,p1503,20150225,5032,5032,4824,4824,4822,4822,4822,-210,-210,4,192920,10
74,p1503,20150226,4822,4822,0,0,0,4850,4850,28,28,0,0,10
75,p1503,20150227,4850,4850,4850,4850,4750,4750,4816,-100,-34,6,289000,4
76,p1503,20150302,4750,4816,0,0,0,4816,4816,0,0,0,0,4
77,p1503,20150303,4816,4816,0,0,0,4816,4816,0,0,0,0,4
78,p1503,20150304,4816,4816,0,0,0,4816,4816,0,0,0,0,4
79,p1503,20150305,4816,4816,0,0,0,4816,4816,0,0,0,0,4
80,p1503,20150306,4816,4816,0,0,0,4816,4816,0,0,0,0,4
81,p1503,20150309,4816,4816,0,0,0,4816,4816,0,0,0,0,4
82,p1503,20150310,4816,4816,0,0,0,4900,4900,84,84,0,0,4
83,p1503,20150311,4900,4900,0,0,0,4900,4900,0,0,0,0,4
84,p1503,20150312,4900,4900,4900,4900,4900,4900,4900,0,0,4,196000,0
85,p1503,20150313,4900,4900,0,0,0,4900,4900,0,0,0,0,0
86,p1504,20150105,5086,5134,0,0,0,5110,5110,-24,-24,0,0,8
87,p1504,20150106,5110,5110,5044,5044,5044,5044,5044,-66,-66,2,100880,10
88,p1504,20150107,5044,5044,5060,5060,5060,5060,5060,16,16,2,101200,8
89,p1504,20150108,5060,5060,5098,5098,5060,5060,5080,0,20,18,914600,6
90,p1504,20150109,5060,5080,0,0,0,5080,5080,0,0,0,0,6
91,p1504,20150112,5080,5080,0,0,0,5080,5080,0,0,0,0,6
92,p1504,20150113,5080,5080,5024,5024,5024,5024,5024,-56,-56,2,100480,8
93,p1504,20150114,5024,5024,0,0,0,4924,4924,-100,-100,0,0,8
94,p1504,20150115,4924,4924,4948,4948,4948,4948,4948,24,24,4,197920,4
95,p1504,20150116,4948,4948,0,0,0,4948,4948,0,0,0,0,4
96,p1504,20150119,4948,4948,4930,4930,4930,4930,4930,-18,-18,2,98600,4
97,p1504,20150120,4930,4930,4960,4960,4960,4960,4960,30,30,2,99200,4
98,p1504,20150121,4960,4960,0,0,0,4956,4956,-4,-4,0,0,4
99,p1504,20150122,4956,4956,0,0,0,4956,4956,0,0,0,0,4
100,p1504,20150123,4956,4956,0,0,0,5034,5034,78,78,0,0,4
101,p1504,20150126,5034,5034,0,0,0,4980,4980,-54,-54,0,0,4
102,p1504,20150127,4980,4980,0,0,0,4990,4990,10,10,0,0,4
103,p1504,20150128,4990,4990,4810,4872,4810,4872,4840,-118,-150,4,193640,4
104,p1504,20150129,4872,4840,4824,4824,4824,4824,4824,-16,-16,2,96480,6
105,p1504,20150130,4824,4824,4662,4698,4632,4632,4664,-192,-160,6,279840,4
106,p1504,20150202,4632,4664,0,0,0,4716,4716,52,52,0,0,4
107,p1504,20150203,4716,4716,0,0,0,4716,4716,0,0,0,0,4
108,p1504,20150204,4716,4716,4820,4820,4820,4820,4820,104,104,2,96400,2
109,p1504,20150205,4820,4820,4800,4800,4772,4772,4786,-48,-34,4,191440,2
110,p1504,20150206,4772,4786,4810,4810,4810,4810,4810,24,24,12,577200,12
111,p1504,20150209,4810,4810,4828,4830,4828,4830,4828,20,18,4,193160,12
112,p1504,20150210,4830,4828,4868,4920,4816,4920,4864,92,36,26,1264640,4
113,p1504,20150211,4920,4864,0,0,0,4864,4864,0,0,0,0,4
114,p1504,20150212,4864,4864,0,0,0,4864,4864,0,0,0,0,4
115,p1504,20150213,4864,4864,0,0,0,4864,4864,0,0,0,0,4
116,p1504,20150216,4864,4864,0,0,0,4864,4864,0,0,0,0,4
117,p1504,20150217,4864,4864,0,0,0,4864,4864,0,0,0,0,4
118,p1504,20150225,4864,4864,4800,4800,4800,4800,4800,-64,-64,4,192000,0
119,p1504,20150226,4800,4800,0,0,0,4800,4800,0,0,0,0,0
120,p1504,20150227,4800,4800,0,0,0,4768,4768,-32,-32,0,0,0
121,p1504,20150302,4768,4768,0,0,0,4768,4768,0,0,0,0,0
122,p1504,20150303,4768,4768,0,0,0,4768,4768,0,0,0,0,0
123,p1504,20150304,4768,4768,0,0,0,4768,4768,0,0,0,0,0
124,p1504,20150305,4768,4768,0,0,0,4768,4768,0,0,0,0,0
125,p1504,20150306,4768,4768,0,0,0,4768,4768,0,0,0,0,0
126,p1504,20150309,4768,4768,0,0,0,4768,4768,0,0,0,0,0
127,p1504,20150310,4768,4768,0,0,0,4768,4768,0,0,0,0,0
128,p1504,20150311,4768,4768,0,0,0,4768,4768,0,0,0,0,0
129,p1504,20150312,4768,4768,0,0,0,4768,4768,0,0,0,0,0
130,p1504,20150313,4768,4768,0,0,0,4768,4768,0,0,0,0,0
131,p1504,20150316,4768,4768,4958,4958,4780,4788,4852,20,84,10,485360,0
132,p1504,20150317,4788,4852,0,0,0,4852,4852,0,0,0,0,0
133,p1504,20150318,4852,4852,0,0,0,4852,4852,0,0,0,0,0
134,p1504,20150319,4852,4852,0,0,0,4852,4852,0,0,0,0,0
135,p1504,20150320,4852,4852,0,0,0,4852,4852,0,0,0,0,0
136,p1504,20150323,4852,4852,4754,4898,4754,4898,4826,46,-26,8,386080,0
137,p1504,20150324,4898,4826,0,0,0,4826,4826,0,0,0,0,0
138,p1504,20150325,4826,4826,0,0,0,4826,4826,0,0,0,0,0
139,p1504,20150326,4826,4826,0,0,0,4826,4826,0,0,0,0,0
140,p1504,20150327,4826,4826,0,0,0,4826,4826,0,0,0,0,0
141,p1504,20150330,4826,4826,0,0,0,4826,4826,0,0,0,0,0
142,p1504,20150331,4826,4826,0,0,0,4826,4826,0,0,0,0,0
143,p1504,20150401,4826,4826,0,0,0,4826,4826,0,0,0,0,0
144,p1504,20150402,4826,4826,0,0,0,4826,4826,0,0,0,0,0
145,p1504,20150403,4826,4826,0,0,0,4826,4826,0,0,0,0,0
146,p1504,20150407,4826,4826,0,0,0,4826,4826,0,0,0,0,0
147,p1504,20150408,4826,4826,0,0,0,4826,4826,0,0,0,0,0
148,p1504,20150409,4826,4826,0,0,0,4826,4826,0,0,0,0,0
149,p1504,20150410,4826,4826,0,0,0,4826,4826,0,0,0,0,0
150,p1504,20150413,4826,4826,0,0,0,4826,4826,0,0,0,0,0
151,p1504,20150414,4826,4826,0,0,0,4826,4826,0,0,0,0,0
152,p1504,20150415,4826,4826,0,0,0,4826,4826,0,0,0,0,0
153,p1505,20150105,5078,5074,5048,5052,4982,5006,5020,-68,-54,240460,12074116720,532642
154,p1505,20150106,5006,5020,5000,5050,4984,5038,5022,18,2,393316,19754499640,525292
155,p1505,20150107,5038,5022,5040,5066,5004,5026,5032,4,10,342328,17232604960,519712
156,p1505,20150108,5026,5032,5070,5088,5038,5062,5062,30,30,473784,23992290960,529996
157,p1505,20150109,5062,5062,5086,5098,5040,5052,5074,-10,12,433036,21976241600,526510
158,p1505,20150112,5052,5074,5050,5076,5044,5060,5060,-14,-14,227010,11488572280,532212
159,p1505,20150113,5060,5060,5058,5058,4972,4982,5008,-78,-52,299966,15027324080,537682
160,p1505,20150114,4982,5008,4986,5008,4924,4938,4968,-70,-40,358504,17814671440,535308
161,p1505,20150115,4938,4968,4926,4974,4900,4956,4936,-12,-32,428382,21152807640,547210
162,p1505,20150116,4956,4936,4956,4998,4920,4942,4950,6,14,379078,18771062040,540918
163,p1505,20150119,4942,4950,4936,4982,4760,4896,4914,-54,-36,718154,35295516840,474688
164,p1505,20150120,4896,4914,4880,4912,4864,4888,4886,-26,-28,295924,14459875120,476784
165,p1505,20150121,4888,4886,4888,4928,4870,4894,4898,8,12,382368,18729126200,493330
166,p1505,20150122,4894,4898,4870,4908,4864,4876,4888,-22,-10,285746,13968766080,489316
167,p1505,20150123,4876,4888,4890,4892,4854,4870,4868,-18,-20,329186,16029083520,481754
168,p1505,20150126,4870,4868,4852,4874,4836,4838,4850,-30,-18,247708,12016167080,463804
169,p1505,20150127,4838,4850,4840,4868,4822,4826,4840,-24,-10,327400,15850522640,471282
170,p1505,20150128,4826,4840,4834,4850,4780,4810,4810,-30,-30,315388,15176442520,465740
171,p1505,20150129,4810,4810,4814,4818,4736,4756,4770,-54,-40,332030,15838781800,481950
172,p1505,20150130,4756,4770,4722,4746,4610,4652,4666,-118,-104,617164,28800207720,499368
173,p1505,20150202,4652,4666,4680,4708,4628,4694,4668,28,2,336800,15724960520,477366
174,p1505,20150203,4694,4668,4718,4750,4696,4736,4718,68,50,293516,13853471960,472290
175,p1505,20150204,4736,4718,4740,4818,4736,4750,4766,32,48,343794,16386340440,450958
176,p1505,20150205,4750,4766,4778,4826,4736,4802,4782,36,16,479924,22951008760,442668
177,p1505,20150206,4802,4782,4888,4952,4846,4896,4892,114,110,812316,39742977440,421582
178,p1505,20150209,4896,4892,4930,4934,4884,4916,4904,24,12,397022,19474234400,413604
179,p1505,20150210,4916,4904,4892,4942,4886,4940,4912,36,8,273506,13438955360,411748
180,p1505,20150211,4940,4912,4912,4942,4898,4936,4918,24,6,259104,12746971600,401270
181,p1505,20150212,4936,4918,4918,4924,4882,4886,4900,-32,-18,323994,15875979600,368938
182,p1505,20150213,4886,4900,4902,4988,4890,4986,4950,86,50,327188,16200099120,372408
183,p1505,20150216,4986,4950,4990,5030,4972,5000,5004,50,54,204542,10235692840,346924
184,p1505,20150217,5000,5004,5002,5016,4990,4996,4998,-8,-6,82618,4130740120,333412
185,p1505,20150225,4996,4998,4976,4978,4816,4942,4916,-56,-82,125970,6195202960,319178
186,p1505,20150226,4942,4916,4952,4974,4936,4962,4956,46,40,116924,5796265080,321936
187,p1505,20150227,4962,4956,4974,5104,4966,5100,5040,144,84,351048,17699436400,363518
188,p1505,20150302,5100,5040,5100,5174,5100,5164,5136,124,96,447282,22976439560,372620
189,p1505,20150303,5164,5136,5164,5220,5070,5106,5144,-30,8,529290,27234534680,345050
190,p1505,20150304,5106,5144,5124,5170,5100,5142,5136,-2,-8,241488,12405497960,339784
191,p1505,20150305,5142,5136,5098,5114,5020,5056,5056,-80,-80,234122,11837712800,312268
192,p1505,20150306,5056,5056,5020,5040,4968,4970,5004,-86,-52,151198,7566443920,301170
193,p1505,20150309,4970,5004,4972,5016,4944,5014,4978,10,-26,138526,6897993640,288376
194,p1505,20150310,5014,4978,4980,5010,4932,4934,4968,-44,-10,154002,7651307880,257644
195,p1505,20150311,4934,4968,4922,4942,4880,4928,4908,-40,-60,150948,7410069920,257194
196,p1505,20150312,4928,4908,4962,4964,4880,4894,4918,-14,10,83770,4120157560,250164
197,p1505,20150313,4894,4918,4880,4894,4846,4858,4864,-60,-54,76912,3741710880,239138
198,p1505,20150316,4858,4864,4848,4858,4700,4788,4798,-76,-66,88752,4258771640,220890
199,p1505,20150317,4788,4798,4780,4824,4780,4818,4808,20,10,78430,3771060360,192576
200,p1505,20150318,4818,4808,4772,4776,4734,4762,4754,-46,-54,85074,4045490360,173312
201,p1505,20150319,4762,4754,4788,4884,4766,4854,4824,100,70,98520,4753927080,151168
202,p1505,20150320,4854,4824,4826,4850,4778,4786,4810,-38,-14,66814,3214397120,139228
203,p1505,20150323,4786,4810,4748,4798,4744,4788,4766,-22,-44,78254,3730531320,115156
204,p1505,20150324,4788,4766,4800,4846,4776,4802,4808,36,42,31386,1509512760,109996
205,p1505,20150325,4802,4808,4800,4810,4772,4776,4790,-32,-18,24308,1164670680,101620
206,p1505,20150326,4776,4790,4790,4824,4766,4822,4798,32,8,22402,1074948800,98606
207,p1505,20150327,4822,4798,4820,4826,4788,4792,4800,-6,2,30294,1454499320,91320
208,p1505,20150330,4792,4800,4800,4814,4724,4760,4768,-40,-32,23266,1109420000,83396
209,p1505,20150331,4760,4768,4782,4782,4740,4742,4762,-26,-6,13476,641793640,82462
210,p1505,20150401,4742,4762,4728,4786,4720,4758,4754,-4,-8,16126,766843480,82078
211,p1505,20150402,4758,4754,4764,4790,4726,4784,4766,30,12,29502,1406079880,72812
212,p1505,20150403,4784,4766,4778,4786,4748,4776,4770,10,4,27560,1314707480,70714
213,p1505,20150407,4776,4770,4840,4860,4810,4854,4840,84,70,17516,847943720,65204
214,p1505,20150408,4854,4840,4834,4846,4786,4806,4820,-34,-20,10392,500928960,62776
215,p1505,20150409,4806,4820,4792,4802,4760,4770,4778,-50,-42,11020,526675440,57116
216,p1505,20150410,4770,4778,4742,4798,4600,4776,4762,-2,-16,18228,868225960,51804
217,p1505,20150413,4776,4762,4782,4824,4774,4814,4800,52,38,17262,828596600,47968
218,p1505,20150414,4814,4800,4804,4806,4764,4768,4776,-32,-24,11110,530775840,46674
219,p1505,20150415,4768,4776,4780,4836,4780,4800,4802,24,26,13774,661660440,39400
220,p1505,20150416,4800,4802,4770,4850,4770,4842,4832,40,30,8314,401776000,35942
221,p1505,20150417,4842,4832,4842,4842,4804,4826,4828,-6,-4,3146,151933840,34090
222,p1505,20150420,4826,4828,4826,4992,4826,4980,4930,152,102,20814,1026195960,27572
223,p1505,20150421,4980,4930,4962,4996,4946,4988,4976,58,46,6472,322109080,24688
224,p1505,20150422,4988,4976,4988,5000,4952,4978,4980,2,4,7256,361492560,21620
225,p1505,20150423,4978,4980,4972,4992,4948,4952,4968,-28,-12,2426,120554800,20538
226,p1505,20150424,4952,4968,4984,5002,4956,4972,4978,4,10,1664,82861720,19662
227,p1505,20150427,4972,4978,4950,5008,4928,5006,4970,28,-8,2316,115115200,18124
228,p1505,20150428,5006,4970,5014,5022,4948,4992,4978,22,8,2524,125670840,17008
229,p1505,20150429,4992,4978,5006,5010,4960,4996,4990,18,12,4452,222182480,13260
230,p1505,20150430,4996,4990,4986,5086,4900,5058,5044,68,54,4064,205058680,11294
231,p1505,20150504,5058,5044,5012,5080,4980,5040,5034,-4,-10,6534,329046000,7256
232,p1505,20150505,5040,5034,5050,5070,5050,5060,5058,26,24,104,5260800,7216
233,p1505,20150506,5060,5058,5222,5222,5080,5080,5094,22,36,1010,51458080,6216
234,p1505,20150507,5080,5094,5062,5122,5062,5122,5082,28,-12,404,20538080,5812
235,p1505,20150508,5122,5082,5082,5106,5082,5106,5090,24,8,32,1629120,5780
236,p1505,20150511,5106,5090,5130,5130,5130,5130,5130,40,40,1000,51300000,4780
237,p1505,20150512,5130,5130,0,0,0,5130,5130,0,0,8,410400,4772
238,p1505,20150513,5130,5130,5000,5140,5000,5140,5014,10,-116,2240,112316000,2532
239,p1505,20150514,5140,5014,5148,5148,5148,5148,5148,134,134,94,4839120,2438
240,p1505,20150515,5148,5148,5456,5456,5260,5456,5050,308,-98,84,4472080,0
241,p1506,20150105,5100,5116,5068,5068,5068,5068,5068,-48,-48,2,101360,28
242,p1506,20150106,5068,5068,5042,5094,5042,5094,5052,26,-16,10,505320,28
243,p1506,20150107,5094,5052,0,0,0,5052,5052,0,0,0,0,28
244,p1506,20150108,5052,5052,5122,5122,5090,5114,5106,62,54,16,817240,24
245,p1506,20150109,5114,5106,0,0,0,5106,5106,0,0,0,0,24
246,p1506,20150112,5106,5106,0,0,0,5106,5106,0,0,0,0,24
247,p1506,20150113,5106,5106,5040,5040,5040,5040,5040,-66,-66,2,100800,24
248,p1506,20150114,5040,5040,0,0,0,5000,5000,-40,-40,0,0,24
249,p1506,20150115,5000,5000,4964,4964,4964,4964,4964,-36,-36,2,99280,22
250,p1506,20150116,4964,4964,5024,5034,5024,5034,5028,70,64,4,201160,20
251,p1506,20150119,5034,5028,4978,4978,4852,4928,4884,-100,-144,244,11920560,114
252,p1506,20150120,4928,4884,4932,4932,4920,4924,4924,40,40,86,4235280,28
253,p1506,20150121,4924,4924,4920,4936,4920,4936,4928,12,4,4,197120,28
254,p1506,20150122,4936,4928,4924,4928,4894,4928,4918,0,-10,10,491880,32
255,p1506,20150123,4928,4918,4880,4882,4876,4876,4878,-42,-40,8,390280,32
256,p1506,20150126,4876,4878,4882,4888,4850,4882,4872,4,-6,24,1169560,32
257,p1506,20150127,4882,4872,0,0,0,4872,4872,0,0,0,0,32
258,p1506,20150128,4872,4872,4922,5048,4832,4832,4886,-40,14,14,684240,36
259,p1506,20150129,4832,4886,0,0,0,4834,4834,-52,-52,0,0,36
260,p1506,20150130,4834,4834,4642,4644,4642,4644,4642,-190,-192,8,371400,34
261,p1506,20150202,4644,4642,4728,4728,4650,4666,4680,24,38,22,1029880,34
262,p1506,20150203,4666,4680,4680,4748,4680,4748,4714,68,34,4,188560,34
263,p1506,20150204,4748,4714,0,0,0,4730,4730,16,16,0,0,34
264,p1506,20150205,4730,4730,4800,4800,4798,4798,4798,68,68,4,191960,36
265,p1506,20150206,4798,4798,0,0,0,4868,4868,70,70,0,0,36
266,p1506,20150209,4868,4868,0,0,0,4890,4890,22,22,0,0,36
267,p1506,20150210,4890,4890,0,0,0,4902,4902,12,12,0,0,36
268,p1506,20150211,4902,4902,0,0,0,4908,4908,6,6,0,0,36
269,p1506,20150212,4908,4908,4924,4924,4866,4880,4892,-28,-16,10,489200,34
270,p1506,20150213,4880,4892,4886,4994,4886,4974,4964,82,72,10,496440,34
271,p1506,20150216,4974,4964,4998,4998,4998,4998,4998,34,34,2,99960,32
272,p1506,20150217,4998,4998,0,0,0,4998,4998,0,0,0,0,32
273,p1506,20150225,4998,4998,4910,4934,4906,4926,4920,-72,-78,28,1377840,26
274,p1506,20150226,4926,4920,4932,4998,4928,4952,4946,32,26,42,2077360,28
275,p1506,20150227,4952,4946,5042,5046,5040,5040,5042,94,96,6,302560,32
276,p1506,20150302,5040,5042,5162,5176,5142,5142,5160,100,118,6,309600,30
277,p1506,20150303,5142,5160,5180,5200,5094,5094,5144,-66,-16,8,411640,30
278,p1506,20150304,5094,5144,5138,5164,5122,5128,5136,-16,-8,10,513600,30
279,p1506,20150305,5128,5136,5056,5056,5056,5056,5056,-80,-80,2,101120,28
280,p1506,20150306,5056,5056,0,0,0,5004,5004,-52,-52,0,0,28
281,p1506,20150309,5004,5004,4960,4960,4906,4946,4940,-58,-64,16,790560,32
282,p1506,20150310,4946,4940,4950,4950,4872,4914,4906,-26,-34,18,883360,30
283,p1506,20150311,4914,4906,4872,4874,4830,4874,4854,-32,-52,18,873960,30
284,p1506,20150312,4874,4854,0,0,0,4854,4854,0,0,0,0,30
285,p1506,20150313,4854,4854,0,0,0,4830,4830,-24,-24,0,0,30
286,p1506,20150316,4830,4830,4728,4728,4728,4728,4728,-102,-102,2,94560,28
287,p1506,20150317,4728,4728,0,0,0,4728,4728,0,0,0,0,28
288,p1506,20150318,4728,4728,4700,4700,4700,4700,4700,-28,-28,4,188000,28
289,p1506,20150319,4700,4700,4784,4844,4784,4818,4816,118,116,8,385280,28
290,p1506,20150320,4818,4816,4774,4774,4728,4768,4760,-48,-56,12,571400,26
291,p1506,20150323,4768,4760,4732,4762,4732,4762,4756,2,-4,14,665880,28
292,p1506,20150324,4762,4756,4800,4800,4800,4800,4800,44,44,10,480000,22
293,p1506,20150325,4800,4800,4796,4796,4796,4796,4796,-4,-4,2,95920,24
294,p1506,20150326,4796,4796,4778,4778,4760,4760,4768,-36,-28,4,190760,22
295,p1506,20150327,4760,4768,4750,4792,4750,4768,4772,0,4,40,1909200,20
296,p1506,20150330,4768,4772,4758,4782,4716,4782,4756,10,-16,8,380520,20
297,p1506,20150331,4782,4756,0,0,0,4756,4756,0,0,0,0,20
298,p1506,20150401,4756,4756,4706,4736,4706,4736,4720,-20,-36,4,188840,20
299,p1506,20150402,4736,4720,4728,4774,4660,4774,4752,54,32,102,4847680,54
300,p1506,20150403,4774,4752,4732,4796,4728,4760,4742,8,-10,48,2276960,20
301,p1506,20150407,4760,4742,0,0,0,4810,4810,68,68,0,0,20
302,p1506,20150408,4810,4810,0,0,0,4792,4792,-18,-18,0,0,20
303,p1506,20150409,4792,4792,0,0,0,4752,4752,-40,-40,0,0,20
304,p1506,20150410,4752,4752,4738,4782,4718,4718,4746,-34,-6,6,284760,18
305,p1506,20150413,4718,4746,0,0,0,4756,4756,10,10,0,0,18
306,p1506,20150414,4756,4756,0,0,0,4756,4756,0,0,0,0,18
307,p1506,20150415,4756,4756,0,0,0,4756,4756,0,0,0,0,18
308,p1506,20150416,4756,4756,0,0,0,4756,4756,0,0,0,0,18
309,p1506,20150417,4756,4756,0,0,0,4756,4756,0,0,0,0,18
310,p1506,20150420,4756,4756,4866,4866,4866,4866,4866,110,110,2,97320,16
311,p1506,20150421,4866,4866,0,0,0,4910,4910,44,44,0,0,16
312,p1506,20150422,4910,4910,0,0,0,4912,4912,2,2,0,0,16
313,p1506,20150423,4912,4912,0,0,0,4912,4912,0,0,0,0,16
314,p1506,20150424,4912,4912,4990,4992,4910,4910,4976,-2,64,12,597280,14
315,p1506,20150427,4910,4976,0,0,0,4970,4970,-6,-6,0,0,14
316,p1506,20150428,4970,4970,0,0,0,4978,4978,8,8,0,0,14
317,p1506,20150429,4978,4978,0,0,0,4978,4978,0,0,0,0,14
318,p1506,20150430,4978,4978,0,0,0,4978,4978,0,0,0,0,14
319,p1506,20150504,4978,4978,4980,4990,4980,4990,4982,12,4,6,299000,12
320,p1506,20150505,4990,4982,5008,5008,5008,5008,5008,26,26,2,100160,10
321,p1506,20150506,5008,5008,0,0,0,5042,5042,34,34,0,0,10
322,p1506,20150507,5042,5042,0,0,0,5032,5032,-10,-10,0,0,10
323,p1506,20150508,5032,5032,0,0,0,5038,5038,6,6,0,0,10
324,p1506,20150511,5038,5038,0,0,0,5076,5076,38,38,0,0,10
325,p1506,20150512,5076,5076,0,0,0,5076,5076,0,0,0,0,10
326,p1506,20150513,5076,5076,0,0,0,4962,4962,-114,-114,0,0,10
327,p1506,20150514,4962,4962,0,0,0,5094,5094,132,132,0,0,10
328,p1506,20150515,5094,5094,0,0,0,4998,4998,-96,-96,0,0,10
329,p1506,20150518,4998,4998,0,0,0,4998,4998,0,0,0,0,10
330,p1506,20150519,4998,4998,0,0,0,4998,4998,0,0,0,0,10
331,p1506,20150520,4998,4998,5128,5128,4900,4900,5014,-98,16,4,200560,12
332,p1506,20150521,4900,5014,0,0,0,5014,5014,0,0,0,0,12
333,p1506,20150522,5014,5014,0,0,0,5014,5014,0,0,0,0,12
334,p1506,20150525,5014,5014,4840,4840,4840,4840,4840,-174,-174,2,96800,10
335,p1506,20150526,4840,4840,0,0,0,5032,5032,192,192,0,0,10
336,p1506,20150527,5032,5032,0,0,0,5032,5032,0,0,0,0,10
337,p1506,20150528,5032,5032,5150,5150,5150,5150,5150,118,118,2,103000,10
338,p1506,20150529,5150,5150,5156,5458,4842,5458,5156,308,6,14,722000,0
339,p1506,20150601,5458,5156,0,0,0,5156,5156,0,0,0,0,0
340,p1506,20150602,5156,5156,0,0,0,5156,5156,0,0,0,0,0
341,p1506,20150603,5156,5156,0,0,0,5156,5156,0,0,0,0,0
342,p1506,20150604,5156,5156,0,0,0,5156,5156,0,0,0,0,0
343,p1506,20150605,5156,5156,5464,5464,4848,4848,5156,-308,0,4,206240,2
344,p1506,20150608,4848,5156,0,0,0,5156,5156,0,0,0,0,2
345,p1506,20150609,5156,5156,0,0,0,5156,5156,0,0,0,0,2
346,p1506,20150610,5156,5156,0,0,0,5156,5156,0,0,0,0,2
347,p1506,20150611,5156,5156,0,0,0,5156,5156,0,0,0,0,2
348,p1506,20150612,5156,5156,5156,5156,5156,5156,5156,0,0,2,103120,0
349,p1507,20150105,5094,5094,0,0,0,5074,5074,-20,-20,0,0,10
350,p1507,20150106,5074,5074,0,0,0,5058,5058,-16,-16,0,0,10
351,p1507,20150107,5058,5058,0,0,0,5058,5058,0,0,0,0,10
352,p1507,20150108,5058,5058,0,0,0,5058,5058,0,0,0,0,10
353,p1507,20150109,5058,5058,0,0,0,5068,5068,10,10,0,0,10
354,p1507,20150112,5068,5068,0,0,0,5068,5068,0,0,0,0,10
355,p1507,20150113,5068,5068,0,0,0,5068,5068,0,0,0,0,10
356,p1507,20150114,5068,5068,0,0,0,5060,5060,-8,-8,0,0,10
357,p1507,20150115,5060,5060,0,0,0,5060,5060,0,0,0,0,10
358,p1507,20150116,5060,5060,0,0,0,5060,5060,0,0,0,0,10
359,p1507,20150119,5060,5060,4922,4922,4922,4922,4922,-138,-138,2,98440,10
360,p1507,20150120,4922,4922,4944,4944,4944,4944,4944,22,22,2,98880,8
361,p1507,20150121,4944,4944,0,0,0,4944,4944,0,0,0,0,8
362,p1507,20150122,4944,4944,5016,5016,4892,4892,4954,-52,10,8,396360,8
363,p1507,20150123,4892,4954,4908,4954,4876,4876,4924,-78,-30,20,985040,10
364,p1507,20150126,4876,4924,0,0,0,4918,4918,-6,-6,0,0,10
365,p1507,20150127,4918,4918,0,0,0,4908,4908,-10,-10,0,0,10
366,p1507,20150128,4908,4908,0,0,0,4922,4922,14,14,0,0,10
367,p1507,20150129,4922,4922,0,0,0,4882,4882,-40,-40,0,0,10
368,p1507,20150130,4882,4882,0,0,0,4690,4690,-192,-192,0,0,10
369,p1507,20150202,4690,4690,0,0,0,4728,4728,38,38,0,0,10
370,p1507,20150203,4728,4728,0,0,0,4728,4728,0,0,0,0,10
371,p1507,20150204,4728,4728,0,0,0,4776,4776,48,48,0,0,10
372,p1507,20150205,4776,4776,0,0,0,4844,4844,68,68,0,0,10
373,p1507,20150206,4844,4844,0,0,0,4954,4954,110,110,0,0,10
374,p1507,20150209,4954,4954,0,0,0,4966,4966,12,12,0,0,10
375,p1507,20150210,4966,4966,0,0,0,4974,4974,8,8,0,0,10
376,p1507,20150211,4974,4974,0,0,0,4980,4980,6,6,0,0,10
377,p1507,20150212,4980,4980,0,0,0,4980,4980,0,0,0,0,10
378,p1507,20150213,4980,4980,4840,5038,4840,5038,4910,58,-70,10,491160,14
379,p1507,20150216,5038,4910,4962,4992,4962,4992,4976,82,66,4,199080,14
380,p1507,20150217,4992,4976,0,0,0,4976,4976,0,0,0,0,14
381,p1507,20150225,4976,4976,0,0,0,4976,4976,0,0,0,0,14
382,p1507,20150226,4976,4976,0,0,0,4964,4964,-12,-12,0,0,14
383,p1507,20150227,4964,4964,5012,5012,5012,5012,5012,48,48,2,100240,14
384,p1507,20150302,5012,5012,0,0,0,5074,5074,62,62,0,0,14
385,p1507,20150303,5074,5074,5020,5046,5020,5046,5032,-28,-42,4,201320,14
386,p1507,20150304,5046,5032,0,0,0,5092,5092,60,60,0,0,14
387,p1507,20150305,5092,5092,0,0,0,5092,5092,0,0,0,0,14
388,p1507,20150306,5092,5092,0,0,0,5092,5092,0,0,0,0,14
389,p1507,20150309,5092,5092,4926,4926,4926,4926,4926,-166,-166,2,98520,16
390,p1507,20150310,4926,4926,0,0,0,4894,4894,-32,-32,0,0,16
391,p1507,20150311,4894,4894,0,0,0,4844,4844,-50,-50,0,0,16
392,p1507,20150312,4844,4844,0,0,0,4852,4852,8,8,0,0,16
393,p1507,20150313,4852,4852,0,0,0,4800,4800,-52,-52,0,0,16
394,p1507,20150316,4800,4800,0,0,0,4800,4800,0,0,0,0,16
395,p1507,20150317,4800,4800,0,0,0,4810,4810,10,10,0,0,16
396,p1507,20150318,4810,4810,0,0,0,4782,4782,-28,-28,0,0,16
397,p1507,20150319,4782,4782,4922,4930,4844,4844,4896,62,114,22,1077280,18
398,p1507,20150320,4844,4896,0,0,0,4840,4840,-56,-56,0,0,18
399,p1507,20150323,4840,4840,4790,4814,4762,4762,4776,-78,-64,14,668840,12
400,p1507,20150324,4762,4776,4742,4810,4742,4810,4776,34,0,4,191040,12
401,p1507,20150325,4810,4776,0,0,0,4774,4774,-2,-2,0,0,12
402,p1507,20150326,4774,4774,0,0,0,4748,4748,-26,-26,0,0,12
403,p1507,20150327,4748,4748,0,0,0,4750,4750,2,2,0,0,12
404,p1507,20150330,4750,4750,0,0,0,4736,4736,-14,-14,0,0,12
405,p1507,20150331,4736,4736,0,0,0,4732,4732,-4,-4,0,0,12
406,p1507,20150401,4732,4732,0,0,0,4698,4698,-34,-34,0,0,12
407,p1507,20150402,4698,4698,0,0,0,4698,4698,0,0,0,0,12
408,p1507,20150403,4698,4698,0,0,0,4690,4690,-8,-8,0,0,12
409,p1507,20150407,4690,4690,0,0,0,4758,4758,68,68,0,0,12
410,p1507,20150408,4758,4758,0,0,0,4740,4740,-18,-18,0,0,12
411,p1507,20150409,4740,4740,0,0,0,4700,4700,-40,-40,0,0,12
412,p1507,20150410,4700,4700,0,0,0,4696,4696,-4,-4,0,0,12
413,p1507,20150413,4696,4696,0,0,0,4732,4732,36,36,0,0,12
414,p1507,20150414,4732,4732,0,0,0,4710,4710,-22,-22,0,0,12
415,p1507,20150415,4710,4710,0,0,0,4714,4714,4,4,0,0,12
416,p1507,20150416,4714,4714,0,0,0,4742,4742,28,28,0,0,12
417,p1507,20150417,4742,4742,0,0,0,4740,4740,-2,-2,0,0,12
418,p1507,20150420,4740,4740,0,0,0,4850,4850,110,110,0,0,12
419,p1507,20150421,4850,4850,4986,4986,4930,4930,4958,80,108,4,198320,12
420,p1507,20150422,4930,4958,0,0,0,4958,4958,0,0,0,0,12
421,p1507,20150423,4958,4958,4918,4952,4918,4952,4934,-6,-24,4,197400,10
422,p1507,20150424,4952,4934,0,0,0,4934,4934,0,0,0,0,10
423,p1507,20150427,4934,4934,0,0,0,4934,4934,0,0,0,0,10
424,p1507,20150428,4934,4934,0,0,0,4934,4934,0,0,0,0,10
425,p1507,20150429,4934,4934,4838,4962,4816,4864,4870,-70,-64,8,389600,6
426,p1507,20150430,4864,4870,0,0,0,4870,4870,0,0,0,0,6
427,p1507,20150504,4870,4870,5052,5060,4956,5052,5028,182,158,14,704040,12
428,p1507,20150505,5052,5028,0,0,0,5054,5054,26,26,0,0,12
429,p1507,20150506,5054,5054,0,0,0,5088,5088,34,34,0,0,12
430,p1507,20150507,5088,5088,0,0,0,5078,5078,-10,-10,0,0,12
431,p1507,20150508,5078,5078,5036,5040,5036,5038,5038,-40,-40,8,403080,8
432,p1507,20150511,5038,5038,5172,5172,5056,5056,5114,18,76,4,204560,8
433,p1507,20150512,5056,5114,0,0,0,5114,5114,0,0,0,0,8
434,p1507,20150513,5114,5114,0,0,0,5000,5000,-114,-114,0,0,8
435,p1507,20150514,5000,5000,0,0,0,5132,5132,132,132,0,0,8
436,p1507,20150515,5132,5132,5290,5290,5290,5290,5290,158,158,2,105800,6
437,p1507,20150518,5290,5290,0,0,0,5290,5290,0,0,0,0,6
438,p1507,20150519,5290,5290,0,0,0,5290,5290,0,0,0,0,6
439,p1507,20150520,5290,5290,0,0,0,5080,5080,-210,-210,0,0,6
440,p1507,20150521,5080,5080,0,0,0,5080,5080,0,0,0,0,6
441,p1507,20150522,5080,5080,0,0,0,5080,5080,0,0,0,0,6
442,p1507,20150525,5080,5080,0,0,0,4904,4904,-176,-176,0,0,6
443,p1507,20150526,4904,4904,0,0,0,4904,4904,0,0,0,0,6
444,p1507,20150527,4904,4904,0,0,0,4904,4904,0,0,0,0,6
445,p1507,20150528,4904,4904,0,0,0,5018,5018,114,114,0,0,6
446,p1507,20150529,5018,5018,0,0,0,5022,5022,4,4,0,0,6
447,p1507,20150601,5022,5022,0,0,0,5022,5022,0,0,0,0,6
448,p1507,20150602,5022,5022,0,0,0,5022,5022,0,0,0,0,6
449,p1507,20150603,5022,5022,5222,5222,5222,5222,5222,200,200,2,104440,6
450,p1507,20150604,5222,5222,5016,5036,5016,5036,5026,-186,-196,4,201040,2
451,p1507,20150605,5036,5026,0,0,0,5026,5026,0,0,0,0,2
452,p1507,20150608,5026,5026,0,0,0,5134,5134,108,108,0,0,2
453,p1507,20150609,5134,5134,0,0,0,5134,5134,0,0,0,0,2
454,p1507,20150610,5134,5134,0,0,0,5134,5134,0,0,0,0,2
455,p1507,20150611,5134,5134,0,0,0,5134,5134,0,0,0,0,2
456,p1507,20150612,5134,5134,0,0,0,5134,5134,0,0,0,0,2
457,p1507,20150615,5134,5134,0,0,0,5134,5134,0,0,0,0,2
458,p1507,20150616,5134,5134,0,0,0,5134,5134,0,0,0,0,2
459,p1507,20150617,5134,5134,0,0,0,5134,5134,0,0,0,0,2
460,p1507,20150618,5134,5134,0,0,0,5134,5134,0,0,0,0,2
461,p1507,20150619,5134,5134,0,0,0,5134,5134,0,0,0,0,2
462,p1507,20150623,5134,5134,0,0,0,5134,5134,0,0,0,0,2
463,p1507,20150624,5134,5134,0,0,0,5134,5134,0,0,0,0,2
464,p1507,20150625,5134,5134,0,0,0,5134,5134,0,0,0,0,2
465,p1507,20150626,5134,5134,0,0,0,5134,5134,0,0,0,0,2
466,p1507,20150629,5134,5134,0,0,0,5134,5134,0,0,0,0,2
467,p1507,20150630,5134,5134,5134,5134,5134,5134,5134,0,0,2,102680,0
468,p1507,20150701,5134,5134,0,0,0,5134,5134,0,0,0,0,0
469,p1507,20150702,5134,5134,0,0,0,5134,5134,0,0,0,0,0
470,p1507,20150703,5134,5134,0,0,0,5134,5134,0,0,0,0,0
471,p1507,20150706,5134,5134,0,0,0,5134,5134,0,0,0,0,0
472,p1507,20150707,5134,5134,0,0,0,5134,5134,0,0,0,0,0
473,p1507,20150708,5134,5134,0,0,0,5134,5134,0,0,0,0,0
474,p1507,20150709,5134,5134,0,0,0,5134,5134,0,0,0,0,0
475,p1507,20150710,5134,5134,0,0,0,5134,5134,0,0,0,0,0
476,p1507,20150713,5134,5134,0,0,0,5134,5134,0,0,0,0,0
477,p1507,20150714,5134,5134,0,0,0,5134,5134,0,0,0,0,0
478,p1508,20150105,5096,5096,0,0,0,5096,5096,0,0,0,0,4
479,p1508,20150106,5096,5096,0,0,0,5096,5096,0,0,0,0,4
480,p1508,20150107,5096,5096,0,0,0,5106,5106,10,10,0,0,4
481,p1508,20150108,5106,5106,0,0,0,5106,5106,0,0,0,0,4
482,p1508,20150109,5106,5106,0,0,0,5118,5118,12,12,0,0,4
483,p1508,20150112,5118,5118,0,0,0,5118,5118,0,0,0,0,4
484,p1508,20150113,5118,5118,0,0,0,5078,5078,-40,-40,0,0,4
485,p1508,20150114,5078,5078,0,0,0,5078,5078,0,0,0,0,4
486,p1508,20150115,5078,5078,0,0,0,5078,5078,0,0,0,0,4
487,p1508,20150116,5078,5078,0,0,0,5078,5078,0,0,0,0,4
488,p1508,20150119,5078,5078,0,0,0,5018,5018,-60,-60,0,0,4
489,p1508,20150120,5018,5018,0,0,0,5018,5018,0,0,0,0,4
490,p1508,20150121,5018,5018,0,0,0,5018,5018,0,0,0,0,4
491,p1508,20150122,5018,5018,0,0,0,4952,4952,-66,-66,0,0,4
492,p1508,20150123,4952,4952,0,0,0,4952,4952,0,0,0,0,4
493,p1508,20150126,4952,4952,0,0,0,4952,4952,0,0,0,0,4
494,p1508,20150127,4952,4952,4804,4804,4804,4804,4804,-148,-148,6,288240,8
495,p1508,20150128,4804,4804,0,0,0,4804,4804,0,0,0,0,8
496,p1508,20150129,4804,4804,0,0,0,4766,4766,-38,-38,0,0,8
497,p1508,20150130,4766,4766,4584,4654,4584,4586,4608,-180,-158,6,276480,8
498,p1508,20150202,4586,4608,4630,4630,4630,4630,4630,22,22,2,92600,8
499,p1508,20150203,4630,4630,0,0,0,4652,4652,22,22,0,0,8
500,p1508,20150204,4652,4652,4774,4774,4774,4774,4774,122,122,2,95480,8
501,p1508,20150205,4774,4774,0,0,0,4774,4774,0,0,0,0,8
502,p1508,20150206,4774,4774,4868,4868,4868,4868,4868,94,94,2,97360,8
503,p1508,20150209,4868,4868,0,0,0,4874,4874,6,6,0,0,8
504,p1508,20150210,4874,4874,4918,4976,4918,4976,4956,102,82,6,297400,10
505,p1508,20150211,4976,4956,4866,4876,4866,4876,4870,-80,-86,6,292280,6
506,p1508,20150212,4876,4870,0,0,0,4856,4856,-14,-14,0,0,6
507,p1508,20150213,4856,4856,0,0,0,4788,4788,-68,-68,0,0,6
508,p1508,20150216,4788,4788,0,0,0,4924,4924,136,136,0,0,6
509,p1508,20150217,4924,4924,0,0,0,4924,4924,0,0,0,0,6
510,p1508,20150225,4924,4924,0,0,0,4848,4848,-76,-76,0,0,6
511,p1508,20150226,4848,4848,0,0,0,4886,4886,38,38,0,0,6
512,p1508,20150227,4886,4886,0,0,0,4988,4988,102,102,0,0,6
513,p1508,20150302,4988,4988,5164,5164,5164,5164,5164,176,176,2,103280,6
514,p1508,20150303,5164,5164,5072,5072,5040,5040,5058,-124,-106,24,1214240,8
515,p1508,20150304,5040,5058,0,0,0,5058,5058,0,0,0,0,8
516,p1508,20150305,5058,5058,0,0,0,5050,5050,-8,-8,0,0,8
517,p1508,20150306,5050,5050,0,0,0,5002,5002,-48,-48,0,0,8
518,p1508,20150309,5002,5002,0,0,0,4840,4840,-162,-162,0,0,8
519,p1508,20150310,4840,4840,0,0,0,4808,4808,-32,-32,0,0,8
520,p1508,20150311,4808,4808,0,0,0,4758,4758,-50,-50,0,0,8
521,p1508,20150312,4758,4758,0,0,0,4758,4758,0,0,0,0,8
522,p1508,20150313,4758,4758,4824,4824,4824,4824,4824,66,66,2,96480,8
523,p1508,20150316,4824,4824,0,0,0,4780,4780,-44,-44,0,0,8
524,p1508,20150317,4780,4780,0,0,0,4780,4780,0,0,0,0,8
525,p1508,20150318,4780,4780,0,0,0,4780,4780,0,0,0,0,8
526,p1508,20150319,4780,4780,0,0,0,4780,4780,0,0,0,0,8
527,p1508,20150320,4780,4780,0,0,0,4780,4780,0,0,0,0,8
528,p1508,20150323,4780,4780,0,0,0,4802,4802,22,22,0,0,8
529,p1508,20150324,4802,4802,0,0,0,4804,4804,2,2,0,0,8
530,p1508,20150325,4804,4804,0,0,0,4804,4804,0,0,0,0,8
531,p1508,20150326,4804,4804,0,0,0,4820,4820,16,16,0,0,8
532,p1508,20150327,4820,4820,0,0,0,4824,4824,4,4,0,0,8
533,p1508,20150330,4824,4824,0,0,0,4790,4790,-34,-34,0,0,8
534,p1508,20150331,4790,4790,0,0,0,4790,4790,0,0,0,0,8
535,p1508,20150401,4790,4790,0,0,0,4790,4790,0,0,0,0,8
536,p1508,20150402,4790,4790,0,0,0,4790,4790,0,0,0,0,8
537,p1508,20150403,4790,4790,0,0,0,4790,4790,0,0,0,0,8
538,p1508,20150407,4790,4790,0,0,0,4814,4814,24,24,0,0,8
539,p1508,20150408,4814,4814,0,0,0,4814,4814,0,0,0,0,8
540,p1508,20150409,4814,4814,0,0,0,4814,4814,0,0,0,0,8
541,p1508,20150410,4814,4814,0,0,0,4758,4758,-56,-56,0,0,8
542,p1508,20150413,4758,4758,0,0,0,4794,4794,36,36,0,0,8
543,p1508,20150414,4794,4794,0,0,0,4766,4766,-28,-28,0,0,8
544,p1508,20150415,4766,4766,0,0,0,4790,4790,24,24,0,0,8
545,p1508,20150416,4790,4790,0,0,0,4818,4818,28,28,0,0,8
546,p1508,20150417,4818,4818,0,0,0,4818,4818,0,0,0,0,8
547,p1508,20150420,4818,4818,4978,4978,4892,4892,4940,74,122,122,6028480,18
548,p1508,20150421,4892,4940,0,0,0,4940,4940,0,0,0,0,18
549,p1508,20150422,4940,4940,0,0,0,4954,4954,14,14,0,0,18
550,p1508,20150423,4954,4954,0,0,0,4932,4932,-22,-22,0,0,18
551,p1508,20150424,4932,4932,0,0,0,4932,4932,0,0,0,0,18
552,p1508,20150427,4932,4932,0,0,0,4960,4960,28,28,0,0,18
553,p1508,20150428,4960,4960,0,0,0,4960,4960,0,0,0,0,18
554,p1508,20150429,4960,4960,0,0,0,4946,4946,-14,-14,0,0,18
555,p1508,20150430,4946,4946,4940,4940,4938,4938,4938,-8,-8,10,493960,18
556,p1508,20150504,4938,4938,0,0,0,5098,5098,160,160,0,0,18
557,p1508,20150505,5098,5098,5106,5106,5006,5006,5056,-92,-42,4,202240,18
558,p1508,20150506,5006,5056,5150,5150,5148,5148,5148,92,92,14,720760,14
559,p1508,20150507,5148,5148,0,0,0,5136,5136,-12,-12,0,0,14
560,p1508,20150508,5136,5136,0,0,0,5096,5096,-40,-40,0,0,14
561,p1508,20150511,5096,5096,5092,5138,5066,5066,5104,-30,8,46,2348680,14
562,p1508,20150512,5066,5104,5126,5126,5126,5126,5126,22,22,2,102520,14
563,p1508,20150513,5126,5126,5186,5186,5130,5184,5166,58,40,8,413280,14
564,p1508,20150514,5184,5166,0,0,0,5304,5304,138,138,0,0,14
565,p1508,20150515,5304,5304,5136,5166,5136,5166,5150,-138,-154,4,206040,12
566,p1508,20150518,5166,5150,5166,5166,5070,5108,5092,-42,-58,24,1222360,14
567,p1508,20150519,5108,5092,5050,5058,5050,5058,5052,-34,-40,6,303160,12
568,p1508,20150520,5058,5052,0,0,0,5068,5068,16,16,0,0,12
569,p1508,20150521,5068,5068,0,0,0,5068,5068,0,0,0,0,12
570,p1508,20150522,5068,5068,0,0,0,5068,5068,0,0,0,0,12
571,p1508,20150525,5068,5068,0,0,0,4894,4894,-174,-174,0,0,12
572,p1508,20150526,4894,4894,0,0,0,4894,4894,0,0,0,0,12
573,p1508,20150527,4894,4894,0,0,0,4894,4894,0,0,0,0,12
574,p1508,20150528,4894,4894,5088,5088,5088,5088,5088,194,194,4,203520,16
575,p1508,20150529,5088,5088,5160,5168,5152,5152,5160,64,72,6,309600,12
576,p1508,20150601,5152,5160,5190,5190,5186,5186,5188,26,28,4,207520,12
577,p1508,20150602,5186,5188,0,0,0,5188,5188,0,0,0,0,12
578,p1508,20150603,5188,5188,0,0,0,5394,5394,206,206,0,0,12
579,p1508,20150604,5394,5394,0,0,0,5192,5192,-202,-202,0,0,12
580,p1508,20150605,5192,5192,0,0,0,5192,5192,0,0,0,0,12
581,p1508,20150608,5192,5192,0,0,0,5192,5192,0,0,0,0,12
582,p1508,20150609,5192,5192,0,0,0,5192,5192,0,0,0,0,12
583,p1508,20150610,5192,5192,0,0,0,5192,5192,0,0,0,0,12
584,p1508,20150611,5192,5192,0,0,0,5192,5192,0,0,0,0,12
585,p1508,20150612,5192,5192,5012,5032,4986,4988,5000,-204,-192,20,1000360,6
586,p1508,20150615,4988,5000,0,0,0,5000,5000,0,0,0,0,6
587,p1508,20150616,5000,5000,0,0,0,5000,5000,0,0,0,0,6
588,p1508,20150617,5000,5000,5068,5068,5068,5068,5068,68,68,2,101360,6
589,p1508,20150618,5068,5068,0,0,0,5068,5068,0,0,0,0,6
590,p1508,20150619,5068,5068,0,0,0,5068,5068,0,0,0,0,6
591,p1508,20150623,5068,5068,0,0,0,5068,5068,0,0,0,0,6
592,p1508,20150624,5068,5068,4960,5050,4960,5010,5006,-58,-62,10,500600,6
593,p1508,20150625,5010,5006,5088,5088,4998,5020,5030,14,24,12,603800,6
594,p1508,20150626,5020,5030,4980,4988,4978,4988,4982,-42,-48,6,298920,2
595,p1508,20150629,4988,4982,0,0,0,4982,4982,0,0,0,0,2
596,p1508,20150630,4982,4982,0,0,0,4982,4982,0,0,0,0,2
597,p1508,20150701,4982,4982,0,0,0,4982,4982,0,0,0,0,2
598,p1508,20150702,4982,4982,0,0,0,4982,4982,0,0,0,0,2
599,p1508,20150703,4982,4982,0,0,0,4982,4982,0,0,0,0,2
600,p1508,20150706,4982,4982,4812,5040,4812,5040,4926,58,-56,8,394080,2
601,p1508,20150707,5040,4926,0,0,0,4926,4926,0,0,0,0,2
602,p1508,20150708,4926,4926,0,0,0,4926,4926,0,0,0,0,2
603,p1508,20150709,4926,4926,4730,4730,4730,4730,4730,-196,-196,2,94600,2
604,p1508,20150710,4730,4730,0,0,0,4730,4730,0,0,0,0,2
605,p1508,20150713,4730,4730,0,0,0,4730,4730,0,0,0,0,2
606,p1508,20150714,4730,4730,0,0,0,4730,4730,0,0,0,0,2
607,p1508,20150715,4730,4730,0,0,0,4730,4730,0,0,0,0,2
608,p1508,20150716,4730,4730,4918,4918,4918,4918,4918,188,188,2,98360,2
609,p1508,20150717,4918,4918,0,0,0,4918,4918,0,0,0,0,2
610,p1508,20150720,4918,4918,0,0,0,4918,4918,0,0,0,0,2
611,p1508,20150721,4918,4918,0,0,0,4918,4918,0,0,0,0,2
612,p1508,20150722,4918,4918,4800,4800,4800,4800,4800,-118,-118,2,96000,0
613,p1508,20150723,4800,4800,0,0,0,4800,4800,0,0,0,0,0
614,p1508,20150724,4800,4800,0,0,0,4800,4800,0,0,0,0,0
615,p1508,20150727,4800,4800,0,0,0,4800,4800,0,0,0,0,0
616,p1508,20150728,4800,4800,0,0,0,4800,4800,0,0,0,0,0
617,p1508,20150729,4800,4800,0,0,0,4800,4800,0,0,0,0,0
618,p1508,20150730,4800,4800,0,0,0,4800,4800,0,0,0,0,0
619,p1508,20150731,4800,4800,0,0,0,4800,4800,0,0,0,0,0
620,p1508,20150803,4800,4800,0,0,0,4800,4800,0,0,0,0,0
621,p1508,20150804,4800,4800,0,0,0,4800,4800,0,0,0,0,0
622,p1508,20150805,4800,4800,0,0,0,4800,4800,0,0,0,0,0
623,p1508,20150806,4800,4800,0,0,0,4800,4800,0,0,0,0,0
624,p1508,20150807,4800,4800,0,0,0,4800,4800,0,0,0,0,0
625,p1508,20150810,4800,4800,0,0,0,4800,4800,0,0,0,0,0
626,p1508,20150811,4800,4800,0,0,0,4800,4800,0,0,0,0,0
627,p1508,20150812,4800,4800,0,0,0,4800,4800,0,0,0,0,0
628,p1508,20150813,4800,4800,0,0,0,4800,4800,0,0,0,0,0
629,p1508,20150814,4800,4800,0,0,0,4800,4800,0,0,0,0,0
630,p1509,20150105,5152,5140,5080,5120,5052,5076,5090,-64,-50,17488,890269000,69180
631,p1509,20150106,5076,5090,5050,5112,5050,5096,5084,6,-6,45314,2303947880,74486
632,p1509,20150107,5096,5084,5092,5124,4982,5084,5084,0,0,43046,2188938800,73650
633,p1509,20150108,5084,5084,5100,5148,5094,5118,5120,34,36,39498,2022957000,74628
634,p1509,20150109,5118,5120,5140,5160,5104,5118,5132,-2,12,39382,2021844520,74680
635,p1509,20150112,5118,5132,5112,5136,5108,5116,5120,-16,-12,22122,1132880360,75762
636,p1509,20150113,5116,5120,5110,5114,5030,5040,5062,-80,-58,26988,1366245120,74068
637,p1509,20150114,5040,5062,5030,5062,4984,4988,5020,-74,-42,40828,2050367520,73090
638,p1509,20150115,4988,5020,5000,5028,4958,5012,4994,-8,-26,43912,2193457960,84112
639,p1509,20150116,5012,4994,5040,5058,4984,5000,5008,6,14,31116,1558709080,84846
640,p1509,20150119,5000,5008,5000,5038,4828,4958,4972,-50,-36,76402,3799480600,80126
641,p1509,20150120,4958,4972,4942,4970,4928,4946,4944,-26,-28,40092,1982534600,87140
642,p1509,20150121,4946,4944,4966,4984,4912,4936,4950,-8,6,64032,3170311000,96960
643,p1509,20150122,4936,4950,4906,4942,4904,4914,4924,-36,-26,53086,2614651480,104146
644,p1509,20150123,4914,4924,4920,4930,4840,4846,4866,-78,-58,94830,4615318800,129394
645,p1509,20150126,4846,4866,4850,4858,4804,4810,4834,-56,-32,53676,2594705920,136864
646,p1509,20150127,4810,4834,4816,4822,4750,4760,4790,-74,-44,124022,5942585880,174890
647,p1509,20150128,4760,4790,4780,4786,4730,4752,4756,-38,-34,122242,5814214840,193142
648,p1509,20150129,4752,4756,4756,4756,4664,4686,4700,-70,-56,205112,9643562600,239118
649,p1509,20150130,4686,4700,4650,4660,4564,4598,4612,-102,-88,209084,9643780200,255932
650,p1509,20150202,4598,4612,4620,4646,4572,4626,4612,14,0,139572,6438557840,279682
651,p1509,20150203,4626,4612,4638,4684,4632,4674,4656,62,44,114306,5324128880,288314
652,p1509,20150204,4674,4656,4684,4748,4670,4678,4700,22,44,177050,8322427200,303226
653,p1509,20150205,4678,4700,4702,4762,4654,4732,4702,32,2,235852,11093850480,313650
654,p1509,20150206,4732,4702,4840,4880,4786,4828,4828,126,126,276460,13348266480,283858
655,p1509,20150209,4828,4828,4878,4878,4816,4866,4844,38,16,215674,10451376200,311478
656,p1509,20150210,4866,4844,4836,4890,4836,4878,4868,34,24,132490,6450462080,301894
657,p1509,20150211,4878,4868,4850,4874,4836,4862,4854,-6,-14,100128,4860433920,287434
658,p1509,20150212,4862,4854,4840,4852,4808,4816,4824,-38,-30,152214,7344145560,280342
659,p1509,20150213,4816,4824,4830,4910,4820,4902,4870,78,46,152358,7422145120,270054
660,p1509,20150216,4902,4870,4888,4942,4888,4914,4918,44,48,122090,6004641600,258020
661,p1509,20150217,4914,4918,4918,4930,4908,4920,4918,2,0,36460,1793473200,253032
662,p1509,20150225,4920,4918,4888,4904,4772,4850,4844,-68,-74,62148,3010559400,262582
663,p1509,20150226,4850,4844,4858,4886,4846,4874,4868,30,24,94480,4600089480,281124
664,p1509,20150227,4874,4868,4888,4980,4872,4974,4922,106,54,223700,11012779040,323540
665,p1509,20150302,4974,4922,4980,5032,4958,5014,4998,92,76,237296,11861504520,318486
666,p1509,20150303,5014,4998,5010,5066,4950,4968,4992,-30,-6,253102,12639029280,317084
667,p1509,20150304,4968,4992,4986,5034,4978,4998,5002,6,10,273074,13661767960,346720
668,p1509,20150305,4998,5002,4990,4990,4892,4918,4926,-84,-76,277524,13673744760,324160
669,p1509,20150306,4918,4926,4900,4900,4816,4818,4862,-108,-64,254300,12366758280,313986
670,p1509,20150309,4818,4862,4830,4834,4760,4814,4806,-48,-56,297770,14314592040,327508
671,p1509,20150310,4814,4806,4804,4808,4732,4742,4764,-64,-42,441202,21019252960,333666
672,p1509,20150311,4742,4764,4744,4752,4706,4742,4726,-22,-38,396420,18741215640,369372
673,p1509,20150312,4742,4726,4754,4776,4732,4748,4750,22,24,316596,15041825040,372660
674,p1509,20150313,4748,4750,4742,4756,4706,4724,4724,-26,-26,322900,15258245880,379322
675,p1509,20150316,4724,4724,4724,4734,4536,4650,4682,-74,-42,505634,23677216120,351798
676,p1509,20150317,4650,4682,4660,4680,4646,4662,4666,-20,-16,344602,16083326320,404802
677,p1509,20150318,4662,4666,4602,4626,4578,4616,4600,-50,-66,637820,29341473120,515052
678,p1509,20150319,4616,4600,4652,4774,4652,4738,4718,138,118,803982,37938586960,512322
679,p1509,20150320,4738,4718,4730,4756,4678,4688,4714,-30,-4,593376,27974895760,557522
680,p1509,20150323,4688,4714,4650,4744,4642,4730,4702,16,-12,714462,33600720040,608354
681,p1509,20150324,4730,4702,4730,4788,4708,4730,4746,28,44,702168,33338855920,621754
682,p1509,20150325,4730,4746,4740,4752,4714,4716,4728,-30,-18,450566,21310417480,628748
683,p1509,20150326,4716,4728,4752,4766,4698,4752,4736,24,8,610362,28911837240,627142
684,p1509,20150327,4752,4736,4750,4762,4674,4688,4716,-48,-20,514884,24287783520,623764
685,p1509,20150330,4688,4716,4700,4706,4642,4664,4668,-52,-48,469874,21941939760,607624
686,p1509,20150331,4664,4668,4680,4686,4632,4644,4660,-24,-8,429164,19999791280,590226
687,p1509,20150401,4644,4660,4626,4696,4620,4650,4658,-10,-2,398886,18582546920,604216
688,p1509,20150402,4650,4658,4650,4688,4612,4670,4656,12,-2,572444,26656436440,630800
689,p1509,20150403,4670,4656,4652,4680,4646,4678,4662,22,6,306492,14292806000,606770
690,p1509,20150407,4678,4662,4706,4778,4702,4746,4738,84,76,294052,13935235960,606364
691,p1509,20150408,4746,4738,4726,4730,4692,4714,4714,-24,-24,303586,14311984480,617796
692,p1509,20150409,4714,4714,4696,4702,4648,4656,4674,-58,-40,365568,17090388880,602082
693,p1509,20150410,4656,4674,4630,4672,4620,4626,4644,-48,-30,386470,17951704720,599762
694,p1509,20150413,4626,4644,4644,4688,4636,4676,4664,32,20,430286,20076135800,625806
695,p1509,20150414,4676,4664,4670,4686,4632,4642,4658,-22,-6,360574,16796356840,637088
696,p1509,20150415,4642,4658,4666,4734,4662,4720,4700,62,42,747760,35155049120,681610
697,p1509,20150416,4720,4700,4704,4802,4690,4762,4750,62,50,886354,42109040360,694486
698,p1509,20150417,4762,4750,4742,4774,4734,4742,4750,-8,0,406422,19308961680,701910
699,p1509,20150420,4742,4750,4752,4848,4748,4846,4808,96,58,897266,43144888080,758058
700,p1509,20150421,4846,4808,4824,4926,4812,4918,4878,110,70,1010870,49327081160,749012
701,p1509,20150422,4918,4878,4912,4934,4854,4896,4898,18,20,822094,40269622080,737320
702,p1509,20150423,4896,4898,4902,4926,4872,4880,4898,-18,0,956542,46856226200,717204
703,p1509,20150424,4880,4898,4898,4930,4860,4868,4894,-30,-4,940678,46052252440,697520
704,p1509,20150427,4868,4894,4870,4924,4834,4908,4886,14,-8,840964,41102487440,763944
705,p1509,20150428,4908,4886,4886,4932,4858,4868,4896,-18,10,901886,44163673920,753280
706,p1509,20150429,4868,4896,4870,4892,4830,4852,4862,-44,-34,632060,30730953080,758168
707,p1509,20150430,4852,4862,4860,4904,4836,4878,4874,16,12,670580,32696341440,804306
708,p1509,20150504,4878,4874,4870,4990,4854,4980,4944,106,70,737616,36477996560,836140
709,p1509,20150505,4980,4944,4990,5092,4984,5050,5038,106,94,1182844,59615111360,753296
710,p1509,20150506,5050,5038,5070,5206,5056,5162,5126,124,88,1360948,69764400600,797958
711,p1509,20150507,5162,5126,5154,5168,5072,5108,5116,-18,-10,948898,48547491640,799034
712,p1509,20150508,5108,5116,5098,5098,5002,5008,5042,-108,-74,860076,43374680720,778976
713,p1509,20150511,5008,5042,5032,5100,5018,5094,5068,52,26,709774,35972521560,789116
714,p1509,20150512,5094,5068,5106,5130,5064,5092,5102,24,34,876902,44748544960,822224
715,p1509,20150513,5092,5102,5122,5172,5110,5116,5138,14,36,985976,50659527080,780984
716,p1509,20150514,5116,5138,5114,5124,5056,5112,5094,-26,-44,729058,37144997840,801338
717,p1509,20150515,5112,5094,5124,5164,5102,5138,5136,44,42,941750,48373144520,789500
718,p1509,20150518,5138,5136,5110,5110,5062,5100,5082,-36,-54,590556,30023133440,768470
719,p1509,20150519,5100,5082,5096,5100,5008,5026,5044,-56,-38,559642,28235062880,751674
720,p1509,20150520,5026,5044,5000,5006,4860,4908,4918,-136,-126,851050,41862027800,682944
721,p1509,20150521,4908,4918,4910,4952,4894,4918,4926,0,8,517618,25505462440,691232
722,p1509,20150522,4918,4926,4936,4966,4912,4938,4938,12,12,450228,22238545560,675114
723,p1509,20150525,4938,4938,4898,4934,4876,4918,4904,-20,-34,461842,22657210360,695274
724,p1509,20150526,4918,4904,4930,5090,4918,5058,5022,154,118,886790,44540782480,710228
725,p1509,20150527,5058,5022,5054,5120,5040,5084,5086,62,64,972186,49447149920,735998
726,p1509,20150528,5084,5086,5060,5184,5048,5148,5128,62,42,1282304,65763462720,743794
727,p1509,20150529,5148,5128,5138,5162,5100,5116,5136,-12,8,885376,45488676880,708296
728,p1509,20150601,5116,5136,5130,5254,5116,5184,5184,48,48,1497370,77648968680,637132
729,p1509,20150602,5184,5184,5238,5250,5186,5232,5222,48,38,933004,48728666040,580186
730,p1509,20150603,5232,5222,5202,5248,5122,5138,5198,-84,-24,828870,43087134120,508354
731,p1509,20150604,5138,5198,5152,5168,5064,5126,5120,-72,-78,654472,33515532200,460112
732,p1509,20150605,5126,5120,5136,5176,5084,5156,5126,36,6,454846,23319451640,444056
733,p1509,20150608,5156,5126,5180,5188,5126,5132,5154,6,28,378756,19527667880,439208
734,p1509,20150609,5132,5154,5106,5134,4996,5034,5048,-120,-106,442006,22320630640,399238
735,p1509,20150610,5034,5048,5064,5074,5012,5030,5044,-18,-4,271778,13708845160,375962
736,p1509,20150611,5030,5044,5066,5066,5020,5054,5042,10,-2,223344,11265050840,357606
737,p1509,20150612,5054,5042,5040,5054,4964,4968,4996,-74,-46,261090,13045231280,315432
738,p1509,20150615,4968,4996,4992,5026,4950,4980,4992,-16,-4,193232,9648662880,288066
739,p1509,20150616,4980,4992,4980,5030,4964,5022,5004,30,12,173672,8693478800,273372
740,p1509,20150617,5022,5004,5036,5036,4978,5016,5014,12,10,166316,8339583080,265750
741,p1509,20150618,5016,5014,5000,5030,4916,4920,4972,-94,-42,184142,9158515880,262130
742,p1509,20150619,4920,4972,4918,4958,4892,4954,4924,-18,-48,136302,6711591680,251236
743,p1509,20150623,4954,4924,4980,4992,4906,4930,4944,6,20,73044,3612606520,247586
744,p1509,20150624,4930,4944,4926,4968,4896,4956,4932,12,-12,119582,5899037280,239160
745,p1509,20150625,4956,4932,4982,5012,4966,4976,4992,44,60,140878,7034975800,225408
746,p1509,20150626,4976,4992,4980,5016,4922,4956,4980,-36,-12,128778,6415052280,216304
747,p1509,20150629,4956,4980,5004,5016,4910,4934,4966,-46,-14,116712,5798241680,208412
748,p1509,20150630,4934,4966,4940,4958,4832,4874,4888,-92,-78,164872,8060028000,188826
749,p1509,20150701,4874,4888,4890,5058,4864,4990,4966,102,78,108378,5382860400,174748
750,p1509,20150702,4990,4966,4998,5000,4920,4976,4954,10,-12,78226,3875440720,170618
751,p1509,20150703,4976,4954,4970,4998,4946,4966,4978,12,24,69476,3459494640,164284
752,p1509,20150706,4966,4978,4966,4966,4802,4860,4882,-118,-96,97298,4750606040,158536
753,p1509,20150707,4860,4882,4850,4892,4798,4822,4842,-60,-40,92948,4501986160,151760
754,p1509,20150708,4822,4842,4774,4796,4650,4650,4686,-192,-156,77918,3651403040,121630
755,p1509,20150709,4650,4686,4406,4788,4406,4702,4614,16,-72,173546,8007489240,99822
756,p1509,20150710,4702,4614,4736,4798,4724,4798,4778,184,164,55020,2629930840,96844
757,p1509,20150713,4798,4778,4812,4856,4734,4804,4798,26,20,77486,3717798200,92636
758,p1509,20150714,4804,4798,4798,4924,4780,4864,4870,66,72,79610,3877567360,87272
759,p1509,20150715,4864,4870,4848,4908,4840,4866,4866,-4,-4,61078,2972186240,90016
760,p1509,20150716,4866,4866,4864,4868,4794,4832,4824,-34,-42,50272,2426122640,92620
761,p1509,20150717,4832,4824,4844,4866,4778,4816,4814,-8,-10,43486,2093596760,94586
762,p1509,20150720,4816,4814,4806,4846,4772,4838,4816,24,2,35650,1717510880,90952
763,p1509,20150721,4838,4816,4846,4874,4818,4872,4848,56,32,43900,2128399320,90404
764,p1509,20150722,4872,4848,4892,4900,4828,4862,4866,14,18,39130,1904603720,83778
765,p1509,20150723,4862,4866,4846,4848,4810,4816,4826,-50,-40,24042,1160424240,84972
766,p1509,20150724,4816,4826,4810,4838,4794,4812,4814,-14,-12,19914,958692160,81852
767,p1509,20150727,4812,4814,4802,4816,4692,4712,4746,-102,-68,38066,1806682200,79624
768,p1509,20150728,4712,4746,4650,4742,4650,4712,4706,-34,-40,24470,1151735120,75646
769,p1509,20150729,4712,4706,4720,4784,4720,4748,4750,42,44,19130,908793920,75594
770,p1509,20150730,4748,4750,4732,4746,4710,4720,4724,-30,-26,21526,1017128920,76696
771,p1509,20150731,4720,4724,4750,4762,4688,4688,4716,-36,-8,27040,1275635920,77402
772,p1509,20150803,4688,4716,4678,4712,4582,4586,4638,-130,-78,31788,1474532040,71756
773,p1509,20150804,4586,4638,4580,4600,4540,4598,4578,-40,-60,30806,1410660040,65580
774,p1509,20150805,4598,4578,4598,4624,4548,4564,4576,-14,-2,21146,968021080,63956
775,p1509,20150806,4564,4576,4560,4560,4468,4476,4518,-100,-58,17522,791649080,62496
776,p1509,20150807,4476,4518,4468,4528,4434,4490,4482,-28,-36,28024,1256055280,58216
777,p1509,20150810,4490,4482,4478,4530,4446,4472,4474,-10,-8,20876,934128800,56694
778,p1509,20150811,4472,4474,4474,4586,4466,4534,4524,60,50,36650,1658774480,48704
779,p1509,20150812,4534,4524,4524,4546,4496,4546,4530,22,6,18906,856533360,47190
780,p1509,20150813,4546,4530,4548,4578,4386,4502,4488,-28,-42,23852,1070779160,46366
781,p1509,20150814,4502,4488,4488,4516,4478,4492,4494,4,6,7774,349413360,42784
782,p1509,20150817,4492,4494,4486,4508,4474,4492,4490,-2,-4,4236,190240200,40260
783,p1509,20150818,4492,4490,4492,4514,4436,4456,4464,-34,-26,5260,234810880,37536
784,p1509,20150819,4456,4464,4452,4476,4394,4424,4414,-40,-50,8366,369402920,37076
785,p1509,20150820,4424,4414,4412,4426,4326,4334,4380,-80,-34,4934,216115720,35634
786,p1509,20150821,4334,4380,4366,4366,4260,4272,4304,-108,-76,5804,249910720,34382
787,p1509,20150824,4272,4304,4256,4260,4132,4132,4194,-172,-110,2598,108987800,34132
788,p1509,20150825,4132,4194,3962,4034,3944,3968,3976,-226,-218,8410,334403680,32738
789,p1509,20150826,3968,3976,4056,4060,3952,3980,4004,4,28,4718,189003000,33434
790,p1509,20150827,3980,4004,3976,4010,3880,4002,3944,-2,-60,6582,259598720,32380
791,p1509,20150828,4002,3944,4042,4100,4000,4090,4070,146,126,4132,168249360,30638
792,p1509,20150831,4090,4070,4112,4114,4040,4048,4058,-22,-12,8440,342510080,28818
793,p1509,20150901,4048,4058,4048,4120,4026,4120,4072,62,14,1082,44072280,28502
794,p1509,20150902,4120,4072,4074,4074,4042,4042,4070,-30,-2,406,16524280,28502
795,p1509,20150907,4042,4070,4020,4020,4020,4020,4038,-50,-32,140,5654400,28502
796,p1509,20150908,4020,4038,4066,4110,4066,4066,4086,28,48,1684,68835240,28502
797,p1509,20150909,4066,4086,0,0,0,4106,4106,20,20,0,0,28502
798,p1509,20150910,4106,4106,4104,4128,4100,4128,4114,22,8,192,7901840,28502
799,p1509,20150911,4128,4114,4168,4168,4168,4168,4168,54,54,8,333440,28502
800,p1509,20150914,4168,4168,0,0,0,4158,4158,-10,-10,0,0,28502
801,p1509,20150915,4158,4158,4168,4178,4140,4140,4168,-18,10,176,7337200,28500
802,p1509,20150916,4140,4168,4148,4148,4148,4148,4084,-20,-84,10,414800,0
803,p1510,20150105,5092,5092,0,0,0,5092,5092,0,0,0,0,2
804,p1510,20150106,5092,5092,0,0,0,5092,5092,0,0,0,0,2
805,p1510,20150107,5092,5092,0,0,0,5092,5092,0,0,0,0,2
806,p1510,20150108,5092,5092,0,0,0,5092,5092,0,0,0,0,2
807,p1510,20150109,5092,5092,0,0,0,5120,5120,28,28,0,0,2
808,p1510,20150112,5120,5120,5204,5204,5124,5124,5164,4,44,4,206560,2
809,p1510,20150113,5124,5164,0,0,0,5164,5164,0,0,0,0,2
810,p1510,20150114,5164,5164,0,0,0,5130,5130,-34,-34,0,0,2
811,p1510,20150115,5130,5130,0,0,0,5100,5100,-30,-30,0,0,2
812,p1510,20150116,5100,5100,0,0,0,5082,5082,-18,-18,0,0,2
813,p1510,20150119,5082,5082,0,0,0,5082,5082,0,0,0,0,2
814,p1510,20150120,5082,5082,0,0,0,5082,5082,0,0,0,0,2
815,p1510,20150121,5082,5082,0,0,0,5058,5058,-24,-24,0,0,2
816,p1510,20150122,5058,5058,0,0,0,5006,5006,-52,-52,0,0,2
817,p1510,20150123,5006,5006,0,0,0,5006,5006,0,0,0,0,2
818,p1510,20150126,5006,5006,0,0,0,5006,5006,0,0,0,0,2
819,p1510,20150127,5006,5006,0,0,0,4962,4962,-44,-44,0,0,2
820,p1510,20150128,4962,4962,0,0,0,4834,4834,-128,-128,0,0,2
821,p1510,20150129,4834,4834,4658,4772,4658,4772,4714,-62,-120,4,188600,2
822,p1510,20150130,4772,4714,4604,4652,4604,4652,4628,-62,-86,4,185120,2
823,p1510,20150202,4652,4628,0,0,0,4662,4662,34,34,0,0,2
824,p1510,20150203,4662,4662,4722,4722,4722,4722,4722,60,60,2,94440,2
825,p1510,20150204,4722,4722,4772,4772,4772,4772,4772,50,50,2,95440,4
826,p1510,20150205,4772,4772,4738,4782,4738,4782,4760,10,-12,4,190400,6
827,p1510,20150206,4782,4760,4842,4842,4842,4842,4842,82,82,2,96840,4
828,p1510,20150209,4842,4842,0,0,0,4842,4842,0,0,0,0,4
829,p1510,20150210,4842,4842,0,0,0,4900,4900,58,58,0,0,4
830,p1510,20150211,4900,4900,0,0,0,4886,4886,-14,-14,0,0,4
831,p1510,20150212,4886,4886,0,0,0,4856,4856,-30,-30,0,0,4
832,p1510,20150213,4856,4856,0,0,0,4920,4920,64,64,0,0,4
833,p1510,20150216,4920,4920,4988,4988,4964,4964,4976,44,56,4,199040,4
834,p1510,20150217,4964,4976,0,0,0,4976,4976,0,0,0,0,4
835,p1510,20150225,4976,4976,0,0,0,4976,4976,0,0,0,0,4
836,p1510,20150226,4976,4976,0,0,0,4976,4976,0,0,0,0,4
837,p1510,20150227,4976,4976,4900,4902,4900,4902,4900,-74,-76,4,196040,4
838,p1510,20150302,4902,4900,0,0,0,5032,5032,132,132,0,0,4
839,p1510,20150303,5032,5032,0,0,0,5032,5032,0,0,0,0,4
840,p1510,20150304,5032,5032,0,0,0,5032,5032,0,0,0,0,4
841,p1510,20150305,5032,5032,4920,4920,4920,4920,4920,-112,-112,2,98400,6
842,p1510,20150306,4920,4920,4880,4880,4880,4880,4880,-40,-40,2,97600,6
843,p1510,20150309,4880,4880,4862,4862,4862,4862,4862,-18,-18,2,97240,4
844,p1510,20150310,4862,4862,4790,4790,4752,4752,4758,-110,-104,10,475960,8
845,p1510,20150311,4752,4758,4754,4758,4754,4758,4756,0,-2,8,380560,2
846,p1510,20150312,4758,4756,0,0,0,4758,4758,2,2,0,0,2
847,p1510,20150313,4758,4758,0,0,0,4758,4758,0,0,0,0,2
848,p1510,20150316,4758,4758,0,0,0,4670,4670,-88,-88,0,0,2
849,p1510,20150317,4670,4670,0,0,0,4680,4680,10,10,0,0,2
850,p1510,20150318,4680,4680,0,0,0,4666,4666,-14,-14,0,0,2
851,p1510,20150319,4666,4666,4760,4760,4730,4760,4754,94,88,10,475400,6
852,p1510,20150320,4760,4754,4758,4758,4748,4748,4750,-6,-4,6,285080,4
853,p1510,20150323,4748,4750,4752,4758,4718,4718,4734,-32,-16,24,1136520,6
854,p1510,20150324,4718,4734,0,0,0,4754,4754,20,20,0,0,6
855,p1510,20150325,4754,4754,4784,4784,4784,4784,4784,30,30,2,95680,6
856,p1510,20150326,4784,4784,4820,4820,4784,4784,4802,0,18,4,192080,6
857,p1510,20150327,4784,4802,0,0,0,4758,4758,-44,-44,0,0,6
858,p1510,20150330,4758,4758,0,0,0,4740,4740,-18,-18,0,0,6
859,p1510,20150331,4740,4740,4692,4720,4688,4718,4704,-22,-36,20,940800,4
860,p1510,20150401,4718,4704,0,0,0,4704,4704,0,0,0,0,4
861,p1510,20150402,4704,4704,0,0,0,4704,4704,0,0,0,0,4
862,p1510,20150403,4704,4704,0,0,0,4704,4704,0,0,0,0,4
863,p1510,20150407,4704,4704,0,0,0,4778,4778,74,74,0,0,4
864,p1510,20150408,4778,4778,0,0,0,4778,4778,0,0,0,0,4
865,p1510,20150409,4778,4778,0,0,0,4722,4722,-56,-56,0,0,4
866,p1510,20150410,4722,4722,4676,4724,4676,4724,4700,2,-22,4,188000,4
867,p1510,20150413,4724,4700,4742,4742,4704,4704,4722,4,22,4,188920,4
868,p1510,20150414,4704,4722,0,0,0,4722,4722,0,0,0,0,4
869,p1510,20150415,4722,4722,0,0,0,4764,4764,42,42,0,0,4
870,p1510,20150416,4764,4764,0,0,0,4764,4764,0,0,0,0,4
871,p1510,20150417,4764,4764,4764,4764,4764,4764,4764,0,0,2,95280,4
872,p1510,20150420,4764,4764,4816,4878,4816,4834,4854,70,90,14,679560,4
873,p1510,20150421,4834,4854,4910,4910,4910,4910,4910,56,56,2,98200,4
874,p1510,20150422,4910,4910,4988,4988,4988,4988,4988,78,78,2,99760,4
875,p1510,20150423,4988,4988,0,0,0,4988,4988,0,0,0,0,4
876,p1510,20150424,4988,4988,4912,5076,4792,4914,4946,-74,-42,232,11476680,50
877,p1510,20150427,4914,4946,4870,5124,4870,4982,4974,36,28,78,3880120,24
878,p1510,20150428,4982,4974,4996,5014,4954,4954,4978,-20,4,78,3883000,42
879,p1510,20150429,4954,4978,4934,4934,4932,4932,4932,-46,-46,4,197320,40
880,p1510,20150430,4932,4932,4980,4980,4924,4924,4938,-8,6,22,1086360,44
881,p1510,20150504,4924,4938,4998,5030,4988,5030,5004,92,66,12,600520,36
882,p1510,20150505,5030,5004,5016,5068,4966,5030,5020,26,16,102,5120960,76
883,p1510,20150506,5030,5020,5038,5168,5038,5168,5090,148,70,74,3767040,76
884,p1510,20150507,5168,5090,5122,5122,5038,5038,5052,-52,-38,34,1717840,74
885,p1510,20150508,5038,5052,5050,5050,4930,4930,4960,-122,-92,36,1785920,74
886,p1510,20150511,4930,4960,4990,5040,4988,5022,5008,62,48,56,2804680,72
887,p1510,20150512,5022,5008,5050,5090,5018,5036,5056,28,48,108,5461680,78
888,p1510,20150513,5036,5056,5120,5120,5074,5080,5088,24,32,16,814360,78
889,p1510,20150514,5080,5088,5074,5080,5068,5068,5076,-20,-12,22,1116720,80
890,p1510,20150515,5068,5076,5092,5092,5092,5092,5092,16,16,2,101840,80
891,p1510,20150518,5092,5092,5104,5104,5048,5072,5070,-20,-22,8,405640,80
892,p1510,20150519,5072,5070,5028,5028,5008,5008,5018,-62,-52,4,200720,78
893,p1510,20150520,5008,5018,4924,4940,4924,4930,4930,-88,-88,30,1479120,56
894,p1510,20150521,4930,4930,4902,4960,4902,4960,4930,30,0,4,197240,56
895,p1510,20150522,4960,4930,4988,4988,4930,4930,4952,0,22,14,693520,58
896,p1510,20150525,4930,4952,4930,4930,4930,4930,4930,-22,-22,8,394400,54
897,p1510,20150526,4930,4930,4988,5078,4988,5078,5018,148,88,10,501880,54
898,p1510,20150527,5078,5018,5102,5136,5086,5100,5102,82,84,38,1939360,54
899,p1510,20150528,5100,5102,5110,5118,5110,5112,5112,10,10,6,306800,54
900,p1510,20150529,5112,5112,5118,5156,5118,5126,5130,14,18,8,410480,54
901,p1510,20150601,5126,5130,5202,5210,5202,5210,5206,80,76,4,208240,54
902,p1510,20150602,5210,5206,5220,5220,5168,5216,5208,10,2,22,1146080,52
903,p1510,20150603,5216,5208,5218,5220,5188,5188,5192,-20,-16,24,1246360,50
904,p1510,20150604,5188,5192,5042,5132,5042,5120,5108,-72,-84,56,2861560,52
905,p1510,20150605,5120,5108,5128,5140,5062,5126,5112,18,4,54,2760960,46
906,p1510,20150608,5126,5112,5108,5112,5076,5076,5098,-36,-14,6,305920,48
907,p1510,20150609,5076,5098,5082,5082,4996,4996,5010,-102,-88,12,601240,40
908,p1510,20150610,4996,5010,0,0,0,5008,5008,-2,-2,0,0,40
909,p1510,20150611,5008,5008,5048,5064,5020,5038,5042,30,34,8,403400,40
910,p1510,20150612,5038,5042,4984,4990,4984,4984,4984,-58,-58,14,698000,26
911,p1510,20150615,4984,4984,4986,4986,4986,4986,4986,2,2,2,99720,24
912,p1510,20150616,4986,4986,0,0,0,4996,4996,10,10,0,0,24
913,p1510,20150617,4996,4996,0,0,0,5004,5004,8,8,0,0,24
914,p1510,20150618,5004,5004,4984,4984,4954,4954,4980,-50,-24,24,1195560,24
915,p1510,20150619,4954,4980,4924,5000,4918,5000,4944,20,-36,20,988800,28
916,p1510,20150623,5000,4944,5046,5046,5046,5046,5046,102,102,6,302760,28
917,p1510,20150624,5046,5046,5008,5008,5008,5008,5008,-38,-38,6,300480,26
918,p1510,20150625,5008,5008,5048,5048,5048,5048,5048,40,40,4,201920,22
919,p1510,20150626,5048,5048,5032,5032,5032,5032,5032,-16,-16,2,100640,20
920,p1510,20150629,5032,5032,5020,5020,4970,4996,4994,-36,-38,6,299720,16
921,p1510,20150630,4996,4994,4990,4990,4990,4990,4990,-4,-4,2,99800,18
922,p1510,20150701,4990,4990,0,0,0,5068,5068,78,78,0,0,18
923,p1510,20150702,5068,5068,0,0,0,5056,5056,-12,-12,0,0,18
924,p1510,20150703,5056,5056,5002,5010,5002,5010,5006,-46,-50,6,300440,14
925,p1510,20150706,5010,5006,0,0,0,4910,4910,-96,-96,0,0,14
926,p1510,20150707,4910,4910,0,0,0,4870,4870,-40,-40,0,0,14
927,p1510,20150708,4870,4870,4830,4832,4786,4786,4814,-84,-56,114,5490120,12
928,p1510,20150709,4786,4814,0,0,0,4742,4742,-72,-72,0,0,12
929,p1510,20150710,4742,4742,4804,4804,4804,4804,4804,62,62,2,96080,10
930,p1510,20150713,4804,4804,4916,4956,4822,4826,4870,22,66,12,584480,12
931,p1510,20150714,4826,4870,0,0,0,4942,4942,72,72,0,0,12
932,p1510,20150715,4942,4942,4972,4972,4972,4972,4972,30,30,6,298320,18
933,p1510,20150716,4972,4972,0,0,0,4930,4930,-42,-42,0,0,18
934,p1510,20150717,4930,4930,4932,4932,4932,4932,4932,2,2,2,98640,18
935,p1510,20150720,4932,4932,0,0,0,4934,4934,2,2,0,0,18
936,p1510,20150721,4934,4934,0,0,0,4934,4934,0,0,0,0,18
937,p1510,20150722,4934,4934,0,0,0,4934,4934,0,0,0,0,18
938,p1510,20150723,4934,4934,0,0,0,4894,4894,-40,-40,0,0,18
939,p1510,20150724,4894,4894,4850,4850,4850,4850,4850,-44,-44,2,97000,16
940,p1510,20150727,4850,4850,4972,4972,4804,4804,4888,-46,38,40,1955200,16
941,p1510,20150728,4804,4888,0,0,0,4840,4840,-48,-48,0,0,16
942,p1510,20150729,4840,4840,0,0,0,4840,4840,0,0,0,0,16
943,p1510,20150730,4840,4840,0,0,0,4814,4814,-26,-26,0,0,16
944,p1510,20150731,4814,4814,4876,4876,4876,4876,4876,62,62,2,97520,18
945,p1510,20150803,4876,4876,4760,4760,4760,4760,4760,-116,-116,2,95200,16
946,p1510,20150804,4760,4760,0,0,0,4700,4700,-60,-60,0,0,16
947,p1510,20150805,4700,4700,0,0,0,4698,4698,-2,-2,0,0,16
948,p1510,20150806,4698,4698,0,0,0,4640,4640,-58,-58,0,0,16
949,p1510,20150807,4640,4640,0,0,0,4604,4604,-36,-36,0,0,16
950,p1510,20150810,4604,4604,0,0,0,4596,4596,-8,-8,0,0,16
951,p1510,20150811,4596,4596,0,0,0,4596,4596,0,0,0,0,16
952,p1510,20150812,4596,4596,0,0,0,4602,4602,6,6,0,0,16
953,p1510,20150813,4602,4602,0,0,0,4560,4560,-42,-42,0,0,16
954,p1510,20150814,4560,4560,0,0,0,4566,4566,6,6,0,0,16
955,p1510,20150817,4566,4566,0,0,0,4562,4562,-4,-4,0,0,16
956,p1510,20150818,4562,4562,0,0,0,4536,4536,-26,-26,0,0,16
957,p1510,20150819,4536,4536,4550,4550,4550,4550,4550,14,14,2,91000,16
958,p1510,20150820,4550,4550,0,0,0,4516,4516,-34,-34,0,0,16
959,p1510,20150821,4516,4516,0,0,0,4438,4438,-78,-78,0,0,16
960,p1510,20150824,4438,4438,0,0,0,4414,4414,-24,-24,0,0,16
961,p1510,20150825,4414,4414,4238,4238,4238,4238,4238,-176,-176,2,84760,16
962,p1510,20150826,4238,4238,0,0,0,4238,4238,0,0,0,0,16
963,p1510,20150827,4238,4238,0,0,0,4176,4176,-62,-62,0,0,16
964,p1510,20150828,4176,4176,0,0,0,4308,4308,132,132,0,0,16
965,p1510,20150831,4308,4308,0,0,0,4296,4296,-12,-12,0,0,16
966,p1510,20150901,4296,4296,0,0,0,4310,4310,14,14,0,0,16
967,p1510,20150902,4310,4310,0,0,0,4308,4308,-2,-2,0,0,16
968,p1510,20150907,4308,4308,0,0,0,4276,4276,-32,-32,0,0,16
969,p1510,20150908,4276,4276,0,0,0,4276,4276,0,0,0,0,16
970,p1510,20150909,4276,4276,0,0,0,4276,4276,0,0,0,0,16
971,p1510,20150910,4276,4276,0,0,0,4284,4284,8,8,0,0,16
972,p1510,20150911,4284,4284,0,0,0,4340,4340,56,56,0,0,16
973,p1510,20150914,4340,4340,0,0,0,4340,4340,0,0,0,0,16
974,p1510,20150915,4340,4340,4422,4422,4234,4334,4344,-6,4,12,521320,8
975,p1510,20150916,4334,4344,0,0,0,4344,4344,0,0,0,0,8
976,p1510,20150917,4344,4344,4350,4350,4350,4350,4350,6,6,2,87000,6
977,p1510,20150918,4350,4350,4182,4182,4182,4182,4182,-168,-168,2,83640,4
978,p1510,20150921,4182,4182,4042,4042,4042,4042,4042,-140,-140,2,80840,4
979,p1510,20150922,4042,4042,0,0,0,4042,4042,0,0,0,0,4
980,p1510,20150923,4042,4042,0,0,0,4042,4042,0,0,0,0,4
981,p1510,20150924,4042,4042,0,0,0,4042,4042,0,0,0,0,4
982,p1510,20150925,4042,4042,4182,4192,4182,4192,4186,150,144,4,167480,8
983,p1510,20150928,4192,4186,4334,4334,4334,4334,4334,148,148,4,173360,4
984,p1510,20150929,4334,4334,4680,4680,4450,4450,4594,116,260,12,551440,4
985,p1510,20150930,4450,4594,4500,4500,4500,4500,4500,-94,-94,4,180000,0
986,p1510,20151008,4500,4500,0,0,0,4500,4500,0,0,0,0,0
987,p1510,20151009,4500,4500,0,0,0,4500,4500,0,0,0,0,0
988,p1510,20151012,4500,4500,0,0,0,4500,4500,0,0,0,0,0
989,p1510,20151013,4500,4500,0,0,0,4500,4500,0,0,0,0,0
990,p1510,20151014,4500,4500,0,0,0,4500,4500,0,0,0,0,0
991,p1510,20151015,4500,4500,0,0,0,4500,4500,0,0,0,0,0
992,p1510,20151016,4500,4500,0,0,0,4500,4500,0,0,0,0,0
993,p1510,20151019,4500,4500,0,0,0,4500,4500,0,0,0,0,0
994,p1510,20151020,4500,4500,0,0,0,4500,4500,0,0,0,0,0
995,p1510,20151021,4500,4500,0,0,0,4500,4500,0,0,0,0,0
996,p1511,20150105,5172,5172,5152,5152,5144,5144,5148,-28,-24,4,205920,10
997,p1511,20150106,5144,5148,5122,5188,5122,5144,5142,-4,-6,20,1028720,14
998,p1511,20150107,5144,5142,5178,5188,5178,5188,5182,46,40,4,207320,14
999,p1511,20150108,5188,5182,5224,5224,5174,5180,5192,-2,10,6,311560,12
1000,p1511,20150109,5180,5192,5180,5180,5156,5156,5168,-36,-24,8,413480,14
1001,p1511,20150112,5156,5168,5112,5168,5112,5168,5140,0,-28,4,205600,14
1002,p1511,20150113,5168,5140,5132,5132,5090,5090,5110,-50,-30,4,204440,14
1003,p1511,20150114,5090,5110,5052,5070,5052,5070,5060,-40,-50,4,202440,12
1004,p1511,20150115,5070,5060,0,0,0,5060,5060,0,0,0,0,12
1005,p1511,20150116,5060,5060,5016,5084,5016,5084,5050,24,-10,4,202000,14
1006,p1511,20150119,5084,5050,0,0,0,5040,5040,-10,-10,0,0,14
1007,p1511,20150120,5040,5040,0,0,0,5038,5038,-2,-2,0,0,14
1008,p1511,20150121,5038,5038,0,0,0,5034,5034,-4,-4,0,0,14
1009,p1511,20150122,5034,5034,0,0,0,5008,5008,-26,-26,0,0,14
1010,p1511,20150123,5008,5008,0,0,0,4930,4930,-78,-78,0,0,14
1011,p1511,20150126,4930,4930,4994,4994,4860,4860,4926,-70,-4,4,197080,12
1012,p1511,20150127,4860,4926,4832,4832,4810,4810,4820,-116,-106,18,867760,10
1013,p1511,20150128,4810,4820,4778,4778,4778,4778,4778,-42,-42,4,191120,14
1014,p1511,20150129,4778,4778,4748,4748,4746,4746,4746,-32,-32,6,284840,10
1015,p1511,20150130,4746,4746,4564,4654,4564,4654,4608,-92,-138,4,184360,12
1016,p1511,20150202,4654,4608,4666,4666,4666,4666,4666,58,58,2,93320,12
1017,p1511,20150203,4666,4666,4672,4672,4672,4672,4672,6,6,2,93440,10
1018,p1511,20150204,4672,4672,0,0,0,4702,4702,30,30,0,0,10
1019,p1511,20150205,4702,4702,0,0,0,4746,4746,44,44,0,0,10
1020,p1511,20150206,4746,4746,4850,4850,4850,4850,4850,104,104,2,97000,8
1021,p1511,20150209,4850,4850,0,0,0,4850,4850,0,0,0,0,8
1022,p1511,20150210,4850,4850,0,0,0,4850,4850,0,0,0,0,8
1023,p1511,20150211,4850,4850,0,0,0,4862,4862,12,12,0,0,8
1024,p1511,20150212,4862,4862,0,0,0,4862,4862,0,0,0,0,8
1025,p1511,20150213,4862,4862,0,0,0,4874,4874,12,12,0,0,8
1026,p1511,20150216,4874,4874,0,0,0,4902,4902,28,28,0,0,8
1027,p1511,20150217,4902,4902,0,0,0,4904,4904,2,2,0,0,8
1028,p1511,20150225,4904,4904,0,0,0,4904,4904,0,0,0,0,8
1029,p1511,20150226,4904,4904,0,0,0,4904,4904,0,0,0,0,8
1030,p1511,20150227,4904,4904,0,0,0,4960,4960,56,56,0,0,8
1031,p1511,20150302,4960,4960,5098,5098,5046,5054,5062,94,102,8,404960,8
1032,p1511,20150303,5054,5062,5008,5008,5008,5008,5008,-54,-54,2,100160,6
1033,p1511,20150304,5008,5008,0,0,0,5008,5008,0,0,0,0,6
1034,p1511,20150305,5008,5008,0,0,0,4986,4986,-22,-22,0,0,6
1035,p1511,20150306,4986,4986,0,0,0,4896,4896,-90,-90,0,0,6
1036,p1511,20150309,4896,4896,0,0,0,4890,4890,-6,-6,0,0,6
1037,p1511,20150310,4890,4890,4716,4716,4716,4716,4716,-174,-174,14,660240,20
1038,p1511,20150311,4716,4716,4720,4788,4718,4718,4726,2,10,18,850760,10
1039,p1511,20150312,4718,4726,0,0,0,4726,4726,0,0,0,0,10
1040,p1511,20150313,4726,4726,0,0,0,4726,4726,0,0,0,0,10
1041,p1511,20150316,4726,4726,4718,4718,4718,4718,4718,-8,-8,4,188720,10
1042,p1511,20150317,4718,4718,0,0,0,4718,4718,0,0,0,0,10
1043,p1511,20150318,4718,4718,0,0,0,4664,4664,-54,-54,0,0,10
1044,p1511,20150319,4664,4664,0,0,0,4672,4672,8,8,0,0,10
1045,p1511,20150320,4672,4672,0,0,0,4672,4672,0,0,0,0,10
1046,p1511,20150323,4672,4672,0,0,0,4672,4672,0,0,0,0,10
1047,p1511,20150324,4672,4672,0,0,0,4708,4708,36,36,0,0,10
1048,p1511,20150325,4708,4708,0,0,0,4708,4708,0,0,0,0,10
1049,p1511,20150326,4708,4708,0,0,0,4720,4720,12,12,0,0,10
1050,p1511,20150327,4720,4720,0,0,0,4720,4720,0,0,0,0,10
1051,p1511,20150330,4720,4720,0,0,0,4720,4720,0,0,0,0,10
1052,p1511,20150331,4720,4720,0,0,0,4714,4714,-6,-6,0,0,10
1053,p1511,20150401,4714,4714,0,0,0,4714,4714,0,0,0,0,10
1054,p1511,20150402,4714,4714,4668,4668,4664,4664,4666,-50,-48,6,280000,6
1055,p1511,20150403,4664,4666,0,0,0,4666,4666,0,0,0,0,6
1056,p1511,20150407,4666,4666,0,0,0,4704,4704,38,38,0,0,6
1057,p1511,20150408,4704,4704,0,0,0,4682,4682,-22,-22,0,0,6
1058,p1511,20150409,4682,4682,0,0,0,4644,4644,-38,-38,0,0,6
1059,p1511,20150410,4644,4644,0,0,0,4644,4644,0,0,0,0,6
1060,p1511,20150413,4644,4644,4718,4718,4646,4646,4684,2,40,84,3935080,28
1061,p1511,20150414,4646,4684,4678,4678,4674,4674,4676,-10,-8,12,561120,16
1062,p1511,20150415,4674,4676,4736,4736,4722,4722,4732,46,56,8,378600,8
1063,p1511,20150416,4722,4732,0,0,0,4782,4782,50,50,0,0,8
1064,p1511,20150417,4782,4782,0,0,0,4782,4782,0,0,0,0,8
1065,p1511,20150420,4782,4782,4826,4826,4826,4826,4826,44,44,2,96520,8
1066,p1511,20150421,4826,4826,0,0,0,4880,4880,54,54,0,0,8
1067,p1511,20150422,4880,4880,0,0,0,4880,4880,0,0,0,0,8
1068,p1511,20150423,4880,4880,0,0,0,4880,4880,0,0,0,0,8
1069,p1511,20150424,4880,4880,5020,5020,4868,4868,4944,-12,64,4,197760,10
1070,p1511,20150427,4868,4944,0,0,0,4970,4970,26,26,0,0,10
1071,p1511,20150428,4970,4970,0,0,0,4970,4970,0,0,0,0,10
1072,p1511,20150429,4970,4970,0,0,0,4906,4906,-64,-64,0,0,10
1073,p1511,20150430,4906,4906,0,0,0,4906,4906,0,0,0,0,10
1074,p1511,20150504,4906,4906,0,0,0,4962,4962,56,56,0,0,10
1075,p1511,20150505,4962,4962,0,0,0,4966,4966,4,4,0,0,10
1076,p1511,20150506,4966,4966,5150,5150,5150,5150,5150,184,184,4,206000,14
1077,p1511,20150507,5150,5150,0,0,0,5112,5112,-38,-38,0,0,14
1078,p1511,20150508,5112,5112,5096,5096,5060,5060,5084,-52,-28,6,305040,8
1079,p1511,20150511,5060,5084,0,0,0,5132,5132,48,48,0,0,8
1080,p1511,20150512,5132,5132,0,0,0,5180,5180,48,48,0,0,8
1081,p1511,20150513,5180,5180,5206,5206,5206,5206,5206,26,26,2,104120,6
1082,p1511,20150514,5206,5206,0,0,0,5194,5194,-12,-12,0,0,6
1083,p1511,20150515,5194,5194,0,0,0,5210,5210,16,16,0,0,6
1084,p1511,20150518,5210,5210,0,0,0,5188,5188,-22,-22,0,0,6
1085,p1511,20150519,5188,5188,0,0,0,5136,5136,-52,-52,0,0,6
1086,p1511,20150520,5136,5136,0,0,0,5046,5046,-90,-90,0,0,6
1087,p1511,20150521,5046,5046,4906,4992,4906,4960,4950,-86,-96,30,1485360,6
1088,p1511,20150522,4960,4950,0,0,0,4972,4972,22,22,0,0,6
1089,p1511,20150525,4972,4972,0,0,0,4950,4950,-22,-22,0,0,6
1090,p1511,20150526,4950,4950,0,0,0,5038,5038,88,88,0,0,6
1091,p1511,20150527,5038,5038,0,0,0,5122,5122,84,84,0,0,6
1092,p1511,20150528,5122,5122,0,0,0,5132,5132,10,10,0,0,6
1093,p1511,20150529,5132,5132,0,0,0,5150,5150,18,18,0,0,6
1094,p1511,20150601,5150,5150,0,0,0,5226,5226,76,76,0,0,6
1095,p1511,20150602,5226,5226,0,0,0,5228,5228,2,2,0,0,6
1096,p1511,20150603,5228,5228,0,0,0,5212,5212,-16,-16,0,0,6
1097,p1511,20150604,5212,5212,5198,5208,5126,5126,5172,-86,-40,48,2483120,20
1098,p1511,20150605,5126,5172,0,0,0,5172,5172,0,0,0,0,20
1099,p1511,20150608,5172,5172,0,0,0,5158,5158,-14,-14,0,0,20
1100,p1511,20150609,5158,5158,0,0,0,5070,5070,-88,-88,0,0,20
1101,p1511,20150610,5070,5070,5164,5164,5078,5090,5118,20,48,44,2252200,18
1102,p1511,20150611,5090,5118,0,0,0,5152,5152,34,34,0,0,18
1103,p1511,20150612,5152,5152,5114,5114,5032,5032,5052,-120,-100,8,404200,12
1104,p1511,20150615,5032,5052,5088,5088,5088,5088,5088,36,36,4,203520,8
1105,p1511,20150616,5088,5088,0,0,0,5100,5100,12,12,0,0,8
1106,p1511,20150617,5100,5100,5132,5132,5132,5132,5132,32,32,2,102640,8
1107,p1511,20150618,5132,5132,0,0,0,5108,5108,-24,-24,0,0,8
1108,p1511,20150619,5108,5108,0,0,0,5072,5072,-36,-36,0,0,8
1109,p1511,20150623,5072,5072,0,0,0,5176,5176,104,104,0,0,8
1110,p1511,20150624,5176,5176,0,0,0,5138,5138,-38,-38,0,0,8
1111,p1511,20150625,5138,5138,0,0,0,5178,5178,40,40,0,0,8
1112,p1511,20150626,5178,5178,0,0,0,5162,5162,-16,-16,0,0,8
1113,p1511,20150629,5162,5162,0,0,0,5124,5124,-38,-38,0,0,8
1114,p1511,20150630,5124,5124,0,0,0,5120,5120,-4,-4,0,0,8
1115,p1511,20150701,5120,5120,0,0,0,5200,5200,80,80,0,0,8
1116,p1511,20150702,5200,5200,0,0,0,5188,5188,-12,-12,0,0,8
1117,p1511,20150703,5188,5188,0,0,0,5138,5138,-50,-50,0,0,8
1118,p1511,20150706,5138,5138,0,0,0,5040,5040,-98,-98,0,0,8
1119,p1511,20150707,5040,5040,0,0,0,5000,5000,-40,-40,0,0,8
1120,p1511,20150708,5000,5000,0,0,0,4944,4944,-56,-56,0,0,8
1121,p1511,20150709,4944,4944,4748,4780,4748,4780,4760,-164,-184,10,476080,8
1122,p1511,20150710,4780,4760,4818,4818,4818,4818,4818,58,58,2,96360,6
1123,p1511,20150713,4818,4818,4822,5010,4822,4838,4872,20,54,8,389840,2
1124,p1511,20150714,4838,4872,0,0,0,4944,4944,72,72,0,0,2
1125,p1511,20150715,4944,4944,5058,5058,4954,4954,5006,10,62,4,200240,2
1126,p1511,20150716,4954,5006,0,0,0,4964,4964,-42,-42,0,0,2
1127,p1511,20150717,4964,4964,0,0,0,4966,4966,2,2,0,0,2
1128,p1511,20150720,4966,4966,0,0,0,4968,4968,2,2,0,0,2
1129,p1511,20150721,4968,4968,0,0,0,5000,5000,32,32,0,0,2
1130,p1511,20150722,5000,5000,0,0,0,5018,5018,18,18,0,0,2
1131,p1511,20150723,5018,5018,0,0,0,4978,4978,-40,-40,0,0,2
1132,p1511,20150724,4978,4978,0,0,0,4934,4934,-44,-44,0,0,2
1133,p1511,20150727,4934,4934,0,0,0,4972,4972,38,38,0,0,2
1134,p1511,20150728,4972,4972,0,0,0,4932,4932,-40,-40,0,0,2
1135,p1511,20150729,4932,4932,0,0,0,4978,4978,46,46,0,0,2
1136,p1511,20150730,4978,4978,0,0,0,4952,4952,-26,-26,0,0,2
1137,p1511,20150731,4952,4952,0,0,0,5014,5014,62,62,0,0,2
1138,p1511,20150803,5014,5014,0,0,0,4814,4814,-200,-200,0,0,2
1139,p1511,20150804,4814,4814,0,0,0,4752,4752,-62,-62,0,0,2
1140,p1511,20150805,4752,4752,0,0,0,4750,4750,-2,-2,0,0,2
1141,p1511,20150806,4750,4750,0,0,0,4690,4690,-60,-60,0,0,2
1142,p1511,20150807,4690,4690,0,0,0,4654,4654,-36,-36,0,0,2
1143,p1511,20150810,4654,4654,0,0,0,4654,4654,0,0,0,0,2
1144,p1511,20150811,4654,4654,0,0,0,4706,4706,52,52,0,0,2
1145,p1511,20150812,4706,4706,0,0,0,4712,4712,6,6,0,0,2
1146,p1511,20150813,4712,4712,0,0,0,4670,4670,-42,-42,0,0,2
1147,p1511,20150814,4670,4670,0,0,0,4676,4676,6,6,0,0,2
1148,p1511,20150817,4676,4676,0,0,0,4672,4672,-4,-4,0,0,2
1149,p1511,20150818,4672,4672,0,0,0,4646,4646,-26,-26,0,0,2
1150,p1511,20150819,4646,4646,0,0,0,4660,4660,14,14,0,0,2
1151,p1511,20150820,4660,4660,0,0,0,4626,4626,-34,-34,0,0,2
1152,p1511,20150821,4626,4626,0,0,0,4546,4546,-80,-80,0,0,2
1153,p1511,20150824,4546,4546,0,0,0,4430,4430,-116,-116,0,0,2
1154,p1511,20150825,4430,4430,0,0,0,4254,4254,-176,-176,0,0,2
1155,p1511,20150826,4254,4254,0,0,0,4282,4282,28,28,0,0,2
1156,p1511,20150827,4282,4282,0,0,0,4218,4218,-64,-64,0,0,2
1157,p1511,20150828,4218,4218,0,0,0,4352,4352,134,134,0,0,2
1158,p1511,20150831,4352,4352,0,0,0,4340,4340,-12,-12,0,0,2
1159,p1511,20150901,4340,4340,0,0,0,4354,4354,14,14,0,0,2
1160,p1511,20150902,4354,4354,0,0,0,4352,4352,-2,-2,0,0,2
1161,p1511,20150907,4352,4352,0,0,0,4318,4318,-34,-34,0,0,2
1162,p1511,20150908,4318,4318,0,0,0,4368,4368,50,50,0,0,2
1163,p1511,20150909,4368,4368,0,0,0,4368,4368,0,0,0,0,2
1164,p1511,20150910,4368,4368,0,0,0,4376,4376,8,8,0,0,2
1165,p1511,20150911,4376,4376,0,0,0,4432,4432,56,56,0,0,2
1166,p1511,20150914,4432,4432,0,0,0,4432,4432,0,0,0,0,2
1167,p1511,20150915,4432,4432,0,0,0,4436,4436,4,4,0,0,2
1168,p1511,20150916,4436,4436,0,0,0,4348,4348,-88,-88,0,0,2
1169,p1511,20150917,4348,4348,0,0,0,4354,4354,6,6,0,0,2
1170,p1511,20150918,4354,4354,0,0,0,4186,4186,-168,-168,0,0,2
1171,p1511,20150921,4186,4186,4054,4054,4054,4054,4054,-132,-132,2,81080,0
1172,p1511,20150922,4054,4054,0,0,0,4054,4054,0,0,0,0,0
1173,p1511,20150923,4054,4054,0,0,0,4054,4054,0,0,0,0,0
1174,p1511,20150924,4054,4054,0,0,0,4054,4054,0,0,0,0,0
1175,p1511,20150925,4054,4054,0,0,0,4198,4198,144,144,0,0,0
1176,p1511,20150928,4198,4198,0,0,0,4346,4346,148,148,0,0,0
1177,p1511,20150929,4346,4346,0,0,0,4518,4518,172,172,0,0,0
1178,p1511,20150930,4518,4518,0,0,0,4426,4426,-92,-92,0,0,0
1179,p1511,20151008,4426,4426,0,0,0,4426,4426,0,0,0,0,0
1180,p1511,20151009,4426,4426,0,0,0,4426,4426,0,0,0,0,0
1181,p1511,20151012,4426,4426,0,0,0,4426,4426,0,0,0,0,0
1182,p1511,20151013,4426,4426,0,0,0,4426,4426,0,0,0,0,0
1183,p1511,20151014,4426,4426,0,0,0,4426,4426,0,0,0,0,0
1184,p1511,20151015,4426,4426,0,0,0,4426,4426,0,0,0,0,0
1185,p1511,20151016,4426,4426,0,0,0,4426,4426,0,0,0,0,0
1186,p1511,20151019,4426,4426,0,0,0,4426,4426,0,0,0,0,0
1187,p1511,20151020,4426,4426,0,0,0,4426,4426,0,0,0,0,0
1188,p1511,20151021,4426,4426,0,0,0,4426,4426,0,0,0,0,0
1189,p1511,20151022,4426,4426,0,0,0,4426,4426,0,0,0,0,0
1190,p1511,20151023,4426,4426,0,0,0,4426,4426,0,0,0,0,0
1191,p1511,20151026,4426,4426,0,0,0,4426,4426,0,0,0,0,0
1192,p1511,20151027,4426,4426,0,0,0,4426,4426,0,0,0,0,0
1193,p1511,20151028,4426,4426,0,0,0,4426,4426,0,0,0,0,0
1194,p1511,20151029,4426,4426,0,0,0,4426,4426,0,0,0,0,0
1195,p1511,20151030,4426,4426,4420,4420,4420,4420,4420,-6,-6,10,442000,10
1196,p1511,20151102,4420,4420,0,0,0,4420,4420,0,0,0,0,10
1197,p1511,20151103,4420,4420,4390,4390,4390,4390,4390,-30,-30,10,439000,0
1198,p1511,20151104,4390,4390,0,0,0,4390,4390,0,0,0,0,0
1199,p1511,20151105,4390,4390,0,0,0,4390,4390,0,0,0,0,0
1200,p1511,20151106,4390,4390,0,0,0,4390,4390,0,0,0,0,0
1201,p1511,20151109,4390,4390,0,0,0,4390,4390,0,0,0,0,0
1202,p1511,20151110,4390,4390,0,0,0,4390,4390,0,0,0,0,0
1203,p1511,20151111,4390,4390,0,0,0,4390,4390,0,0,0,0,0
1204,p1511,20151112,4390,4390,0,0,0,4390,4390,0,0,0,0,0
1205,p1511,20151113,4390,4390,0,0,0,4390,4390,0,0,0,0,0
1206,p1512,20150105,5134,5134,0,0,0,5112,5112,-22,-22,0,0,2
1207,p1512,20150106,5112,5112,0,0,0,5108,5108,-4,-4,0,0,2
1208,p1512,20150107,5108,5108,0,0,0,5146,5146,38,38,0,0,2
1209,p1512,20150108,5146,5146,5212,5212,5118,5172,5162,26,16,114,5886480,2
1210,p1512,20150109,5172,5162,5152,5186,5150,5150,5162,-12,0,6,309760,6
1211,p1512,20150112,5150,5162,0,0,0,5162,5162,0,0,0,0,6
1212,p1512,20150113,5162,5162,5132,5132,5104,5104,5118,-58,-44,4,204720,6
1213,p1512,20150114,5104,5118,0,0,0,5112,5112,-6,-6,0,0,6
1214,p1512,20150115,5112,5112,0,0,0,5112,5112,0,0,0,0,6
1215,p1512,20150116,5112,5112,5028,5136,5000,5000,5054,-112,-58,6,303280,6
1216,p1512,20150119,5000,5054,4988,4988,4988,4988,4988,-66,-66,2,99760,8
1217,p1512,20150120,4988,4988,4994,4994,4994,4994,4994,6,6,2,99880,8
1218,p1512,20150121,4994,4994,0,0,0,5000,5000,6,6,0,0,8
1219,p1512,20150122,5000,5000,0,0,0,4974,4974,-26,-26,0,0,8
1220,p1512,20150123,4974,4974,0,0,0,4916,4916,-58,-58,0,0,8
1221,p1512,20150126,4916,4916,4876,4892,4826,4826,4866,-90,-50,28,1362800,18
1222,p1512,20150127,4826,4866,4838,4850,4790,4806,4818,-60,-48,44,2120720,36
1223,p1512,20150128,4806,4818,4800,4820,4700,4780,4760,-38,-58,384,18280040,30
1224,p1512,20150129,4780,4760,4780,4780,4736,4736,4758,-24,-2,4,190320,28
1225,p1512,20150130,4736,4758,4668,4678,4658,4678,4664,-80,-94,10,466560,30
1226,p1512,20150202,4678,4664,4698,4698,4676,4676,4690,12,26,6,281440,30
1227,p1512,20150203,4676,4690,0,0,0,4702,4702,12,12,0,0,30
1228,p1512,20150204,4702,4702,0,0,0,4706,4706,4,4,0,0,30
1229,p1512,20150205,4706,4706,0,0,0,4750,4750,44,44,0,0,30
1230,p1512,20150206,4750,4750,4824,4902,4824,4850,4862,100,112,20,972760,36
1231,p1512,20150209,4850,4862,0,0,0,4862,4862,0,0,0,0,36
1232,p1512,20150210,4862,4862,4850,4850,4850,4850,4850,-12,-12,2,97000,38
1233,p1512,20150211,4850,4850,0,0,0,4850,4850,0,0,0,0,38
1234,p1512,20150212,4850,4850,0,0,0,4850,4850,0,0,0,0,38
1235,p1512,20150213,4850,4850,0,0,0,4900,4900,50,50,0,0,38
1236,p1512,20150216,4900,4900,4900,4992,4900,4958,4950,58,50,10,495000,40
1237,p1512,20150217,4958,4950,4948,4948,4948,4948,4948,-2,-2,4,197920,36
1238,p1512,20150225,4948,4948,4948,4948,4896,4896,4910,-52,-38,8,392840,32
1239,p1512,20150226,4896,4910,0,0,0,4910,4910,0,0,0,0,32
1240,p1512,20150227,4910,4910,0,0,0,4950,4950,40,40,0,0,32
1241,p1512,20150302,4950,4950,5004,5080,5002,5080,5028,130,78,6,301720,30
1242,p1512,20150303,5080,5028,0,0,0,5028,5028,0,0,0,0,30
1243,p1512,20150304,5028,5028,5008,5008,5008,5008,5008,-20,-20,4,200320,30
1244,p1512,20150305,5008,5008,4888,4888,4888,4888,4888,-120,-120,2,97760,32
1245,p1512,20150306,4888,4888,4884,4898,4884,4898,4894,10,6,10,489480,30
1246,p1512,20150309,4898,4894,4796,4878,4794,4876,4858,-18,-36,20,971800,28
1247,p1512,20150310,4876,4858,4808,4808,4808,4808,4808,-50,-50,10,480800,28
1248,p1512,20150311,4808,4808,4792,4814,4756,4760,4786,-48,-22,10,478680,30
1249,p1512,20150312,4760,4786,4772,4772,4772,4772,4772,-14,-14,2,95440,30
1250,p1512,20150313,4772,4772,4752,4752,4752,4752,4752,-20,-20,2,95040,30
1251,p1512,20150316,4752,4752,4768,4768,4696,4696,4736,-56,-16,8,378960,34
1252,p1512,20150317,4696,4736,4710,4710,4710,4710,4710,-26,-26,4,188400,38
1253,p1512,20150318,4710,4710,4674,4700,4662,4700,4686,-10,-24,18,843600,32
1254,p1512,20150319,4700,4686,0,0,0,4774,4774,88,88,0,0,32
1255,p1512,20150320,4774,4774,4792,4792,4792,4792,4792,18,18,2,95840,32
1256,p1512,20150323,4792,4792,4728,4728,4728,4728,4728,-64,-64,2,94560,32
1257,p1512,20150324,4728,4728,4802,4830,4802,4812,4818,84,90,22,1059960,30
1258,p1512,20150325,4812,4818,0,0,0,4848,4848,30,30,0,0,30
1259,p1512,20150326,4848,4848,0,0,0,4866,4866,18,18,0,0,30
1260,p1512,20150327,4866,4866,0,0,0,4846,4846,-20,-20,0,0,30
1261,p1512,20150330,4846,4846,4784,4784,4722,4722,4762,-124,-84,8,380960,32
1262,p1512,20150331,4722,4762,4756,4756,4756,4756,4756,-6,-6,2,95120,32
1263,p1512,20150401,4756,4756,0,0,0,4756,4756,0,0,0,0,32
1264,p1512,20150402,4756,4756,0,0,0,4756,4756,0,0,0,0,32
1265,p1512,20150403,4756,4756,0,0,0,4756,4756,0,0,0,0,32
1266,p1512,20150407,4756,4756,0,0,0,4802,4802,46,46,0,0,32
1267,p1512,20150408,4802,4802,4806,4806,4802,4802,4804,0,2,4,192160,32
1268,p1512,20150409,4802,4804,4764,4764,4764,4764,4764,-40,-40,2,95280,30
1269,p1512,20150410,4764,4764,0,0,0,4764,4764,0,0,0,0,30
1270,p1512,20150413,4764,4764,0,0,0,4764,4764,0,0,0,0,30
1271,p1512,20150414,4764,4764,0,0,0,4764,4764,0,0,0,0,30
1272,p1512,20150415,4764,4764,0,0,0,4766,4766,2,2,0,0,30
1273,p1512,20150416,4766,4766,4764,4840,4764,4840,4794,74,28,8,383600,34
1274,p1512,20150417,4840,4794,4812,4812,4812,4812,4812,18,18,8,384960,34
1275,p1512,20150420,4812,4812,4854,4854,4854,4854,4854,42,42,4,194160,30
1276,p1512,20150421,4854,4854,0,0,0,4942,4942,88,88,0,0,30
1277,p1512,20150422,4942,4942,4934,4934,4930,4930,4932,-12,-10,4,197280,30
1278,p1512,20150423,4930,4932,0,0,0,4932,4932,0,0,0,0,30
1279,p1512,20150424,4932,4932,4948,4948,4948,4948,4948,16,16,2,98960,30
1280,p1512,20150427,4948,4948,0,0,0,4948,4948,0,0,0,0,30
1281,p1512,20150428,4948,4948,0,0,0,4946,4946,-2,-2,0,0,30
1282,p1512,20150429,4946,4946,0,0,0,4936,4936,-10,-10,0,0,30
1283,p1512,20150430,4936,4936,0,0,0,4936,4936,0,0,0,0,30
1284,p1512,20150504,4936,4936,0,0,0,5000,5000,64,64,0,0,30
1285,p1512,20150505,5000,5000,5064,5074,5064,5074,5068,74,68,4,202760,32
1286,p1512,20150506,5074,5068,5106,5264,5106,5264,5184,196,116,4,207400,34
1287,p1512,20150507,5264,5184,0,0,0,5146,5146,-38,-38,0,0,34
1288,p1512,20150508,5146,5146,5116,5116,5116,5116,5116,-30,-30,2,102320,36
1289,p1512,20150511,5116,5116,0,0,0,5116,5116,0,0,0,0,36
1290,p1512,20150512,5116,5116,5190,5190,5094,5094,5142,-22,26,4,205680,36
1291,p1512,20150513,5094,5142,5238,5240,5234,5234,5238,92,96,8,419040,36
1292,p1512,20150514,5234,5238,5198,5198,5198,5198,5198,-40,-40,2,103960,36
1293,p1512,20150515,5198,5198,0,0,0,5214,5214,16,16,0,0,36
1294,p1512,20150518,5214,5214,0,0,0,5192,5192,-22,-22,0,0,36
1295,p1512,20150519,5192,5192,5150,5150,5150,5150,5150,-42,-42,2,103000,34
1296,p1512,20150520,5150,5150,5038,5038,5038,5038,5038,-112,-112,2,100760,34
1297,p1512,20150521,5038,5038,0,0,0,4944,4944,-94,-94,0,0,34
1298,p1512,20150522,4944,4944,5068,5068,5068,5068,5068,124,124,2,101360,34
1299,p1512,20150525,5068,5068,0,0,0,5046,5046,-22,-22,0,0,34
1300,p1512,20150526,5046,5046,0,0,0,5136,5136,90,90,0,0,34
1301,p1512,20150527,5136,5136,5250,5250,5198,5198,5226,62,90,32,1672600,32
1302,p1512,20150528,5198,5226,5332,5332,5212,5212,5290,-14,64,24,1269720,24
1303,p1512,20150529,5212,5290,0,0,0,5308,5308,18,18,0,0,24
1304,p1512,20150601,5308,5308,5274,5384,5274,5360,5302,52,-6,28,1485080,14
1305,p1512,20150602,5360,5302,5420,5452,5400,5414,5428,112,126,14,760120,14
1306,p1512,20150603,5414,5428,0,0,0,5412,5412,-16,-16,0,0,14
1307,p1512,20150604,5412,5412,5280,5280,5280,5280,5280,-132,-132,2,105600,12
1308,p1512,20150605,5280,5280,0,0,0,5284,5284,4,4,0,0,12
1309,p1512,20150608,5284,5284,5372,5372,5330,5330,5366,46,82,14,751240,18
1310,p1512,20150609,5330,5366,5266,5284,5246,5246,5266,-120,-100,44,2317400,18
1311,p1512,20150610,5246,5266,5278,5278,5278,5278,5278,12,12,2,105560,18
1312,p1512,20150611,5278,5278,5242,5242,5242,5242,5242,-36,-36,2,104840,18
1313,p1512,20150612,5242,5242,0,0,0,5156,5156,-86,-86,0,0,18
1314,p1512,20150615,5156,5156,0,0,0,5192,5192,36,36,0,0,18
1315,p1512,20150616,5192,5192,5212,5212,5190,5190,5202,-2,10,8,416160,18
1316,p1512,20150617,5190,5202,0,0,0,5234,5234,32,32,0,0,18
1317,p1512,20150618,5234,5234,0,0,0,5210,5210,-24,-24,0,0,18
1318,p1512,20150619,5210,5210,0,0,0,5126,5126,-84,-84,0,0,18
1319,p1512,20150623,5126,5126,5092,5092,5092,5092,5092,-34,-34,2,101840,18
1320,p1512,20150624,5092,5092,5154,5154,5132,5132,5142,40,50,4,205720,18
1321,p1512,20150625,5132,5142,0,0,0,5142,5142,0,0,0,0,18
1322,p1512,20150626,5142,5142,0,0,0,5126,5126,-16,-16,0,0,18
1323,p1512,20150629,5126,5126,0,0,0,5088,5088,-38,-38,0,0,18
1324,p1512,20150630,5088,5088,0,0,0,5084,5084,-4,-4,0,0,18
1325,p1512,20150701,5084,5084,0,0,0,5164,5164,80,80,0,0,18
1326,p1512,20150702,5164,5164,0,0,0,5152,5152,-12,-12,0,0,18
1327,p1512,20150703,5152,5152,0,0,0,5140,5140,-12,-12,0,0,18
1328,p1512,20150706,5140,5140,4946,5106,4946,4964,5058,-176,-82,24,1214360,22
1329,p1512,20150707,4964,5058,4976,4976,4890,4890,4932,-168,-126,4,197320,24
1330,p1512,20150708,4890,4932,0,0,0,4876,4876,-56,-56,0,0,24
1331,p1512,20150709,4876,4876,4682,4962,4682,4888,4834,12,-42,18,870440,26
1332,p1512,20150710,4888,4834,4946,4946,4946,4946,4946,112,112,2,98920,26
1333,p1512,20150713,4946,4946,4940,4940,4940,4940,4940,-6,-6,4,197600,26
1334,p1512,20150714,4940,4940,4950,5022,4950,5022,4986,82,46,10,498760,24
1335,p1512,20150715,5022,4986,0,0,0,4986,4986,0,0,0,0,24
1336,p1512,20150716,4986,4986,4948,4948,4888,4888,4918,-98,-68,4,196720,24
1337,p1512,20150717,4888,4918,4966,4966,4920,4920,4942,2,24,4,197720,24
1338,p1512,20150720,4920,4942,0,0,0,4944,4944,2,2,0,0,24
1339,p1512,20150721,4944,4944,0,0,0,4944,4944,0,0,0,0,24
1340,p1512,20150722,4944,4944,0,0,0,4944,4944,0,0,0,0,24
1341,p1512,20150723,4944,4944,0,0,0,4904,4904,-40,-40,0,0,24
1342,p1512,20150724,4904,4904,0,0,0,4860,4860,-44,-44,0,0,24
1343,p1512,20150727,4860,4860,0,0,0,4838,4838,-22,-22,0,0,24
1344,p1512,20150728,4838,4838,0,0,0,4798,4798,-40,-40,0,0,24
1345,p1512,20150729,4798,4798,0,0,0,4842,4842,44,44,0,0,24
1346,p1512,20150730,4842,4842,0,0,0,4816,4816,-26,-26,0,0,24
1347,p1512,20150731,4816,4816,0,0,0,4816,4816,0,0,0,0,24
1348,p1512,20150803,4816,4816,0,0,0,4702,4702,-114,-114,0,0,24
1349,p1512,20150804,4702,4702,0,0,0,4642,4642,-60,-60,0,0,24
1350,p1512,20150805,4642,4642,0,0,0,4640,4640,-2,-2,0,0,24
1351,p1512,20150806,4640,4640,0,0,0,4582,4582,-58,-58,0,0,24
1352,p1512,20150807,4582,4582,0,0,0,4546,4546,-36,-36,0,0,24
1353,p1512,20150810,4546,4546,4642,4680,4640,4640,4672,94,126,328,15327160,314
1354,p1512,20150811,4640,4672,4676,4796,4676,4796,4718,124,46,124,5851920,220
1355,p1512,20150812,4796,4718,4768,4790,4732,4778,4754,60,36,106,5039360,136
1356,p1512,20150813,4778,4754,4798,4848,4690,4720,4782,-34,28,82,3922720,92
1357,p1512,20150814,4720,4782,4756,4772,4680,4680,4716,-102,-66,106,4999240,50
1358,p1512,20150817,4680,4716,0,0,0,4712,4712,-4,-4,0,0,50
1359,p1512,20150818,4712,4712,0,0,0,4686,4686,-26,-26,0,0,50
1360,p1512,20150819,4686,4686,4612,4624,4576,4624,4602,-62,-84,12,552240,48
1361,p1512,20150820,4624,4602,4602,4602,4560,4560,4580,-42,-22,4,183240,48
1362,p1512,20150821,4560,4580,4502,4550,4502,4550,4526,-30,-54,4,181040,48
1363,p1512,20150824,4550,4526,4376,4376,4346,4346,4356,-180,-170,6,261360,48
1364,p1512,20150825,4346,4356,4268,4268,4192,4240,4236,-116,-120,10,423600,46
1365,p1512,20150826,4240,4236,0,0,0,4236,4236,0,0,0,0,46
1366,p1512,20150827,4236,4236,0,0,0,4174,4174,-62,-62,0,0,46
1367,p1512,20150828,4174,4174,0,0,0,4306,4306,132,132,0,0,46
1368,p1512,20150831,4306,4306,4350,4350,4350,4350,4350,44,44,2,87000,44
1369,p1512,20150901,4350,4350,4350,4398,4350,4364,4374,14,24,24,1049800,38
1370,p1512,20150902,4364,4374,0,0,0,4372,4372,-2,-2,0,0,38
1371,p1512,20150907,4372,4372,0,0,0,4338,4338,-34,-34,0,0,38
1372,p1512,20150908,4338,4338,0,0,0,4388,4388,50,50,0,0,38
1373,p1512,20150909,4388,4388,0,0,0,4388,4388,0,0,0,0,38
1374,p1512,20150910,4388,4388,0,0,0,4396,4396,8,8,0,0,38
1375,p1512,20150911,4396,4396,0,0,0,4452,4452,56,56,0,0,38
1376,p1512,20150914,4452,4452,4402,4402,4368,4368,4382,-84,-70,8,350560,38
1377,p1512,20150915,4368,4382,4442,4442,4442,4442,4442,60,60,2,88840,38
1378,p1512,20150916,4442,4442,0,0,0,4418,4418,-24,-24,0,0,38
1379,p1512,20150917,4418,4418,0,0,0,4424,4424,6,6,0,0,38
1380,p1512,20150918,4424,4424,0,0,0,4254,4254,-170,-170,0,0,38
1381,p1512,20150921,4254,4254,4342,4342,4342,4342,4342,88,88,4,173680,38
1382,p1512,20150922,4342,4342,4410,4410,4410,4410,4410,68,68,2,88200,38
1383,p1512,20150923,4410,4410,4362,4406,4362,4406,4390,-4,-20,8,351280,38
1384,p1512,20150924,4406,4390,4506,4506,4428,4460,4440,70,50,24,1066040,30
1385,p1512,20150925,4460,4440,4470,4590,4470,4590,4534,150,94,6,272080,30
1386,p1512,20150928,4590,4534,4590,4648,4590,4604,4608,70,74,14,645160,34
1387,p1512,20150929,4604,4608,4590,4590,4506,4506,4560,-102,-48,14,638640,34
1388,p1512,20150930,4506,4560,4582,4582,4540,4554,4552,-6,-8,18,819520,22
1389,p1512,20151008,4554,4552,0,0,0,4552,4552,0,0,0,0,22
1390,p1512,20151009,4552,4552,0,0,0,4552,4552,0,0,0,0,22
1391,p1512,20151012,4552,4552,4608,4706,4600,4706,4634,154,82,42,1946640,18
1392,p1512,20151013,4706,4634,0,0,0,4634,4634,0,0,0,0,18
1393,p1512,20151014,4634,4634,0,0,0,4634,4634,0,0,0,0,18
1394,p1512,20151015,4634,4634,4660,4716,4660,4716,4688,82,54,4,187520,18
1395,p1512,20151016,4716,4688,4786,4786,4772,4772,4778,84,90,4,191160,18
1396,p1512,20151019,4772,4778,0,0,0,4778,4778,0,0,0,0,18
1397,p1512,20151020,4778,4778,4600,4700,4600,4700,4654,-78,-124,6,279320,18
1398,p1512,20151021,4700,4654,4598,4598,4598,4598,4598,-56,-56,2,91960,18
1399,p1512,20151022,4598,4598,4780,4780,4602,4610,4636,12,38,24,1112920,24
1400,p1512,20151023,4610,4636,0,0,0,4636,4636,0,0,0,0,24
1401,p1512,20151026,4636,4636,4452,4656,4452,4462,4544,-174,-92,16,727200,24
1402,p1512,20151027,4462,4544,4514,4514,4514,4514,4514,-30,-30,2,90280,22
1403,p1512,20151028,4514,4514,0,0,0,4514,4514,0,0,0,0,22
1404,p1512,20151029,4514,4514,4390,4570,4390,4488,4468,-26,-46,54,2412760,22
1405,p1512,20151030,4488,4468,0,0,0,4462,4462,-6,-6,0,0,22
1406,p1512,20151102,4462,4462,0,0,0,4462,4462,0,0,0,0,22
1407,p1512,20151103,4462,4462,0,0,0,4432,4432,-30,-30,0,0,22
1408,p1512,20151104,4432,4432,0,0,0,4432,4432,0,0,0,0,22
1409,p1512,20151105,4432,4432,0,0,0,4432,4432,0,0,0,0,22
1410,p1512,20151106,4432,4432,0,0,0,4432,4432,0,0,0,0,22
1411,p1512,20151109,4432,4432,0,0,0,4432,4432,0,0,0,0,22
1412,p1512,20151110,4432,4432,4300,4450,4300,4450,4382,18,-50,6,263000,22
1413,p1512,20151111,4450,4382,4480,4480,4480,4480,4480,98,98,2,89600,22
1414,p1512,20151112,4480,4480,0,0,0,4480,4480,0,0,0,0,22
1415,p1512,20151113,4480,4480,0,0,0,4480,4480,0,0,0,0,22
1416,p1512,20151116,4480,4480,0,0,0,4480,4480,0,0,0,0,22
1417,p1512,20151117,4480,4480,0,0,0,4480,4480,0,0,0,0,22
1418,p1512,20151118,4480,4480,0,0,0,4480,4480,0,0,0,0,22
1419,p1512,20151119,4480,4480,0,0,0,4480,4480,0,0,0,0,22
1420,p1512,20151120,4480,4480,0,0,0,4480,4480,0,0,0,0,22
1421,p1512,20151123,4480,4480,4568,4658,4442,4442,4556,-38,76,6,273360,24
1422,p1512,20151124,4442,4556,4374,4374,4374,4374,4374,-182,-182,2,87480,24
1423,p1512,20151125,4374,4374,4210,4400,4112,4112,4212,-262,-162,32,1347840,26
1424,p1512,20151126,4112,4212,4044,4046,4044,4046,4044,-166,-168,4,161800,26
1425,p1512,20151127,4046,4044,0,0,0,4044,4044,0,0,0,0,26
1426,p1512,20151130,4044,4044,3996,3996,3884,3884,3892,-160,-152,28,1089760,0
1427,p1512,20151201,3884,3892,0,0,0,3892,3892,0,0,0,0,0
1428,p1512,20151202,3892,3892,0,0,0,3892,3892,0,0,0,0,0
1429,p1512,20151203,3892,3892,0,0,0,3892,3892,0,0,0,0,0
1430,p1512,20151204,3892,3892,0,0,0,3892,3892,0,0,0,0,0
1431,p1512,20151207,3892,3892,0,0,0,3892,3892,0,0,0,0,0
1432,p1512,20151208,3892,3892,0,0,0,3892,3892,0,0,0,0,0
1433,p1512,20151209,3892,3892,0,0,0,3892,3892,0,0,0,0,0
1434,p1512,20151210,3892,3892,0,0,0,3892,3892,0,0,0,0,0
1435,p1512,20151211,3892,3892,0,0,0,3892,3892,0,0,0,0,0
1436,p1512,20151214,3892,3892,0,0,0,3892,3892,0,0,0,0,0
1437,p1601,20150119,4994,4994,5026,5088,4902,4954,4974,-40,-20,1258,62583800,1130
1438,p1601,20150120,4954,4974,4960,4972,4946,4958,4958,-16,-16,874,43335040,1332
1439,p1601,20150121,4958,4958,4968,4972,4940,4948,4956,-10,-2,1192,59090040,2076
1440,p1601,20150122,4948,4956,4908,4948,4908,4912,4924,-44,-32,1290,63540120,2994
1441,p1601,20150123,4912,4924,4926,4926,4850,4856,4874,-68,-50,1544,75255080,3614
1442,p1601,20150126,4856,4874,4870,4874,4812,4812,4838,-62,-36,1992,96388400,4498
1443,p1601,20150127,4812,4838,4808,4816,4744,4754,4780,-84,-58,6444,308111000,6230
1444,p1601,20150128,4754,4780,4762,4776,4730,4752,4750,-28,-30,2344,111342000,6682
1445,p1601,20150129,4752,4750,4758,4758,4674,4704,4704,-46,-46,3812,179347320,6190
1446,p1601,20150130,4704,4704,4656,4678,4578,4598,4622,-106,-82,8798,406773120,9878
1447,p1601,20150202,4598,4622,4630,4642,4582,4628,4622,6,0,2450,113260760,10458
1448,p1601,20150203,4628,4622,4650,4682,4640,4670,4662,48,40,2332,108727920,10962
1449,p1601,20150204,4670,4662,4682,4736,4670,4674,4700,12,38,4476,210414600,12082
1450,p1601,20150205,4674,4700,4682,4768,4652,4726,4696,26,-4,5850,274824400,13638
1451,p1601,20150206,4726,4696,4770,4860,4770,4804,4798,108,102,15380,738214400,17720
1452,p1601,20150209,4804,4798,4830,4838,4788,4828,4814,30,16,7428,357641600,20210
1453,p1601,20150210,4828,4814,4802,4850,4790,4844,4826,30,12,4574,220821880,19636
1454,p1601,20150211,4844,4826,4828,4840,4806,4826,4818,0,-8,4436,213758080,18890
1455,p1601,20150212,4826,4818,4808,4818,4784,4794,4802,-24,-16,2184,104892640,18494
1456,p1601,20150213,4794,4802,4810,4896,4802,4896,4862,94,60,4920,239269240,18246
1457,p1601,20150216,4896,4862,4880,4932,4878,4900,4910,38,48,2746,134852520,18440
1458,p1601,20150217,4900,4910,4902,4916,4894,4902,4900,-8,-10,1096,53723400,18578
1459,p1601,20150225,4902,4900,4864,4870,4780,4840,4836,-60,-64,2096,101404440,18668
1460,p1601,20150226,4840,4836,4840,4876,4834,4870,4858,34,22,3614,175634680,17898
1461,p1601,20150227,4870,4858,4870,4960,4860,4958,4910,100,52,6522,320267160,18948
1462,p1601,20150302,4958,4910,5000,5018,4940,5002,4980,92,70,6706,333998040,19670
1463,p1601,20150303,5002,4980,5010,5074,4940,4952,4990,-28,10,5360,267469600,19780
1464,p1601,20150304,4952,4990,4968,5010,4948,4970,4976,-20,-14,4888,243314560,20196
1465,p1601,20150305,4970,4976,4960,4960,4848,4880,4888,-96,-88,6430,314410600,20446
1466,p1601,20150306,4880,4888,4852,4856,4772,4772,4822,-116,-66,6178,297929280,22720
1467,p1601,20150309,4772,4822,4794,4794,4724,4770,4764,-52,-58,7954,379045800,24948
1468,p1601,20150310,4770,4764,4740,4758,4686,4706,4718,-58,-46,8128,383560760,28082
1469,p1601,20150311,4706,4718,4696,4724,4676,4714,4698,-4,-20,12056,566593840,26572
1470,p1601,20150312,4714,4698,4730,4798,4706,4722,4728,24,30,8258,390546760,27286
1471,p1601,20150313,4722,4728,4708,4732,4692,4700,4708,-28,-20,11466,539899080,29412
1472,p1601,20150316,4700,4708,4704,4704,4528,4640,4652,-68,-56,10850,504789280,31454
1473,p1601,20150317,4640,4652,4650,4678,4630,4650,4650,-2,-2,7664,356449480,32330
1474,p1601,20150318,4650,4650,4620,4620,4570,4588,4586,-62,-64,13474,617965360,33916
1475,p1601,20150319,4588,4586,4628,4726,4626,4688,4678,102,92,17614,824132480,34700
1476,p1601,20150320,4688,4678,4678,4720,4652,4662,4680,-16,2,16236,760123040,38326
1477,p1601,20150323,4662,4680,4630,4704,4622,4694,4676,14,-4,12220,571598240,39838
1478,p1601,20150324,4694,4676,4692,4746,4676,4702,4712,26,36,23202,1093356480,39282
1479,p1601,20150325,4702,4712,4740,4740,4680,4680,4696,-32,-16,12088,567707760,43100
1480,p1601,20150326,4680,4696,4696,4722,4666,4706,4700,10,4,11298,531085680,43274
1481,p1601,20150327,4706,4700,4712,4720,4652,4666,4684,-34,-16,13410,628380880,43770
1482,p1601,20150330,4666,4684,4670,4682,4626,4640,4652,-44,-32,17070,794254480,44108
1483,p1601,20150331,4640,4652,4656,4662,4610,4620,4636,-32,-16,9890,458595800,44320
1484,p1601,20150401,4620,4636,4598,4666,4598,4628,4638,-8,2,13856,642867640,47530
1485,p1601,20150402,4628,4638,4642,4662,4600,4654,4638,16,0,20838,966782800,48178
1486,p1601,20150403,4654,4638,4640,4660,4632,4658,4644,20,6,9594,445647080,47650
1487,p1601,20150407,4658,4644,4680,4750,4676,4718,4716,74,72,8478,399832000,46888
1488,p1601,20150408,4718,4716,4700,4712,4668,4690,4692,-26,-24,10630,498812480,47850
1489,p1601,20150409,4690,4692,4678,4682,4636,4648,4654,-44,-38,17916,833837760,51234
1490,p1601,20150410,4648,4654,4632,4662,4620,4624,4642,-30,-12,31294,1453277480,57216
1491,p1601,20150413,4624,4642,4640,4684,4636,4658,4660,16,18,41506,1934999960,59108
1492,p1601,20150414,4658,4660,4652,4664,4622,4630,4638,-30,-22,24916,1155859720,62002
1493,p1601,20150415,4630,4638,4650,4712,4650,4704,4686,66,48,39204,1837766480,59180
1494,p1601,20150416,4704,4686,4698,4774,4686,4738,4730,52,44,47150,2231018680,61766
1495,p1601,20150417,4738,4730,4730,4746,4712,4726,4728,-4,-2,16172,764661320,62800
1496,p1601,20150420,4726,4728,4722,4816,4722,4810,4780,82,52,43268,2068903840,64816
1497,p1601,20150421,4810,4780,4796,4886,4782,4874,4840,94,60,44628,2160798040,67328
1498,p1601,20150422,4874,4840,4872,4890,4816,4842,4852,2,12,48714,2364038720,78102
1499,p1601,20150423,4842,4852,4854,4900,4830,4838,4854,-14,2,46378,2251240360,79790
1500,p1601,20150424,4838,4854,4854,4900,4802,4806,4840,-48,-14,93522,4527772440,96148
1501,p1601,20150427,4806,4840,4814,4870,4774,4864,4826,24,-14,81018,3910376760,102868
1502,p1601,20150428,4864,4826,4860,4878,4824,4838,4848,12,22,66282,3213836440,108400
1503,p1601,20150429,4838,4848,4844,4852,4808,4828,4828,-20,-20,61468,2968255040,113348
1504,p1601,20150430,4828,4828,4828,4876,4818,4852,4850,24,22,51030,2475585720,113600
1505,p1601,20150504,4852,4850,4854,4950,4828,4942,4904,92,54,50950,2499142960,110562
1506,p1601,20150505,4942,4904,4950,5042,4948,5006,4994,102,90,65966,3295486320,109712
1507,p1601,20150506,5006,4994,5036,5150,5014,5124,5076,130,82,104444,5302842760,110748
1508,p1601,20150507,5124,5076,5118,5136,5046,5078,5084,2,8,78040,3967923320,112484
1509,p1601,20150508,5078,5084,5070,5070,4992,4996,5028,-88,-56,75454,3794906120,111676
1510,p1601,20150511,4996,5028,5030,5100,5012,5096,5062,68,34,80304,4065689760,116884
1511,p1601,20150512,5096,5062,5110,5134,5066,5112,5104,50,42,76912,3926770240,122598
1512,p1601,20150513,5112,5104,5136,5262,5136,5194,5202,90,98,303814,15807619800,182430
1513,p1601,20150514,5194,5202,5178,5198,5116,5168,5154,-34,-48,180188,9288805160,189764
1514,p1601,20150515,5168,5154,5190,5250,5186,5228,5220,74,66,253324,13225601920,233292
1515,p1601,20150518,5228,5220,5186,5198,5138,5170,5154,-50,-66,162594,8380873520,218128
1516,p1601,20150519,5170,5154,5172,5172,5066,5088,5104,-66,-50,140880,7193190520,205196
1517,p1601,20150520,5088,5104,5072,5072,4930,4972,4980,-132,-124,222870,11101746840,203870
1518,p1601,20150521,4972,4980,4998,5012,4960,4988,4990,8,10,124612,6220417560,209386
1519,p1601,20150522,4988,4990,5012,5052,4996,5024,5020,34,30,136868,6872046520,213346
1520,p1601,20150525,5024,5020,4986,5018,4956,5006,4982,-14,-38,115000,5729895200,211750
1521,p1601,20150526,5006,4982,5008,5180,5002,5136,5112,154,130,316914,16205069360,263010
1522,p1601,20150527,5136,5112,5118,5202,5118,5162,5164,50,52,269732,13929874480,285872
1523,p1601,20150528,5162,5164,5146,5272,5130,5252,5214,88,50,435326,22702406640,338730
1524,p1601,20150529,5252,5214,5252,5264,5196,5212,5230,-2,16,305616,15987809000,345656
1525,p1601,20150601,5212,5230,5230,5428,5212,5360,5342,130,112,632662,33802224920,459600
1526,p1601,20150602,5360,5342,5390,5456,5380,5420,5422,78,80,570050,30916409240,522120
1527,p1601,20150603,5420,5422,5418,5472,5304,5326,5378,-96,-44,770280,41437590000,542232
1528,p1601,20150604,5326,5378,5336,5376,5258,5334,5318,-44,-60,802760,42699342080,535558
1529,p1601,20150605,5334,5318,5340,5390,5272,5372,5326,54,8,886642,47234306760,597904
1530,p1601,20150608,5372,5326,5372,5412,5324,5352,5368,26,42,977406,52476239800,627314
1531,p1601,20150609,5352,5368,5334,5354,5200,5258,5272,-110,-96,988742,52131843160,619106
1532,p1601,20150610,5258,5272,5286,5310,5216,5252,5264,-20,-8,895620,47157721240,632414
1533,p1601,20150611,5252,5264,5268,5286,5214,5256,5246,-8,-18,823288,43204611520,604006
1534,p1601,20150612,5256,5246,5244,5268,5130,5132,5192,-114,-54,1029444,53449947560,527678
1535,p1601,20150615,5132,5192,5162,5190,5106,5132,5152,-60,-40,601830,31018118640,512466
1536,p1601,20150616,5132,5152,5128,5210,5106,5204,5164,52,12,740552,38251694440,526614
1537,p1601,20150617,5204,5164,5198,5222,5138,5190,5188,26,24,825138,42816372000,524112
1538,p1601,20150618,5190,5188,5192,5216,5078,5086,5146,-102,-42,849680,43736280120,482692
1539,p1601,20150619,5086,5146,5076,5124,5044,5114,5082,-32,-64,664172,33762202040,466680
1540,p1601,20150623,5114,5082,5146,5162,5070,5088,5110,6,28,379238,19382172480,466652
1541,p1601,20150624,5088,5110,5070,5150,5048,5140,5100,30,-10,741480,37822253880,507284
1542,p1601,20150625,5140,5100,5166,5210,5140,5152,5176,52,76,812734,42077333720,507012
1543,p1601,20150626,5152,5176,5168,5204,5084,5122,5160,-54,-16,929346,47971616360,477794
1544,p1601,20150629,5122,5160,5170,5204,5074,5106,5144,-54,-16,854502,43958981080,456746
1545,p1601,20150630,5106,5144,5120,5120,4960,5014,5032,-130,-112,836276,42084473520,420242
1546,p1601,20150701,5014,5032,5010,5204,4996,5134,5104,102,72,736912,37624818960,442772
1547,p1601,20150702,5134,5104,5152,5154,5058,5114,5098,10,-6,618268,31524927960,432784
1548,p1601,20150703,5114,5098,5104,5164,5102,5120,5134,22,36,624284,32050944720,442812
1549,p1601,20150706,5120,5134,5118,5120,4930,4990,5018,-144,-116,786004,39455276680,403906
1550,p1601,20150707,4990,5018,4986,5030,4920,4944,4972,-74,-46,698172,34725424480,392934
1551,p1601,20150708,4944,4972,4916,4920,4774,4774,4810,-198,-162,483190,23250434320,333474
1552,p1601,20150709,4774,4810,4700,4894,4522,4792,4724,-18,-86,1170240,55299313040,331066
1553,p1601,20150710,4792,4724,4842,4912,4818,4912,4882,188,158,567476,27713656960,350840
1554,p1601,20150713,4912,4882,4882,4950,4810,4872,4870,-10,-12,616966,30050257640,330292
1555,p1601,20150714,4872,4870,4870,5004,4842,4934,4940,64,70,891122,44029998240,354198
1556,p1601,20150715,4934,4940,4930,4980,4892,4912,4938,-28,-2,705966,34864410400,365492
1557,p1601,20150716,4912,4938,4892,4916,4816,4862,4860,-76,-78,580390,28215550760,372902
1558,p1601,20150717,4862,4860,4882,4910,4804,4852,4852,-8,-8,543928,26398706400,374198
1559,p1601,20150720,4852,4852,4820,4896,4806,4890,4860,38,8,641268,31175713880,398932
1560,p1601,20150721,4890,4860,4890,4966,4874,4966,4924,106,64,898206,44229325800,453456
1561,p1601,20150722,4966,4924,4970,4988,4912,4952,4954,28,30,740424,36684586320,441486
1562,p1601,20150723,4952,4954,4920,4928,4862,4878,4894,-76,-60,637620,31208767640,423566
1563,p1601,20150724,4878,4894,4876,4900,4842,4860,4870,-34,-24,514482,25058601080,406748
1564,p1601,20150727,4860,4870,4850,4874,4736,4756,4802,-114,-68,678800,32603322320,375462
1565,p1601,20150728,4756,4802,4722,4780,4688,4746,4736,-56,-66,578156,27382525360,374698
1566,p1601,20150729,4746,4736,4756,4814,4752,4774,4778,38,42,516132,24667672840,371238
1567,p1601,20150730,4774,4778,4750,4784,4734,4748,4756,-30,-22,508902,24206563360,393058
1568,p1601,20150731,4748,4756,4790,4798,4742,4752,4770,-4,14,515086,24572205600,416690
1569,p1601,20150803,4752,4770,4736,4762,4632,4644,4700,-126,-70,672702,31626338960,428388
1570,p1601,20150804,4644,4700,4606,4666,4596,4642,4626,-58,-74,714354,33051316240,444142
1571,p1601,20150805,4642,4626,4660,4676,4624,4644,4652,18,26,485372,22580838720,454366
1572,p1601,20150806,4644,4652,4640,4642,4546,4560,4592,-92,-60,610416,28034506280,475906
1573,p1601,20150807,4560,4592,4580,4594,4486,4572,4554,-20,-38,757804,34513324080,483646
1574,p1601,20150810,4572,4554,4560,4624,4532,4566,4564,12,10,694122,31681381560,502952
1575,p1601,20150811,4566,4564,4560,4698,4552,4642,4620,78,56,1183014,54664004000,529114
1576,p1601,20150812,4642,4620,4620,4678,4596,4674,4632,54,12,795250,36849621160,521056
1577,p1601,20150813,4674,4632,4670,4724,4502,4628,4642,-4,10,985244,45737213200,529826
1578,p1601,20150814,4628,4642,4614,4664,4582,4586,4622,-56,-20,866288,40056384000,562398
1579,p1601,20150817,4586,4622,4574,4618,4574,4608,4602,-14,-20,598988,27577304000,586724
1580,p1601,20150818,4608,4602,4622,4632,4548,4566,4592,-36,-10,580102,26648805000,597042
1581,p1601,20150819,4566,4592,4578,4578,4498,4544,4532,-48,-60,735616,33348836760,551634
1582,p1601,20150820,4544,4532,4544,4552,4448,4448,4496,-84,-36,793706,35700053760,604074
1583,p1601,20150821,4448,4496,4476,4484,4424,4438,4454,-58,-42,883826,39381256600,624054
1584,p1601,20150824,4438,4454,4424,4434,4276,4276,4338,-178,-116,934054,40524715320,583428
1585,p1601,20150825,4276,4338,4180,4222,4088,4122,4158,-216,-180,1408046,58548287400,523832
1586,p1601,20150826,4122,4158,4216,4256,4116,4138,4176,-20,18,950776,39723150520,543450
1587,p1601,20150827,4138,4176,4134,4196,4078,4188,4132,12,-44,994968,41114437920,553006
1588,p1601,20150828,4188,4132,4216,4296,4200,4296,4258,164,126,1047530,44615072920,477164
1589,p1601,20150831,4296,4258,4310,4320,4230,4272,4274,14,16,1030108,44029703200,493826
1590,p1601,20150901,4272,4274,4240,4360,4232,4312,4290,38,16,870702,37368343600,469654
1591,p1601,20150902,4312,4290,4300,4314,4234,4252,4274,-38,-16,582466,24895124520,454030
1592,p1601,20150907,4252,4274,4232,4258,4202,4222,4234,-52,-40,359654,15227991000,488574
1593,p1601,20150908,4222,4234,4252,4294,4242,4292,4260,58,26,496550,21162185600,493120
1594,p1601,20150909,4292,4260,4310,4378,4310,4326,4336,66,76,741706,32174560600,486022
1595,p1601,20150910,4326,4336,4336,4354,4280,4340,4314,4,-22,890356,38411699280,538298
1596,p1601,20150911,4340,4314,4356,4398,4332,4336,4362,22,48,798444,34834009680,527146
1597,p1601,20150914,4336,4362,4308,4342,4266,4336,4314,-26,-48,889304,38368398960,538360
1598,p1601,20150915,4336,4314,4358,4410,4290,4292,4362,-22,48,1373330,59905235440,544420
1599,p1601,20150916,4292,4362,4294,4316,4244,4310,4284,-52,-78,1458508,62483599280,570078
1600,p1601,20150917,4310,4284,4318,4328,4270,4276,4294,-8,10,1018844,43757433840,589646
1601,p1601,20150918,4276,4294,4252,4300,4252,4264,4274,-30,-20,880926,37664663400,580334
1602,p1601,20150921,4264,4274,4240,4298,4210,4294,4242,20,-32,872304,37003622400,581734
1603,p1601,20150922,4294,4242,4300,4332,4272,4282,4296,40,54,1160582,49874827600,685334
1604,p1601,20150923,4282,4296,4260,4332,4258,4298,4294,2,-2,1186754,50980890600,783616
1605,p1601,20150924,4298,4294,4332,4398,4324,4398,4368,104,74,1245250,54397016840,818474
1606,p1601,20150925,4398,4368,4382,4528,4380,4484,4468,116,100,1984072,88680880760,837784
1607,p1601,20150928,4484,4468,4548,4556,4486,4502,4512,34,44,948428,42805418160,751528
1608,p1601,20150929,4502,4512,4528,4532,4384,4418,4442,-94,-70,1420076,63091232760,583630
1609,p1601,20150930,4418,4442,4458,4496,4432,4480,4470,38,28,918976,41094487720,543336
1610,p1601,20151008,4480,4470,4478,4550,4468,4482,4504,12,34,583200,26271643040,585832
1611,p1601,20151009,4482,4504,4488,4532,4442,4518,4488,14,-16,1087702,48826882520,666800
1612,p1601,20151012,4518,4488,4510,4636,4484,4600,4568,112,80,1422066,64984064280,723662
1613,p1601,20151013,4600,4568,4598,4674,4536,4666,4600,98,32,1559070,71743199960,751800
1614,p1601,20151014,4666,4600,4660,4680,4620,4636,4650,36,50,1229798,57187673440,714660
1615,p1601,20151015,4636,4650,4668,4684,4616,4656,4648,6,-2,1126364,52370457640,715630
1616,p1601,20151016,4656,4648,4636,4648,4586,4622,4620,-26,-28,1283180,59287988000,701264
1617,p1601,20151019,4622,4620,4610,4620,4556,4562,4590,-58,-30,1051120,48256023040,685574
1618,p1601,20151020,4562,4590,4540,4556,4476,4516,4506,-74,-84,1237804,55779154120,694056
1619,p1601,20151021,4516,4506,4526,4574,4524,4540,4548,34,42,1224780,55718357800,726566
1620,p1601,20151022,4540,4548,4548,4622,4544,4618,4586,70,38,1121430,51439157760,760310
1621,p1601,20151023,4618,4586,4620,4630,4526,4548,4568,-38,-18,1301728,59464731840,681686
1622,p1601,20151026,4548,4568,4560,4560,4438,4448,4484,-120,-84,1503636,67424826880,674514
1623,p1601,20151027,4448,4484,4438,4460,4388,4450,4420,-34,-64,1224086,54126781560,731936
1624,p1601,20151028,4450,4420,4454,4460,4388,4418,4418,-2,-2,1331238,58830894360,729550
1625,p1601,20151029,4418,4418,4430,4476,4418,4420,4442,2,24,1125376,50000227040,737350
1626,p1601,20151030,4420,4442,4440,4448,4388,4394,4414,-48,-28,1036268,45748878000,760112
1627,p1601,20151102,4394,4414,4394,4446,4356,4428,4402,14,-12,1073508,47267968920,735462
1628,p1601,20151103,4428,4402,4398,4406,4330,4332,4372,-70,-30,993318,43437613040,716548
1629,p1601,20151104,4332,4372,4328,4384,4326,4376,4356,4,-16,1004684,43770682720,766520
1630,p1601,20151105,4376,4356,4386,4406,4338,4350,4374,-6,18,1061026,46411792120,766076
1631,p1601,20151106,4350,4374,4344,4350,4224,4256,4258,-118,-116,1957222,83376649000,790440
1632,p1601,20151109,4256,4258,4264,4286,4238,4258,4262,0,4,983558,41936871720,755558
1633,p1601,20151110,4258,4262,4274,4286,4208,4248,4238,-14,-24,844934,35815171840,777216
1634,p1601,20151111,4248,4238,4244,4246,4142,4168,4180,-70,-58,1401736,58594347320,671190
1635,p1601,20151112,4168,4180,4166,4208,4162,4188,4182,8,2,689648,28846709160,653700
1636,p1601,20151113,4188,4182,4178,4202,4154,4172,4176,-10,-6,682026,28488558240,622152
1637,p1601,20151116,4172,4176,4130,4166,4130,4140,4148,-36,-28,523224,21706969680,594412
1638,p1601,20151117,4140,4148,4150,4182,4122,4166,4150,18,2,540782,22449642600,582284
1639,p1601,20151118,4166,4150,4162,4174,4112,4146,4146,-4,-4,676284,28046121560,560458
1640,p1601,20151119,4146,4146,4164,4174,4064,4094,4112,-52,-34,912046,37515945120,540602
1641,p1601,20151120,4094,4112,4088,4108,3984,4098,4042,-14,-70,1696830,68597341640,575308
1642,p1601,20151123,4098,4042,4100,4164,4072,4098,4100,56,58,1441102,59087296440,536360
1643,p1601,20151124,4098,4100,4100,4240,4092,4214,4158,114,58,816200,33939805360,521144
1644,p1601,20151125,4214,4158,4196,4216,4174,4198,4192,40,34,541506,22703611760,502554
1645,p1601,20151126,4198,4192,4190,4306,4172,4272,4240,80,48,539548,22878462240,435488
1646,p1601,20151127,4272,4240,4272,4338,4244,4330,4286,90,46,383258,16429142640,434546
1647,p1601,20151130,4330,4286,4330,4330,4266,4302,4294,16,8,199752,8579715800,382146
1648,p1601,20151201,4302,4294,4284,4380,4284,4346,4346,52,52,189520,8237583800,364566
1649,p1601,20151202,4346,4346,4350,4416,4330,4388,4378,42,32,145966,6390406480,319478
1650,p1601,20151203,4388,4378,4380,4410,4332,4354,4362,-24,-16,123710,5398044400,301300
1651,p1601,20151204,4354,4362,4368,4372,4328,4360,4350,-2,-12,144394,6281364680,297636
1652,p1601,20151207,4360,4350,4352,4490,4344,4462,4434,112,84,139008,6163856480,275044
1653,p1601,20151208,4462,4434,4480,4482,4336,4372,4402,-62,-32,96798,4262173080,250988
1654,p1601,20151209,4372,4402,4374,4392,4324,4340,4358,-62,-44,80562,3511686240,227970
1655,p1601,20151210,4340,4358,4328,4394,4328,4370,4362,12,4,66904,2918643160,207694
1656,p1601,20151211,4370,4362,4380,4442,4352,4436,4394,74,32,92204,4052032360,168984
1657,p1601,20151214,4436,4394,4440,4482,4376,4420,4442,26,48,61986,2753787280,155420
1658,p1601,20151215,4420,4442,4364,4458,4364,4410,4424,-32,-18,51800,2292120280,137288
1659,p1601,20151216,4410,4424,4388,4424,4376,4396,4400,-28,-24,39298,1729325160,122856
1660,p1601,20151217,4396,4400,4384,4406,4302,4306,4356,-94,-44,31182,1358294000,116344
1661,p1601,20151218,4306,4356,4306,4318,4264,4294,4292,-62,-64,27862,1195955120,107974
1662,p1601,20151221,4294,4292,4294,4402,4288,4402,4328,110,36,32024,1386352880,99758
1663,p1601,20151222,4402,4328,4400,4422,4380,4408,4398,80,70,15252,670832800,95326
1664,p1601,20151223,4408,4398,4428,4436,4388,4422,4408,24,10,17804,784844880,94762
1665,p1601,20151224,4422,4408,4442,4470,4402,4404,4442,-4,34,12952,575363280,91148
1666,p1601,20151225,4404,4442,4420,4434,4396,4432,4414,-10,-28,5678,250635440,88964
1667,p1601,20151228,4432,4414,4414,4440,4338,4340,4384,-74,-30,17536,768836680,84800
1668,p1601,20151229,4340,4384,4332,4424,4276,4420,4330,36,-54,19332,837189360,78594
1669,p1601,20151230,4420,4330,4396,4500,4396,4482,4458,152,128,35138,1566875000,58656
1670,p1601,20151231,4482,4458,4488,4518,4458,4510,4494,52,36,10958,492480920,50718
1671,p1602,20150216,4802,4802,4770,4770,4770,4770,4770,-32,-32,2,95400,2
1672,p1602,20150217,4770,4770,0,0,0,4762,4762,-8,-8,0,0,2
1673,p1602,20150225,4762,4762,4764,4764,4764,4764,4764,2,2,2,95280,0
1674,p1602,20150226,4764,4764,0,0,0,4784,4784,20,20,0,0,0
1675,p1602,20150227,4784,4784,0,0,0,4834,4834,50,50,0,0,0
1676,p1602,20150302,4834,4834,0,0,0,4902,4902,68,68,0,0,0
1677,p1602,20150303,4902,4902,0,0,0,4902,4902,0,0,0,0,0
1678,p1602,20150304,4902,4902,0,0,0,4902,4902,0,0,0,0,0
1679,p1602,20150305,4902,4902,0,0,0,4902,4902,0,0,0,0,0
1680,p1602,20150306,4902,4902,0,0,0,4902,4902,0,0,0,0,0
1681,p1602,20150309,4902,4902,0,0,0,4894,4894,-8,-8,0,0,0
1682,p1602,20150310,4894,4894,0,0,0,4848,4848,-46,-46,0,0,0
1683,p1602,20150311,4848,4848,0,0,0,4834,4834,-14,-14,0,0,0
1684,p1602,20150312,4834,4834,0,0,0,4834,4834,0,0,0,0,0
1685,p1602,20150313,4834,4834,0,0,0,4788,4788,-46,-46,0,0,0
1686,p1602,20150316,4788,4788,0,0,0,4714,4714,-74,-74,0,0,0
1687,p1602,20150317,4714,4714,0,0,0,4714,4714,0,0,0,0,0
1688,p1602,20150318,4714,4714,4654,4654,4654,4654,4654,-60,-60,2,93080,2
1689,p1602,20150319,4654,4654,0,0,0,4746,4746,92,92,0,0,2
1690,p1602,20150320,4746,4746,4688,4756,4688,4756,4722,10,-24,4,188880,2
1691,p1602,20150323,4756,4722,4770,4770,4672,4672,4720,-50,-2,4,188840,2
1692,p1602,20150324,4672,4720,0,0,0,4720,4720,0,0,0,0,2
1693,p1602,20150325,4720,4720,0,0,0,4720,4720,0,0,0,0,2
1694,p1602,20150326,4720,4720,0,0,0,4720,4720,0,0,0,0,2
1695,p1602,20150327,4720,4720,0,0,0,4720,4720,0,0,0,0,2
1696,p1602,20150330,4720,4720,0,0,0,4720,4720,0,0,0,0,2
1697,p1602,20150331,4720,4720,0,0,0,4714,4714,-6,-6,0,0,2
1698,p1602,20150401,4714,4714,4694,4704,4694,4704,4696,-10,-18,6,281840,6
1699,p1602,20150402,4704,4696,0,0,0,4696,4696,0,0,0,0,6
1700,p1602,20150403,4696,4696,0,0,0,4696,4696,0,0,0,0,6
1701,p1602,20150407,4696,4696,0,0,0,4720,4720,24,24,0,0,6
1702,p1602,20150408,4720,4720,0,0,0,4720,4720,0,0,0,0,6
1703,p1602,20150409,4720,4720,0,0,0,4682,4682,-38,-38,0,0,6
1704,p1602,20150410,4682,4682,0,0,0,4670,4670,-12,-12,0,0,6
1705,p1602,20150413,4670,4670,0,0,0,4688,4688,18,18,0,0,6
1706,p1602,20150414,4688,4688,0,0,0,4688,4688,0,0,0,0,6
1707,p1602,20150415,4688,4688,0,0,0,4706,4706,18,18,0,0,6
1708,p1602,20150416,4706,4706,4738,4760,4738,4760,4748,54,42,4,189960,2
1709,p1602,20150417,4760,4748,0,0,0,4746,4746,-2,-2,0,0,2
1710,p1602,20150420,4746,4746,0,0,0,4798,4798,52,52,0,0,2
1711,p1602,20150421,4798,4798,4860,4908,4860,4908,4892,110,94,6,293520,8
1712,p1602,20150422,4908,4892,0,0,0,4904,4904,12,12,0,0,8
1713,p1602,20150423,4904,4904,0,0,0,4906,4906,2,2,0,0,8
1714,p1602,20150424,4906,4906,0,0,0,4906,4906,0,0,0,0,8
1715,p1602,20150427,4906,4906,0,0,0,4906,4906,0,0,0,0,8
1716,p1602,20150428,4906,4906,4898,4898,4898,4898,4898,-8,-8,2,97960,10
1717,p1602,20150429,4898,4898,4906,4906,4906,4906,4906,8,8,2,98120,12
1718,p1602,20150430,4906,4906,4910,4910,4910,4910,4910,4,4,2,98200,12
1719,p1602,20150504,4910,4910,4870,4984,4870,4984,4926,74,16,4,197080,12
1720,p1602,20150505,4984,4926,5040,5040,5040,5040,5040,114,114,2,100800,12
1721,p1602,20150506,5040,5040,0,0,0,5122,5122,82,82,0,0,12
1722,p1602,20150507,5122,5122,5122,5192,5122,5192,5156,70,34,4,206280,12
1723,p1602,20150508,5192,5156,0,0,0,5100,5100,-56,-56,0,0,12
1724,p1602,20150511,5100,5100,0,0,0,5134,5134,34,34,0,0,12
1725,p1602,20150512,5134,5134,0,0,0,5176,5176,42,42,0,0,12
1726,p1602,20150513,5176,5176,5230,5286,5230,5286,5258,110,82,4,210320,14
1727,p1602,20150514,5286,5258,0,0,0,5210,5210,-48,-48,0,0,14
1728,p1602,20150515,5210,5210,0,0,0,5276,5276,66,66,0,0,14
1729,p1602,20150518,5276,5276,0,0,0,5210,5210,-66,-66,0,0,14
1730,p1602,20150519,5210,5210,0,0,0,5160,5160,-50,-50,0,0,14
1731,p1602,20150520,5160,5160,5060,5060,5056,5056,5058,-104,-102,4,202320,18
1732,p1602,20150521,5056,5058,0,0,0,5068,5068,10,10,0,0,18
1733,p1602,20150522,5068,5068,0,0,0,5098,5098,30,30,0,0,18
1734,p1602,20150525,5098,5098,0,0,0,5060,5060,-38,-38,0,0,18
1735,p1602,20150526,5060,5060,0,0,0,5192,5192,132,132,0,0,18
1736,p1602,20150527,5192,5192,0,0,0,5244,5244,52,52,0,0,18
1737,p1602,20150528,5244,5244,5360,5360,5244,5244,5324,0,80,10,532480,24
1738,p1602,20150529,5244,5324,0,0,0,5340,5340,16,16,0,0,24
1739,p1602,20150601,5340,5340,5350,5350,5350,5350,5350,10,10,2,107000,24
1740,p1602,20150602,5350,5350,5550,5550,5476,5482,5514,132,164,130,7170480,34
1741,p1602,20150603,5482,5514,5458,5458,5372,5372,5384,-142,-130,36,1938280,20
1742,p1602,20150604,5372,5384,5390,5390,5330,5354,5362,-30,-22,30,1609160,8
1743,p1602,20150605,5354,5362,5372,5372,5346,5372,5360,10,-2,20,1072320,18
1744,p1602,20150608,5372,5360,5408,5448,5398,5416,5418,56,58,40,2167920,12
1745,p1602,20150609,5416,5418,0,0,0,5322,5322,-96,-96,0,0,12
1746,p1602,20150610,5322,5322,5318,5318,5278,5312,5302,-10,-20,6,318160,12
1747,p1602,20150611,5312,5302,0,0,0,5284,5284,-18,-18,0,0,12
1748,p1602,20150612,5284,5284,5318,5318,5194,5194,5252,-90,-32,8,420160,10
1749,p1602,20150615,5194,5252,5176,5176,5176,5176,5176,-76,-76,2,103520,10
1750,p1602,20150616,5176,5176,0,0,0,5188,5188,12,12,0,0,10
1751,p1602,20150617,5188,5188,0,0,0,5212,5212,24,24,0,0,10
1752,p1602,20150618,5212,5212,0,0,0,5170,5170,-42,-42,0,0,10
1753,p1602,20150619,5170,5170,0,0,0,5106,5106,-64,-64,0,0,10
1754,p1602,20150623,5106,5106,0,0,0,5134,5134,28,28,0,0,10
1755,p1602,20150624,5134,5134,0,0,0,5124,5124,-10,-10,0,0,10
1756,p1602,20150625,5124,5124,0,0,0,5200,5200,76,76,0,0,10
1757,p1602,20150626,5200,5200,0,0,0,5184,5184,-16,-16,0,0,10
1758,p1602,20150629,5184,5184,5252,5252,5226,5226,5238,42,54,4,209560,10
1759,p1602,20150630,5226,5238,5110,5134,5074,5074,5102,-164,-136,8,408280,10
1760,p1602,20150701,5074,5102,5118,5118,5118,5118,5118,16,16,2,102360,12
1761,p1602,20150702,5118,5118,5116,5116,5116,5116,5116,-2,-2,2,102320,10
1762,p1602,20150703,5116,5116,0,0,0,5152,5152,36,36,0,0,10
1763,p1602,20150706,5152,5152,5048,5048,4990,5028,5022,-124,-130,6,301320,12
1764,p1602,20150707,5028,5022,5040,5040,5040,5040,5040,18,18,2,100800,10
1765,p1602,20150708,5040,5040,4848,4848,4848,4848,4848,-192,-192,2,96960,10
1766,p1602,20150709,4848,4848,4656,4940,4656,4940,4796,92,-52,20,959280,10
1767,p1602,20150710,4940,4796,4852,4890,4852,4890,4870,94,74,4,194840,8
1768,p1602,20150713,4890,4870,4950,4950,4950,4950,4950,80,80,2,99000,8
1769,p1602,20150714,4950,4950,4950,4950,4950,4950,4950,0,0,4,198000,8
1770,p1602,20150715,4950,4950,0,0,0,4948,4948,-2,-2,0,0,8
1771,p1602,20150716,4948,4948,4948,4948,4948,4948,4948,0,0,4,197920,6
1772,p1602,20150717,4948,4948,0,0,0,4940,4940,-8,-8,0,0,6
1773,p1602,20150720,4940,4940,0,0,0,4948,4948,8,8,0,0,6
1774,p1602,20150721,4948,4948,0,0,0,5012,5012,64,64,0,0,6
1775,p1602,20150722,5012,5012,0,0,0,5042,5042,30,30,0,0,6
1776,p1602,20150723,5042,5042,0,0,0,4982,4982,-60,-60,0,0,6
1777,p1602,20150724,4982,4982,0,0,0,4958,4958,-24,-24,0,0,6
1778,p1602,20150727,4958,4958,0,0,0,4888,4888,-70,-70,0,0,6
1779,p1602,20150728,4888,4888,0,0,0,4822,4822,-66,-66,0,0,6
1780,p1602,20150729,4822,4822,0,0,0,4864,4864,42,42,0,0,6
1781,p1602,20150730,4864,4864,4934,4934,4808,4808,4870,-56,6,4,194840,8
1782,p1602,20150731,4808,4870,0,0,0,4884,4884,14,14,0,0,8
1783,p1602,20150803,4884,4884,0,0,0,4814,4814,-70,-70,0,0,8
1784,p1602,20150804,4814,4814,4692,4740,4678,4678,4702,-136,-112,6,282200,6
1785,p1602,20150805,4678,4702,4748,4754,4696,4732,4728,30,26,16,756560,8
1786,p1602,20150806,4732,4728,4690,4702,4690,4702,4696,-26,-32,4,187840,8
1787,p1602,20150807,4702,4696,4560,4602,4510,4602,4560,-94,-136,20,912200,6
1788,p1602,20150810,4602,4560,0,0,0,4612,4612,52,52,0,0,6
1789,p1602,20150811,4612,4612,0,0,0,4668,4668,56,56,0,0,6
1790,p1602,20150812,4668,4668,0,0,0,4680,4680,12,12,0,0,6
1791,p1602,20150813,4680,4680,4738,4738,4738,4738,4738,58,58,2,94760,8
1792,p1602,20150814,4738,4738,4682,4722,4674,4684,4696,-54,-42,22,1033480,14
1793,p1602,20150817,4684,4696,0,0,0,4696,4696,0,0,0,0,14
1794,p1602,20150818,4696,4696,4806,4806,4684,4684,4728,-12,32,6,283720,14
1795,p1602,20150819,4684,4728,0,0,0,4668,4668,-60,-60,0,0,14
1796,p1602,20150820,4668,4668,4612,4664,4612,4664,4642,-4,-26,26,1207000,22
1797,p1602,20150821,4664,4642,4538,4580,4538,4580,4558,-62,-84,12,547080,22
1798,p1602,20150824,4580,4558,4420,4420,4420,4420,4420,-138,-138,8,353600,22
1799,p1602,20150825,4420,4420,0,0,0,4244,4244,-176,-176,0,0,22
1800,p1602,20150826,4244,4244,0,0,0,4262,4262,18,18,0,0,22
1801,p1602,20150827,4262,4262,4192,4234,4104,4226,4194,-36,-68,12,503400,20
1802,p1602,20150828,4226,4194,4348,4348,4348,4348,4348,154,154,2,86960,18
1803,p1602,20150831,4348,4348,4458,4458,4392,4392,4424,44,76,4,177000,18
1804,p1602,20150901,4392,4424,0,0,0,4440,4440,16,16,0,0,18
1805,p1602,20150902,4440,4440,4378,4418,4376,4418,4396,-22,-44,8,351800,18
1806,p1602,20150907,4418,4396,4418,4418,4308,4308,4362,-88,-34,8,349040,18
1807,p1602,20150908,4308,4362,0,0,0,4388,4388,26,26,0,0,18
1808,p1602,20150909,4388,4388,0,0,0,4466,4466,78,78,0,0,18
1809,p1602,20150910,4466,4466,0,0,0,4444,4444,-22,-22,0,0,18
1810,p1602,20150911,4444,4444,0,0,0,4492,4492,48,48,0,0,18
1811,p1602,20150914,4492,4492,4386,4442,4386,4442,4414,-50,-78,4,176560,18
1812,p1602,20150915,4442,4414,4442,4482,4442,4482,4462,68,48,4,178480,18
1813,p1602,20150916,4482,4462,4316,4412,4316,4412,4356,-50,-106,10,435760,20
1814,p1602,20150917,4412,4356,0,0,0,4366,4366,10,10,0,0,20
1815,p1602,20150918,4366,4366,0,0,0,4346,4346,-20,-20,0,0,20
1816,p1602,20150921,4346,4346,4336,4336,4304,4304,4324,-42,-22,6,259520,18
1817,p1602,20150922,4304,4324,0,0,0,4378,4378,54,54,0,0,18
1818,p1602,20150923,4378,4378,4362,4362,4362,4362,4362,-16,-16,2,87240,16
1819,p1602,20150924,4362,4362,4362,4362,4362,4362,4362,0,0,2,87240,16
1820,p1602,20150925,4362,4362,0,0,0,4460,4460,98,98,0,0,16
1821,p1602,20150928,4460,4460,0,0,0,4502,4502,42,42,0,0,16
1822,p1602,20150929,4502,4502,0,0,0,4434,4434,-68,-68,0,0,16
1823,p1602,20150930,4434,4434,0,0,0,4460,4460,26,26,0,0,16
1824,p1602,20151008,4460,4460,0,0,0,4492,4492,32,32,0,0,16
1825,p1602,20151009,4492,4492,0,0,0,4478,4478,-14,-14,0,0,16
1826,p1602,20151012,4478,4478,0,0,0,4656,4656,178,178,0,0,16
1827,p1602,20151013,4656,4656,4694,4718,4664,4718,4684,62,28,8,374840,14
1828,p1602,20151014,4718,4684,0,0,0,4734,4734,50,50,0,0,14
1829,p1602,20151015,4734,4734,0,0,0,4732,4732,-2,-2,0,0,14
1830,p1602,20151016,4732,4732,4784,4784,4716,4716,4748,-16,16,8,379920,16
1831,p1602,20151019,4716,4748,4658,4658,4658,4658,4658,-90,-90,2,93160,14
1832,p1602,20151020,4658,4658,0,0,0,4574,4574,-84,-84,0,0,14
1833,p1602,20151021,4574,4574,0,0,0,4616,4616,42,42,0,0,14
1834,p1602,20151022,4616,4616,0,0,0,4654,4654,38,38,0,0,14
1835,p1602,20151023,4654,4654,0,0,0,4636,4636,-18,-18,0,0,14
1836,p1602,20151026,4636,4636,4564,4598,4514,4514,4558,-122,-78,6,273520,14
1837,p1602,20151027,4514,4558,0,0,0,4558,4558,0,0,0,0,14
1838,p1602,20151028,4558,4558,4548,4548,4468,4492,4502,-66,-56,6,270160,14
1839,p1602,20151029,4492,4502,0,0,0,4502,4502,0,0,0,0,14
1840,p1602,20151030,4502,4502,4498,4498,4498,4498,4498,-4,-4,2,89960,14
1841,p1602,20151102,4498,4498,0,0,0,4502,4502,4,4,0,0,14
1842,p1602,20151103,4502,4502,0,0,0,4502,4502,0,0,0,0,14
1843,p1602,20151104,4502,4502,0,0,0,4502,4502,0,0,0,0,14
1844,p1602,20151105,4502,4502,0,0,0,4502,4502,0,0,0,0,14
1845,p1602,20151106,4502,4502,4368,4368,4338,4338,4352,-164,-150,8,348280,14
1846,p1602,20151109,4338,4352,0,0,0,4356,4356,4,4,0,0,14
1847,p1602,20151110,4356,4356,0,0,0,4356,4356,0,0,0,0,14
1848,p1602,20151111,4356,4356,0,0,0,4356,4356,0,0,0,0,14
1849,p1602,20151112,4356,4356,0,0,0,4356,4356,0,0,0,0,14
1850,p1602,20151113,4356,4356,0,0,0,4356,4356,0,0,0,0,14
1851,p1602,20151116,4356,4356,4230,4280,4230,4280,4254,-76,-102,32,1361600,16
1852,p1602,20151117,4280,4254,0,0,0,4256,4256,2,2,0,0,16
1853,p1602,20151118,4256,4256,4240,4240,4240,4240,4240,-16,-16,2,84800,14
1854,p1602,20151119,4240,4240,0,0,0,4206,4206,-34,-34,0,0,14
1855,p1602,20151120,4206,4206,0,0,0,4136,4136,-70,-70,0,0,14
1856,p1602,20151123,4136,4136,4136,4194,4078,4194,4130,58,-6,162,6693320,14
1857,p1602,20151124,4194,4130,0,0,0,4188,4188,58,58,0,0,14
1858,p1602,20151125,4188,4188,0,0,0,4222,4222,34,34,0,0,14
1859,p1602,20151126,4222,4222,0,0,0,4270,4270,48,48,0,0,14
1860,p1602,20151127,4270,4270,0,0,0,4316,4316,46,46,0,0,14
1861,p1602,20151130,4316,4316,0,0,0,4324,4324,8,8,0,0,14
1862,p1602,20151201,4324,4324,0,0,0,4376,4376,52,52,0,0,14
1863,p1602,20151202,4376,4376,0,0,0,4408,4408,32,32,0,0,14
1864,p1602,20151203,4408,4408,4408,4540,4408,4540,4474,132,66,8,357920,14
1865,p1602,20151204,4540,4474,4652,4652,4480,4646,4562,172,88,12,547520,14
1866,p1602,20151207,4646,4562,0,0,0,4650,4650,88,88,0,0,14
1867,p1602,20151208,4650,4650,0,0,0,4618,4618,-32,-32,0,0,14
1868,p1602,20151209,4618,4618,0,0,0,4572,4572,-46,-46,0,0,14
1869,p1602,20151210,4572,4572,0,0,0,4576,4576,4,4,0,0,14
1870,p1602,20151211,4576,4576,0,0,0,4608,4608,32,32,0,0,14
1871,p1602,20151214,4608,4608,4548,4774,4548,4766,4688,158,80,12,562720,16
1872,p1602,20151215,4766,4688,0,0,0,4688,4688,0,0,0,0,16
1873,p1602,20151216,4688,4688,4644,4652,4644,4650,4646,-38,-42,8,371800,14
1874,p1602,20151217,4650,4646,4556,4688,4462,4462,4530,-184,-116,42,1903400,32
1875,p1602,20151218,4462,4530,4368,4436,4330,4330,4366,-200,-164,10,436600,26
1876,p1602,20151221,4330,4366,4358,4358,4356,4358,4356,-8,-10,10,435720,26
1877,p1602,20151222,4358,4356,4444,4530,4326,4432,4430,76,74,54,2393160,26
1878,p1602,20151223,4432,4430,4448,4508,4448,4508,4478,78,48,4,179120,26
1879,p1602,20151224,4508,4478,4652,4652,4652,4652,4652,174,174,2,93040,26
1880,p1602,20151225,4652,4652,0,0,0,4624,4624,-28,-28,0,0,26
1881,p1602,20151228,4624,4624,0,0,0,4594,4594,-30,-30,0,0,26
1882,p1602,20151229,4594,4594,0,0,0,4538,4538,-56,-56,0,0,26
1883,p1602,20151230,4538,4538,4690,4690,4690,4690,4690,152,152,2,93800,26
1884,p1602,20151231,4690,4690,0,0,0,4726,4726,36,36,0,0,26
1885,p1603,20150316,4728,4728,0,0,0,4672,4672,-56,-56,0,0,0
1886,p1603,20150317,4672,4672,0,0,0,4672,4672,0,0,0,0,0
1887,p1603,20150318,4672,4672,0,0,0,4672,4672,0,0,0,0,0
1888,p1603,20150319,4672,4672,0,0,0,4672,4672,0,0,0,0,0
1889,p1603,20150320,4672,4672,0,0,0,4672,4672,0,0,0,0,0
1890,p1603,20150323,4672,4672,0,0,0,4672,4672,0,0,0,0,0
1891,p1603,20150324,4672,4672,0,0,0,4672,4672,0,0,0,0,0
1892,p1603,20150325,4672,4672,0,0,0,4672,4672,0,0,0,0,0
1893,p1603,20150326,4672,4672,0,0,0,4672,4672,0,0,0,0,0
1894,p1603,20150327,4672,4672,0,0,0,4672,4672,0,0,0,0,0
1895,p1603,20150330,4672,4672,0,0,0,4672,4672,0,0,0,0,0
1896,p1603,20150331,4672,4672,0,0,0,4672,4672,0,0,0,0,0
1897,p1603,20150401,4672,4672,0,0,0,4672,4672,0,0,0,0,0
1898,p1603,20150402,4672,4672,0,0,0,4672,4672,0,0,0,0,0
1899,p1603,20150403,4672,4672,0,0,0,4672,4672,0,0,0,0,0
1900,p1603,20150407,4672,4672,0,0,0,4672,4672,0,0,0,0,0
1901,p1603,20150408,4672,4672,0,0,0,4672,4672,0,0,0,0,0
1902,p1603,20150409,4672,4672,0,0,0,4672,4672,0,0,0,0,0
1903,p1603,20150410,4672,4672,0,0,0,4672,4672,0,0,0,0,0
1904,p1603,20150413,4672,4672,0,0,0,4672,4672,0,0,0,0,0
1905,p1603,20150414,4672,4672,0,0,0,4672,4672,0,0,0,0,0
1906,p1603,20150415,4672,4672,0,0,0,4672,4672,0,0,0,0,0
1907,p1603,20150416,4672,4672,0,0,0,4712,4712,40,40,0,0,0
1908,p1603,20150417,4712,4712,0,0,0,4712,4712,0,0,0,0,0
1909,p1603,20150420,4712,4712,0,0,0,4808,4808,96,96,0,0,0
1910,p1603,20150421,4808,4808,0,0,0,4902,4902,94,94,0,0,0
1911,p1603,20150422,4902,4902,0,0,0,4914,4914,12,12,0,0,0
1912,p1603,20150423,4914,4914,0,0,0,4916,4916,2,2,0,0,0
1913,p1603,20150424,4916,4916,4944,4980,4864,4898,4940,-18,24,12,592920,6
1914,p1603,20150427,4898,4940,4844,4878,4822,4878,4840,-62,-100,12,580920,4
1915,p1603,20150428,4878,4840,0,0,0,4834,4834,-6,-6,0,0,4
1916,p1603,20150429,4834,4834,4868,4924,4810,4924,4874,90,40,10,487480,4
1917,p1603,20150430,4924,4874,0,0,0,4876,4876,2,2,0,0,4
1918,p1603,20150504,4876,4876,4970,5022,4970,5022,4986,146,110,6,299240,4
1919,p1603,20150505,5022,4986,5050,5118,5050,5080,5082,94,96,6,304960,6
1920,p1603,20150506,5080,5082,5082,5082,5082,5082,5082,0,0,2,101640,4
1921,p1603,20150507,5082,5082,0,0,0,5114,5114,32,32,0,0,4
1922,p1603,20150508,5114,5114,0,0,0,5058,5058,-56,-56,0,0,4
1923,p1603,20150511,5058,5058,0,0,0,5092,5092,34,34,0,0,4
1924,p1603,20150512,5092,5092,0,0,0,5092,5092,0,0,0,0,4
1925,p1603,20150513,5092,5092,0,0,0,5172,5172,80,80,0,0,4
1926,p1603,20150514,5172,5172,0,0,0,5126,5126,-46,-46,0,0,4
1927,p1603,20150515,5126,5126,0,0,0,5190,5190,64,64,0,0,4
1928,p1603,20150518,5190,5190,0,0,0,5126,5126,-64,-64,0,0,4
1929,p1603,20150519,5126,5126,0,0,0,5078,5078,-48,-48,0,0,4
1930,p1603,20150520,5078,5078,5090,5090,5090,5090,5090,12,12,2,101800,6
1931,p1603,20150521,5090,5090,0,0,0,5100,5100,10,10,0,0,6
1932,p1603,20150522,5100,5100,0,0,0,5130,5130,30,30,0,0,6
1933,p1603,20150525,5130,5130,0,0,0,5092,5092,-38,-38,0,0,6
1934,p1603,20150526,5092,5092,0,0,0,5224,5224,132,132,0,0,6
1935,p1603,20150527,5224,5224,0,0,0,5276,5276,52,52,0,0,6
1936,p1603,20150528,5276,5276,5354,5354,5354,5354,5354,78,78,8,428320,14
1937,p1603,20150529,5354,5354,0,0,0,5370,5370,16,16,0,0,14
1938,p1603,20150601,5370,5370,5354,5518,5354,5488,5420,118,50,10,542000,16
1939,p1603,20150602,5488,5420,5574,5590,5540,5540,5572,120,152,24,1337280,34
1940,p1603,20150603,5540,5572,5456,5456,5428,5428,5444,-144,-128,30,1633280,10
1941,p1603,20150604,5428,5444,0,0,0,5422,5422,-22,-22,0,0,10
1942,p1603,20150605,5422,5422,0,0,0,5420,5420,-2,-2,0,0,10
1943,p1603,20150608,5420,5420,0,0,0,5478,5478,58,58,0,0,10
1944,p1603,20150609,5478,5478,0,0,0,5382,5382,-96,-96,0,0,10
1945,p1603,20150610,5382,5382,5364,5364,5340,5340,5348,-42,-34,6,320880,6
1946,p1603,20150611,5340,5348,0,0,0,5330,5330,-18,-18,0,0,6
1947,p1603,20150612,5330,5330,0,0,0,5298,5298,-32,-32,0,0,6
1948,p1603,20150615,5298,5298,0,0,0,5222,5222,-76,-76,0,0,6
1949,p1603,20150616,5222,5222,0,0,0,5234,5234,12,12,0,0,6
1950,p1603,20150617,5234,5234,0,0,0,5258,5258,24,24,0,0,6
1951,p1603,20150618,5258,5258,0,0,0,5216,5216,-42,-42,0,0,6
1952,p1603,20150619,5216,5216,0,0,0,5152,5152,-64,-64,0,0,6
1953,p1603,20150623,5152,5152,0,0,0,5180,5180,28,28,0,0,6
1954,p1603,20150624,5180,5180,0,0,0,5170,5170,-10,-10,0,0,6
1955,p1603,20150625,5170,5170,0,0,0,5246,5246,76,76,0,0,6
1956,p1603,20150626,5246,5246,0,0,0,5230,5230,-16,-16,0,0,6
1957,p1603,20150629,5230,5230,0,0,0,5284,5284,54,54,0,0,6
1958,p1603,20150630,5284,5284,5086,5086,5074,5074,5080,-210,-204,4,203200,4
1959,p1603,20150701,5074,5080,5258,5258,5258,5258,5258,178,178,2,105160,6
1960,p1603,20150702,5258,5258,0,0,0,5256,5256,-2,-2,0,0,6
1961,p1603,20150703,5256,5256,0,0,0,5292,5292,36,36,0,0,6
1962,p1603,20150706,5292,5292,5172,5172,5172,5172,5172,-120,-120,2,103440,8
1963,p1603,20150707,5172,5172,0,0,0,5172,5172,0,0,0,0,8
1964,p1603,20150708,5172,5172,0,0,0,4976,4976,-196,-196,0,0,8
1965,p1603,20150709,4976,4976,4950,4990,4792,4990,4890,14,-86,10,489120,8
1966,p1603,20150710,4990,4890,0,0,0,4964,4964,74,74,0,0,8
1967,p1603,20150713,4964,4964,5098,5098,4904,4904,5000,-60,36,4,200040,8
1968,p1603,20150714,4904,5000,5156,5156,5040,5040,5098,40,98,4,203920,8
1969,p1603,20150715,5040,5098,0,0,0,5096,5096,-2,-2,0,0,8
1970,p1603,20150716,5096,5096,0,0,0,5096,5096,0,0,0,0,8
1971,p1603,20150717,5096,5096,0,0,0,5088,5088,-8,-8,0,0,8
1972,p1603,20150720,5088,5088,0,0,0,5096,5096,8,8,0,0,8
1973,p1603,20150721,5096,5096,0,0,0,5162,5162,66,66,0,0,8
1974,p1603,20150722,5162,5162,0,0,0,5192,5192,30,30,0,0,8
1975,p1603,20150723,5192,5192,0,0,0,5130,5130,-62,-62,0,0,8
1976,p1603,20150724,5130,5130,0,0,0,5106,5106,-24,-24,0,0,8
1977,p1603,20150727,5106,5106,0,0,0,5036,5036,-70,-70,0,0,8
1978,p1603,20150728,5036,5036,0,0,0,4968,4968,-68,-68,0,0,8
1979,p1603,20150729,4968,4968,4812,4928,4810,4928,4862,-40,-106,40,1945440,8
1980,p1603,20150730,4928,4862,0,0,0,4866,4866,4,4,0,0,8
1981,p1603,20150731,4866,4866,4890,4890,4888,4888,4888,22,22,6,293360,8
1982,p1603,20150803,4888,4888,0,0,0,4818,4818,-70,-70,0,0,8
1983,p1603,20150804,4818,4818,0,0,0,4706,4706,-112,-112,0,0,8
1984,p1603,20150805,4706,4706,0,0,0,4732,4732,26,26,0,0,8
1985,p1603,20150806,4732,4732,0,0,0,4700,4700,-32,-32,0,0,8
1986,p1603,20150807,4700,4700,0,0,0,4564,4564,-136,-136,0,0,8
1987,p1603,20150810,4564,4564,0,0,0,4574,4574,10,10,0,0,8
1988,p1603,20150811,4574,4574,0,0,0,4630,4630,56,56,0,0,8
1989,p1603,20150812,4630,4630,0,0,0,4642,4642,12,12,0,0,8
1990,p1603,20150813,4642,4642,0,0,0,4698,4698,56,56,0,0,8
1991,p1603,20150814,4698,4698,0,0,0,4658,4658,-40,-40,0,0,8
1992,p1603,20150817,4658,4658,0,0,0,4638,4638,-20,-20,0,0,8
1993,p1603,20150818,4638,4638,0,0,0,4668,4668,30,30,0,0,8
1994,p1603,20150819,4668,4668,0,0,0,4608,4608,-60,-60,0,0,8
1995,p1603,20150820,4608,4608,4564,4564,4446,4446,4518,-162,-90,6,271120,2
1996,p1603,20150821,4446,4518,0,0,0,4438,4438,-80,-80,0,0,2
1997,p1603,20150824,4438,4438,0,0,0,4304,4304,-134,-134,0,0,2
1998,p1603,20150825,4304,4304,0,0,0,4132,4132,-172,-172,0,0,2
1999,p1603,20150826,4132,4132,0,0,0,4148,4148,16,16,0,0,2
2000,p1603,20150827,4148,4148,0,0,0,4082,4082,-66,-66,0,0,2
2001,p1603,20150828,4082,4082,0,0,0,4230,4230,148,148,0,0,2
2002,p1603,20150831,4230,4230,0,0,0,4302,4302,72,72,0,0,2
2003,p1603,20150901,4302,4302,0,0,0,4318,4318,16,16,0,0,2
2004,p1603,20150902,4318,4318,0,0,0,4276,4276,-42,-42,0,0,2
2005,p1603,20150907,4276,4276,0,0,0,4244,4244,-32,-32,0,0,2
2006,p1603,20150908,4244,4244,0,0,0,4270,4270,26,26,0,0,2
2007,p1603,20150909,4270,4270,0,0,0,4346,4346,76,76,0,0,2
2008,p1603,20150910,4346,4346,0,0,0,4324,4324,-22,-22,0,0,2
2009,p1603,20150911,4324,4324,4388,4388,4388,4388,4388,64,64,2,87760,2
2010,p1603,20150914,4388,4388,0,0,0,4312,4312,-76,-76,0,0,2
2011,p1603,20150915,4312,4312,0,0,0,4358,4358,46,46,0,0,2
2012,p1603,20150916,4358,4358,0,0,0,4256,4256,-102,-102,0,0,2
2013,p1603,20150917,4256,4256,0,0,0,4264,4264,8,8,0,0,2
2014,p1603,20150918,4264,4264,0,0,0,4246,4246,-18,-18,0,0,2
2015,p1603,20150921,4246,4246,4220,4302,4220,4302,4270,56,24,6,256200,4
2016,p1603,20150922,4302,4270,0,0,0,4324,4324,54,54,0,0,4
2017,p1603,20150923,4324,4324,4408,4408,4408,4408,4408,84,84,2,88160,4
2018,p1603,20150924,4408,4408,4448,4448,4448,4448,4448,40,40,2,88960,2
2019,p1603,20150925,4448,4448,0,0,0,4548,4548,100,100,0,0,2
2020,p1603,20150928,4548,4548,0,0,0,4592,4592,44,44,0,0,2
2021,p1603,20150929,4592,4592,0,0,0,4522,4522,-70,-70,0,0,2
2022,p1603,20150930,4522,4522,0,0,0,4550,4550,28,28,0,0,2
2023,p1603,20151008,4550,4550,0,0,0,4584,4584,34,34,0,0,2
2024,p1603,20151009,4584,4584,0,0,0,4568,4568,-16,-16,0,0,2
2025,p1603,20151012,4568,4568,4736,4736,4678,4678,4706,110,138,12,564840,2
2026,p1603,20151013,4678,4706,0,0,0,4710,4710,4,4,0,0,2
2027,p1603,20151014,4710,4710,0,0,0,4760,4760,50,50,0,0,2
2028,p1603,20151015,4760,4760,0,0,0,4758,4758,-2,-2,0,0,2
2029,p1603,20151016,4758,4758,0,0,0,4774,4774,16,16,0,0,2
2030,p1603,20151019,4774,4774,0,0,0,4684,4684,-90,-90,0,0,2
2031,p1603,20151020,4684,4684,0,0,0,4600,4600,-84,-84,0,0,2
2032,p1603,20151021,4600,4600,4564,4680,4564,4680,4626,80,26,6,277600,2
2033,p1603,20151022,4680,4626,0,0,0,4664,4664,38,38,0,0,2
2034,p1603,20151023,4664,4664,0,0,0,4646,4646,-18,-18,0,0,2
2035,p1603,20151026,4646,4646,0,0,0,4568,4568,-78,-78,0,0,2
2036,p1603,20151027,4568,4568,0,0,0,4504,4504,-64,-64,0,0,2
2037,p1603,20151028,4504,4504,0,0,0,4450,4450,-54,-54,0,0,2
2038,p1603,20151029,4450,4450,0,0,0,4474,4474,24,24,0,0,2
2039,p1603,20151030,4474,4474,0,0,0,4472,4472,-2,-2,0,0,2
2040,p1603,20151102,4472,4472,0,0,0,4460,4460,-12,-12,0,0,2
2041,p1603,20151103,4460,4460,0,0,0,4430,4430,-30,-30,0,0,2
2042,p1603,20151104,4430,4430,0,0,0,4414,4414,-16,-16,0,0,2
2043,p1603,20151105,4414,4414,0,0,0,4432,4432,18,18,0,0,2
2044,p1603,20151106,4432,4432,0,0,0,4286,4286,-146,-146,0,0,2
2045,p1603,20151109,4286,4286,0,0,0,4290,4290,4,4,0,0,2
2046,p1603,20151110,4290,4290,0,0,0,4266,4266,-24,-24,0,0,2
2047,p1603,20151111,4266,4266,0,0,0,4208,4208,-58,-58,0,0,2
2048,p1603,20151112,4208,4208,0,0,0,4210,4210,2,2,0,0,2
2049,p1603,20151113,4210,4210,0,0,0,4204,4204,-6,-6,0,0,2
2050,p1603,20151116,4204,4204,0,0,0,4106,4106,-98,-98,0,0,2
2051,p1603,20151117,4106,4106,0,0,0,4106,4106,0,0,0,0,2
2052,p1603,20151118,4106,4106,0,0,0,4092,4092,-14,-14,0,0,2
2053,p1603,20151119,4092,4092,0,0,0,4060,4060,-32,-32,0,0,2
2054,p1603,20151120,4060,4060,0,0,0,3992,3992,-68,-68,0,0,2
2055,p1603,20151123,3992,3992,0,0,0,3988,3988,-4,-4,0,0,2
2056,p1603,20151124,3988,3988,0,0,0,4146,4146,158,158,0,0,2
2057,p1603,20151125,4146,4146,0,0,0,4178,4178,32,32,0,0,2
2058,p1603,20151126,4178,4178,0,0,0,4224,4224,46,46,0,0,2
2059,p1603,20151127,4224,4224,0,0,0,4268,4268,44,44,0,0,2
2060,p1603,20151130,4268,4268,0,0,0,4274,4274,6,6,0,0,2
2061,p1603,20151201,4274,4274,4444,4444,4404,4444,4426,170,152,8,354200,4
2062,p1603,20151202,4444,4426,0,0,0,4458,4458,32,32,0,0,4
2063,p1603,20151203,4458,4458,0,0,0,4524,4524,66,66,0,0,4
2064,p1603,20151204,4524,4524,4698,4698,4694,4694,4696,170,172,4,187840,2
2065,p1603,20151207,4694,4696,4700,4700,4596,4596,4650,-100,-46,14,651120,2
2066,p1603,20151208,4596,4650,4464,4464,4464,4464,4464,-186,-186,2,89280,0
2067,p1603,20151209,4464,4464,0,0,0,4420,4420,-44,-44,0,0,0
2068,p1603,20151210,4420,4420,0,0,0,4424,4424,4,4,0,0,0
2069,p1603,20151211,4424,4424,0,0,0,4456,4456,32,32,0,0,0
2070,p1603,20151214,4456,4456,0,0,0,4532,4532,76,76,0,0,0
2071,p1603,20151215,4532,4532,0,0,0,4514,4514,-18,-18,0,0,0
2072,p1603,20151216,4514,4514,0,0,0,4474,4474,-40,-40,0,0,0
2073,p1603,20151217,4474,4474,0,0,0,4364,4364,-110,-110,0,0,0
2074,p1603,20151218,4364,4364,0,0,0,4208,4208,-156,-156,0,0,0
2075,p1603,20151221,4208,4208,0,0,0,4200,4200,-8,-8,0,0,0
2076,p1603,20151222,4200,4200,0,0,0,4270,4270,70,70,0,0,0
2077,p1603,20151223,4270,4270,0,0,0,4316,4316,46,46,0,0,0
2078,p1603,20151224,4316,4316,0,0,0,4482,4482,166,166,0,0,0
2079,p1603,20151225,4482,4482,0,0,0,4454,4454,-28,-28,0,0,0
2080,p1603,20151228,4454,4454,0,0,0,4424,4424,-30,-30,0,0,0
2081,p1603,20151229,4424,4424,0,0,0,4370,4370,-54,-54,0,0,0
2082,p1603,20151230,4370,4370,0,0,0,4516,4516,146,146,0,0,0
2083,p1603,20151231,4516,4516,0,0,0,4552,4552,36,36,0,0,0
2084,p1604,20150416,4638,4638,4854,4854,4654,4654,4754,16,116,4,190160,2
2085,p1604,20150417,4654,4754,4670,4838,4662,4838,4742,84,-12,8,379400,0
2086,p1604,20150420,4838,4742,0,0,0,4794,4794,52,52,0,0,0
2087,p1604,20150421,4794,4794,0,0,0,4886,4886,92,92,0,0,0
2088,p1604,20150422,4886,4886,0,0,0,4898,4898,12,12,0,0,0
2089,p1604,20150423,4898,4898,0,0,0,4900,4900,2,2,0,0,0
2090,p1604,20150424,4900,4900,0,0,0,4922,4922,22,22,0,0,0
2091,p1604,20150427,4922,4922,0,0,0,4824,4824,-98,-98,0,0,0
2092,p1604,20150428,4824,4824,0,0,0,4818,4818,-6,-6,0,0,0
2093,p1604,20150429,4818,4818,4948,4952,4864,4864,4920,46,102,6,295280,2
2094,p1604,20150430,4864,4920,0,0,0,4920,4920,0,0,0,0,2
2095,p1604,20150504,4920,4920,0,0,0,5030,5030,110,110,0,0,2
2096,p1604,20150505,5030,5030,5098,5098,4984,4994,5038,-36,8,62,3124480,0
2097,p1604,20150506,4994,5038,0,0,0,5038,5038,0,0,0,0,0
2098,p1604,20150507,5038,5038,0,0,0,5070,5070,32,32,0,0,0
2099,p1604,20150508,5070,5070,0,0,0,5016,5016,-54,-54,0,0,0
2100,p1604,20150511,5016,5016,0,0,0,5048,5048,32,32,0,0,0
2101,p1604,20150512,5048,5048,0,0,0,5088,5088,40,40,0,0,0
2102,p1604,20150513,5088,5088,0,0,0,5168,5168,80,80,0,0,0
2103,p1604,20150514,5168,5168,0,0,0,5122,5122,-46,-46,0,0,0
2104,p1604,20150515,5122,5122,0,0,0,5186,5186,64,64,0,0,0
2105,p1604,20150518,5186,5186,0,0,0,5122,5122,-64,-64,0,0,0
2106,p1604,20150519,5122,5122,0,0,0,5074,5074,-48,-48,0,0,0
2107,p1604,20150520,5074,5074,5090,5090,5090,5090,5090,16,16,2,101800,2
2108,p1604,20150521,5090,5090,0,0,0,5100,5100,10,10,0,0,2
2109,p1604,20150522,5100,5100,0,0,0,5130,5130,30,30,0,0,2
2110,p1604,20150525,5130,5130,5120,5120,5120,5120,5120,-10,-10,2,102400,2
2111,p1604,20150526,5120,5120,5050,5188,5042,5188,5124,68,4,14,717600,6
2112,p1604,20150527,5188,5124,0,0,0,5176,5176,52,52,0,0,6
2113,p1604,20150528,5176,5176,5298,5348,5298,5318,5320,142,144,8,425640,10
2114,p1604,20150529,5318,5320,0,0,0,5320,5320,0,0,0,0,10
2115,p1604,20150601,5320,5320,5464,5464,5464,5464,5464,144,144,2,109280,10
2116,p1604,20150602,5464,5464,5606,5638,5564,5622,5598,158,134,40,2239840,36
2117,p1604,20150603,5622,5598,5600,5600,5492,5550,5536,-48,-62,58,3211280,66
2118,p1604,20150604,5550,5536,5568,5616,5494,5516,5562,-20,26,34,1891600,74
2119,p1604,20150605,5516,5562,5534,5620,5508,5620,5518,58,-44,24,1324680,88
2120,p1604,20150608,5620,5518,5654,5654,5512,5588,5544,70,26,46,2550640,72
2121,p1604,20150609,5588,5544,0,0,0,5450,5450,-94,-94,0,0,72
2122,p1604,20150610,5450,5450,5494,5494,5370,5466,5442,16,-8,14,762040,78
2123,p1604,20150611,5466,5442,5478,5478,5430,5464,5450,22,8,10,545120,80
2124,p1604,20150612,5464,5450,5342,5342,5342,5342,5342,-108,-108,2,106840,80
2125,p1604,20150615,5342,5342,5386,5386,5310,5358,5346,16,4,8,427800,82
2126,p1604,20150616,5358,5346,5398,5398,5398,5398,5398,52,52,2,107960,84
2127,p1604,20150617,5398,5398,5440,5440,5440,5440,5440,42,42,2,108800,86
2128,p1604,20150618,5440,5440,5386,5390,5310,5332,5354,-108,-86,18,963760,94
2129,p1604,20150619,5332,5354,5302,5400,5302,5400,5358,46,4,12,643160,100
2130,p1604,20150623,5400,5358,5422,5422,5422,5422,5422,64,64,2,108440,102
2131,p1604,20150624,5422,5422,5374,5424,5374,5424,5392,2,-30,8,431440,108
2132,p1604,20150625,5424,5392,5478,5478,5470,5470,5474,78,82,4,218960,110
2133,p1604,20150626,5470,5474,5520,5520,5518,5518,5518,44,44,4,220760,112
2134,p1604,20150629,5518,5518,5384,5442,5384,5442,5412,-76,-106,4,216520,114
2135,p1604,20150630,5442,5412,5318,5366,5270,5278,5316,-134,-96,10,531680,118
2136,p1604,20150701,5278,5316,5330,5434,5330,5420,5378,104,62,8,430280,120
2137,p1604,20150702,5420,5378,5378,5408,5322,5408,5360,30,-18,24,1286600,122
2138,p1604,20150703,5408,5360,5396,5440,5372,5400,5396,40,36,48,2590440,102
2139,p1604,20150706,5400,5396,5184,5296,5182,5296,5214,-100,-182,30,1564520,100
2140,p1604,20150707,5296,5214,5268,5274,5090,5150,5164,-64,-50,122,6302400,20
2141,p1604,20150708,5150,5164,0,0,0,4968,4968,-196,-196,0,0,20
2142,p1604,20150709,4968,4968,4770,4770,4770,4770,4770,-198,-198,2,95400,18
2143,p1604,20150710,4770,4770,0,0,0,4960,4960,190,190,0,0,18
2144,p1604,20150713,4960,4960,0,0,0,4960,4960,0,0,0,0,18
2145,p1604,20150714,4960,4960,0,0,0,4968,4968,8,8,0,0,18
2146,p1604,20150715,4968,4968,0,0,0,4968,4968,0,0,0,0,18
2147,p1604,20150716,4968,4968,4844,5016,4844,4956,4920,-12,-48,40,1968480,16
2148,p1604,20150717,4956,4920,4946,4946,4946,4946,4946,26,26,4,197840,12
2149,p1604,20150720,4946,4946,0,0,0,4984,4984,38,38,0,0,12
2150,p1604,20150721,4984,4984,0,0,0,5052,5052,68,68,0,0,12
2151,p1604,20150722,5052,5052,0,0,0,5082,5082,30,30,0,0,12
2152,p1604,20150723,5082,5082,0,0,0,5058,5058,-24,-24,0,0,12
2153,p1604,20150724,5058,5058,0,0,0,5052,5052,-6,-6,0,0,12
2154,p1604,20150727,5052,5052,0,0,0,4950,4950,-102,-102,0,0,12
2155,p1604,20150728,4950,4950,0,0,0,4950,4950,0,0,0,0,12
2156,p1604,20150729,4950,4950,0,0,0,4846,4846,-104,-104,0,0,12
2157,p1604,20150730,4846,4846,0,0,0,4846,4846,0,0,0,0,12
2158,p1604,20150731,4846,4846,0,0,0,4846,4846,0,0,0,0,12
2159,p1604,20150803,4846,4846,0,0,0,4776,4776,-70,-70,0,0,12
2160,p1604,20150804,4776,4776,4760,4866,4760,4846,4844,70,68,12,581360,12
2161,p1604,20150805,4846,4844,0,0,0,4844,4844,0,0,0,0,12
2162,p1604,20150806,4844,4844,0,0,0,4812,4812,-32,-32,0,0,12
2163,p1604,20150807,4812,4812,4714,4714,4714,4714,4714,-98,-98,2,94280,12
2164,p1604,20150810,4714,4714,0,0,0,4714,4714,0,0,0,0,12
2165,p1604,20150811,4714,4714,0,0,0,4770,4770,56,56,0,0,12
2166,p1604,20150812,4770,4770,0,0,0,4782,4782,12,12,0,0,12
2167,p1604,20150813,4782,4782,4834,4834,4834,4834,4834,52,52,2,96680,14
2168,p1604,20150814,4834,4834,4818,4824,4720,4778,4782,-56,-52,56,2678480,18
2169,p1604,20150817,4778,4782,4768,4802,4768,4802,4778,20,-4,6,286760,14
2170,p1604,20150818,4802,4778,4772,4772,4732,4732,4752,-46,-26,4,190080,12
2171,p1604,20150819,4732,4752,0,0,0,4690,4690,-62,-62,0,0,12
2172,p1604,20150820,4690,4690,0,0,0,4600,4600,-90,-90,0,0,12
2173,p1604,20150821,4600,4600,0,0,0,4518,4518,-82,-82,0,0,12
2174,p1604,20150824,4518,4518,0,0,0,4382,4382,-136,-136,0,0,12
2175,p1604,20150825,4382,4382,0,0,0,4208,4208,-174,-174,0,0,12
2176,p1604,20150826,4208,4208,0,0,0,4226,4226,18,18,0,0,12
2177,p1604,20150827,4226,4226,0,0,0,4160,4160,-66,-66,0,0,12
2178,p1604,20150828,4160,4160,0,0,0,4312,4312,152,152,0,0,12
2179,p1604,20150831,4312,4312,0,0,0,4312,4312,0,0,0,0,12
2180,p1604,20150901,4312,4312,0,0,0,4328,4328,16,16,0,0,12
2181,p1604,20150902,4328,4328,0,0,0,4286,4286,-42,-42,0,0,12
2182,p1604,20150907,4286,4286,0,0,0,4254,4254,-32,-32,0,0,12
2183,p1604,20150908,4254,4254,0,0,0,4280,4280,26,26,0,0,12
2184,p1604,20150909,4280,4280,0,0,0,4450,4450,170,170,0,0,12
2185,p1604,20150910,4450,4450,4484,4484,4484,4484,4484,34,34,2,89680,12
2186,p1604,20150911,4484,4484,0,0,0,4550,4550,66,66,0,0,12
2187,p1604,20150914,4550,4550,4538,4538,4538,4538,4538,-12,-12,4,181520,16
2188,p1604,20150915,4538,4538,4552,4552,4492,4492,4532,-46,-6,6,271920,14
2189,p1604,20150916,4492,4532,0,0,0,4426,4426,-106,-106,0,0,14
2190,p1604,20150917,4426,4426,0,0,0,4436,4436,10,10,0,0,14
2191,p1604,20150918,4436,4436,0,0,0,4416,4416,-20,-20,0,0,14
2192,p1604,20150921,4416,4416,4402,4422,4402,4422,4412,6,-4,8,352960,12
2193,p1604,20150922,4422,4412,4478,4478,4478,4478,4478,66,66,2,89560,14
2194,p1604,20150923,4478,4478,4400,4474,4400,4470,4448,-8,-30,6,266880,12
2195,p1604,20150924,4470,4448,4494,4494,4494,4494,4494,46,46,6,269640,6
2196,p1604,20150925,4494,4494,4574,4574,4574,4574,4574,80,80,2,91480,6
2197,p1604,20150928,4574,4574,4636,4636,4636,4636,4636,62,62,2,92720,4
2198,p1604,20150929,4636,4636,0,0,0,4566,4566,-70,-70,0,0,4
2199,p1604,20150930,4566,4566,0,0,0,4594,4594,28,28,0,0,4
2200,p1604,20151008,4594,4594,0,0,0,4628,4628,34,34,0,0,4
2201,p1604,20151009,4628,4628,0,0,0,4612,4612,-16,-16,0,0,4
2202,p1604,20151012,4612,4612,0,0,0,4750,4750,138,138,0,0,4
2203,p1604,20151013,4750,4750,0,0,0,4774,4774,24,24,0,0,4
2204,p1604,20151014,4774,4774,0,0,0,4824,4824,50,50,0,0,4
2205,p1604,20151015,4824,4824,0,0,0,4824,4824,0,0,0,0,4
2206,p1604,20151016,4824,4824,0,0,0,4840,4840,16,16,0,0,4
2207,p1604,20151019,4840,4840,0,0,0,4750,4750,-90,-90,0,0,4
2208,p1604,20151020,4750,4750,0,0,0,4664,4664,-86,-86,0,0,4
2209,p1604,20151021,4664,4664,0,0,0,4690,4690,26,26,0,0,4
2210,p1604,20151022,4690,4690,0,0,0,4728,4728,38,38,0,0,4
2211,p1604,20151023,4728,4728,0,0,0,4710,4710,-18,-18,0,0,4
2212,p1604,20151026,4710,4710,0,0,0,4632,4632,-78,-78,0,0,4
2213,p1604,20151027,4632,4632,0,0,0,4566,4566,-66,-66,0,0,4
2214,p1604,20151028,4566,4566,0,0,0,4510,4510,-56,-56,0,0,4
2215,p1604,20151029,4510,4510,0,0,0,4534,4534,24,24,0,0,4
2216,p1604,20151030,4534,4534,4516,4516,4516,4516,4516,-18,-18,2,90320,6
2217,p1604,20151102,4516,4516,0,0,0,4504,4504,-12,-12,0,0,6
2218,p1604,20151103,4504,4504,0,0,0,4474,4474,-30,-30,0,0,6
2219,p1604,20151104,4474,4474,4468,4566,4468,4538,4528,64,54,14,634120,8
2220,p1604,20151105,4538,4528,4588,4588,4588,4588,4588,60,60,2,91760,8
2221,p1604,20151106,4588,4588,4524,4524,4524,4524,4524,-64,-64,2,90480,8
2222,p1604,20151109,4524,4524,4488,4488,4488,4488,4488,-36,-36,2,89760,6
2223,p1604,20151110,4488,4488,0,0,0,4464,4464,-24,-24,0,0,6
2224,p1604,20151111,4464,4464,0,0,0,4404,4404,-60,-60,0,0,6
2225,p1604,20151112,4404,4404,4380,4380,4380,4380,4380,-24,-24,2,87600,4
2226,p1604,20151113,4380,4380,4424,4424,4370,4370,4396,-10,16,4,175880,4
2227,p1604,20151116,4370,4396,0,0,0,4294,4294,-102,-102,0,0,4
2228,p1604,20151117,4294,4294,0,0,0,4296,4296,2,2,0,0,4
2229,p1604,20151118,4296,4296,0,0,0,4280,4280,-16,-16,0,0,4
2230,p1604,20151119,4280,4280,0,0,0,4246,4246,-34,-34,0,0,4
2231,p1604,20151120,4246,4246,0,0,0,4174,4174,-72,-72,0,0,4
2232,p1604,20151123,4174,4174,0,0,0,4168,4168,-6,-6,0,0,4
2233,p1604,20151124,4168,4168,0,0,0,4334,4334,166,166,0,0,4
2234,p1604,20151125,4334,4334,0,0,0,4334,4334,0,0,0,0,4
2235,p1604,20151126,4334,4334,0,0,0,4506,4506,172,172,0,0,4
2236,p1604,20151127,4506,4506,0,0,0,4554,4554,48,48,0,0,4
2237,p1604,20151130,4554,4554,0,0,0,4554,4554,0,0,0,0,4
2238,p1604,20151201,4554,4554,0,0,0,4714,4714,160,160,0,0,4
2239,p1604,20151202,4714,4714,0,0,0,4748,4748,34,34,0,0,4
2240,p1604,20151203,4748,4748,4560,4714,4560,4634,4614,-114,-134,42,1938680,4
2241,p1604,20151204,4634,4614,4730,4730,4694,4694,4708,80,94,6,282480,8
2242,p1604,20151207,4694,4708,4828,4828,4828,4828,4828,120,120,2,96560,10
2243,p1604,20151208,4828,4828,4668,4698,4668,4698,4678,-130,-150,6,280720,8
2244,p1604,20151209,4698,4678,4700,4700,4692,4692,4696,14,18,4,187840,8
2245,p1604,20151210,4692,4696,4692,4702,4564,4564,4650,-132,-46,10,465160,6
2246,p1604,20151211,4564,4650,0,0,0,4678,4678,28,28,0,0,6
2247,p1604,20151214,4678,4678,4720,4720,4720,4720,4720,42,42,2,94400,6
2248,p1604,20151215,4720,4720,4716,4716,4716,4716,4716,-4,-4,2,94320,6
2249,p1604,20151216,4716,4716,4654,4654,4654,4654,4654,-62,-62,2,93080,8
2250,p1604,20151217,4654,4654,4640,4640,4640,4640,4640,-14,-14,2,92800,6
2251,p1604,20151218,4640,4640,0,0,0,4640,4640,0,0,0,0,6
2252,p1604,20151221,4640,4640,4464,4572,4464,4564,4510,-76,-130,26,1172960,6
2253,p1604,20151222,4564,4510,0,0,0,4586,4586,76,76,0,0,6
2254,p1604,20151223,4586,4586,0,0,0,4634,4634,48,48,0,0,6
2255,p1604,20151224,4634,4634,0,0,0,4814,4814,180,180,0,0,6
2256,p1604,20151225,4814,4814,0,0,0,4784,4784,-30,-30,0,0,6
2257,p1604,20151228,4784,4784,0,0,0,4752,4752,-32,-32,0,0,6
2258,p1604,20151229,4752,4752,4778,4838,4704,4746,4758,-6,6,22,1046960,8
2259,p1604,20151230,4746,4758,4832,4854,4762,4762,4816,4,58,48,2312160,8
2260,p1604,20151231,4762,4816,0,0,0,4854,4854,38,38,0,0,8
2261,p1605,20150518,5152,5152,5268,5306,5226,5262,5244,110,92,1914,100390680,1268
2262,p1605,20150519,5262,5244,5246,5252,5168,5186,5200,-58,-44,1920,99855760,2232
2263,p1605,20150520,5186,5200,5180,5180,5038,5068,5086,-132,-114,2556,130043720,2856
2264,p1605,20150521,5068,5086,5104,5120,5080,5098,5100,12,14,954,48657400,3326
2265,p1605,20150522,5098,5100,5128,5170,5126,5160,5142,60,42,1934,99484400,3944
2266,p1605,20150525,5160,5142,5110,5160,5100,5156,5126,14,-16,1174,60182640,4202
2267,p1605,20150526,5156,5126,5156,5328,5154,5280,5276,154,150,1902,100370200,4876
2268,p1605,20150527,5280,5276,5266,5326,5250,5294,5290,18,14,1956,103510720,5176
2269,p1605,20150528,5294,5290,5288,5396,5266,5370,5328,80,38,6936,369674120,7032
2270,p1605,20150529,5370,5328,5340,5384,5322,5326,5346,-2,18,9682,517686000,12926
2271,p1605,20150601,5326,5346,5340,5550,5236,5486,5454,140,108,9634,525473960,14592
2272,p1605,20150602,5486,5454,5532,5588,5518,5572,5558,118,104,12426,690847000,19448
2273,p1605,20150603,5572,5558,5560,5630,5480,5488,5548,-70,-10,15990,887201440,23190
2274,p1605,20150604,5488,5548,5496,5560,5436,5494,5498,-54,-50,17934,986020840,24980
2275,p1605,20150605,5494,5498,5504,5544,5446,5530,5490,32,-8,14868,816462760,27564
2276,p1605,20150608,5530,5490,5520,5566,5484,5500,5514,10,24,8388,462559960,30734
2277,p1605,20150609,5500,5514,5478,5504,5360,5406,5414,-108,-100,7906,428169520,30926
2278,p1605,20150610,5406,5414,5428,5460,5372,5408,5418,-6,4,9058,490788720,31998
2279,p1605,20150611,5408,5418,5418,5442,5370,5420,5402,2,-16,7594,410351640,31624
2280,p1605,20150612,5420,5402,5406,5430,5300,5302,5358,-100,-44,13710,734598880,31226
2281,p1605,20150615,5302,5358,5320,5354,5280,5306,5316,-52,-42,11802,627484560,31116
2282,p1605,20150616,5306,5316,5316,5368,5274,5368,5332,52,16,7614,406109360,31068
2283,p1605,20150617,5368,5332,5366,5380,5304,5352,5350,20,18,7768,415708640,29926
2284,p1605,20150618,5352,5350,5344,5384,5262,5262,5304,-88,-46,13622,722680400,28096
2285,p1605,20150619,5262,5304,5258,5292,5216,5284,5250,-20,-54,7856,412500200,26854
2286,p1605,20150623,5284,5250,5288,5326,5246,5256,5280,6,30,4510,238135080,27032
2287,p1605,20150624,5256,5280,5248,5308,5208,5302,5268,22,-12,7830,412634920,30282
2288,p1605,20150625,5302,5268,5318,5370,5308,5308,5334,40,66,6502,346932440,29732
2289,p1605,20150626,5308,5334,5306,5362,5250,5286,5316,-48,-18,10084,536169000,28380
2290,p1605,20150629,5286,5316,5330,5360,5238,5266,5290,-50,-26,8148,431153880,27654
2291,p1605,20150630,5266,5290,5276,5282,5114,5172,5198,-118,-92,10722,557348480,27120
2292,p1605,20150701,5172,5198,5174,5356,5158,5286,5280,88,82,6210,327976720,26884
2293,p1605,20150702,5286,5280,5300,5300,5214,5272,5242,-8,-38,5498,288236720,25152
2294,p1605,20150703,5272,5242,5272,5316,5256,5276,5286,34,44,5284,279350720,26078
2295,p1605,20150706,5276,5286,5270,5270,5090,5154,5184,-132,-102,10456,542078240,25684
2296,p1605,20150707,5154,5184,5150,5192,5082,5110,5136,-74,-48,6276,322399880,24796
2297,p1605,20150708,5110,5136,5100,5100,4932,4932,4978,-204,-158,5312,264505160,24352
2298,p1605,20150709,4932,4978,4680,5030,4680,4926,4822,-52,-156,20120,970425040,22322
2299,p1605,20150710,4926,4822,4984,5014,4954,5014,5002,192,180,7192,359790840,22744
2300,p1605,20150713,5014,5002,5038,5066,4948,5002,4998,0,-4,10244,512132280,22928
2301,p1605,20150714,5002,4998,4984,5128,4964,5056,5070,58,72,6344,321767640,22842
2302,p1605,20150715,5056,5070,5044,5104,5020,5044,5066,-26,-4,7316,370720920,24844
2303,p1605,20150716,5044,5066,5032,5036,4940,4988,4982,-78,-84,4740,236216360,25180
2304,p1605,20150717,4988,4982,5016,5032,4936,4984,4974,2,-8,3648,181486760,25352
2305,p1605,20150720,4984,4974,4970,5024,4940,5024,4982,50,8,4908,244576560,26482
2306,p1605,20150721,5024,4982,5030,5088,5008,5088,5058,106,76,9216,466320120,27796
2307,p1605,20150722,5088,5058,5100,5118,5044,5078,5080,20,22,5416,275133680,28086
2308,p1605,20150723,5078,5080,5052,5056,4994,5004,5020,-76,-60,6668,334748680,28990
2309,p1605,20150724,5004,5020,5004,5028,4972,4994,4994,-26,-26,6350,317210480,31534
2310,p1605,20150727,4994,4994,4998,5006,4870,4890,4924,-104,-70,11984,590213400,32618
2311,p1605,20150728,4890,4924,4856,4904,4820,4874,4866,-50,-58,8784,427496560,33718
2312,p1605,20150729,4874,4866,4880,4932,4878,4902,4904,36,38,9862,483638240,35708
2313,p1605,20150730,4902,4904,4882,4908,4864,4886,4884,-18,-20,8704,425276680,35800
2314,p1605,20150731,4886,4884,4918,4926,4882,4886,4902,2,18,7622,373691400,35464
2315,p1605,20150803,4886,4902,4880,4902,4782,4788,4830,-114,-72,9490,458518920,36326
2316,p1605,20150804,4788,4830,4760,4816,4742,4788,4778,-42,-52,17296,826609400,40782
2317,p1605,20150805,4788,4778,4828,4830,4746,4806,4808,28,30,13300,639470680,39176
2318,p1605,20150806,4806,4808,4786,4798,4712,4714,4748,-94,-60,9240,438795040,41432
2319,p1605,20150807,4714,4748,4730,4750,4646,4724,4710,-24,-38,13584,639837000,43480
2320,p1605,20150810,4724,4710,4720,4774,4684,4710,4716,0,6,12936,610106320,46950
2321,p1605,20150811,4710,4716,4700,4846,4700,4790,4762,74,46,24114,1148359240,48714
2322,p1605,20150812,4790,4762,4760,4820,4752,4820,4784,58,22,12712,608219320,49726
2323,p1605,20150813,4820,4784,4800,4882,4652,4768,4764,-16,-20,38868,1852193120,53514
2324,p1605,20150814,4768,4764,4738,4802,4732,4736,4766,-28,2,26520,1264091200,53398
2325,p1605,20150817,4736,4766,4732,4780,4720,4758,4762,-8,-4,30734,1463858120,55950
2326,p1605,20150818,4758,4762,4772,4786,4710,4722,4750,-40,-12,40734,1935319800,68988
2327,p1605,20150819,4722,4750,4730,4734,4652,4706,4688,-44,-62,30664,1437568640,66698
2328,p1605,20150820,4706,4688,4702,4712,4610,4610,4654,-78,-34,27988,1303071120,66828
2329,p1605,20150821,4610,4654,4620,4640,4592,4600,4614,-54,-40,35776,1650942600,69274
2330,p1605,20150824,4600,4614,4586,4596,4430,4430,4478,-184,-136,59036,2644193400,61650
2331,p1605,20150825,4430,4478,4370,4398,4252,4298,4332,-180,-146,76016,3294346400,63820
2332,p1605,20150826,4298,4332,4400,4432,4296,4318,4352,-14,20,49754,2166145720,70276
2333,p1605,20150827,4318,4352,4310,4380,4270,4380,4326,28,-26,46686,2020314960,74674
2334,p1605,20150828,4380,4326,4400,4498,4386,4496,4450,170,124,45344,2018536200,74490
2335,p1605,20150831,4496,4450,4520,4520,4420,4458,4456,8,6,45718,2037748600,72706
2336,p1605,20150901,4458,4456,4426,4560,4422,4524,4494,68,38,67434,3031485840,83884
2337,p1605,20150902,4524,4494,4500,4512,4432,4450,4472,-44,-22,49320,2205757320,84104
2338,p1605,20150907,4450,4472,4430,4454,4250,4430,4430,-42,-42,26542,1176197160,81518
2339,p1605,20150908,4430,4430,4460,4494,4444,4490,4468,60,38,48678,2175649280,78014
2340,p1605,20150909,4490,4468,4510,4566,4510,4526,4530,58,62,60336,2734128360,78182
2341,p1605,20150910,4526,4530,4530,4566,4494,4556,4528,26,-2,68918,3121157040,92734
2342,p1605,20150911,4556,4528,4580,4616,4552,4558,4580,30,52,70962,3251059520,102940
2343,p1605,20150914,4558,4580,4540,4564,4470,4558,4532,-22,-48,74660,3384873360,114452
2344,p1605,20150915,4558,4532,4598,4616,4494,4500,4570,-32,38,89632,4097614920,113820
2345,p1605,20150916,4500,4570,4488,4520,4458,4516,4492,-54,-78,86500,3886276760,109024
2346,p1605,20150917,4516,4492,4522,4530,4482,4482,4500,-10,8,45574,2051456440,109800
2347,p1605,20150918,4482,4500,4470,4510,4462,4466,4480,-34,-20,61280,2746509640,111274
2348,p1605,20150921,4466,4480,4452,4492,4416,4488,4446,8,-34,63880,2840882920,109480
2349,p1605,20150922,4488,4446,4494,4516,4460,4470,4486,24,40,85568,3839755600,130106
2350,p1605,20150923,4470,4486,4456,4494,4444,4466,4470,-20,-16,83926,3751656040,139872
2351,p1605,20150924,4466,4470,4510,4528,4490,4526,4508,56,38,88724,3999998640,147692
2352,p1605,20150925,4526,4508,4500,4634,4494,4602,4574,94,66,179524,8213971520,139066
2353,p1605,20150928,4602,4574,4650,4678,4628,4648,4652,74,78,115178,5358914120,128616
2354,p1605,20150929,4648,4652,4662,4672,4540,4582,4590,-70,-62,128938,5919193240,129436
2355,p1605,20150930,4582,4590,4618,4650,4602,4632,4628,42,38,103326,4782572800,131388
2356,p1605,20151008,4632,4628,4628,4700,4580,4628,4650,0,22,64632,3005943960,129746
2357,p1605,20151009,4628,4650,4628,4698,4604,4670,4656,20,6,109772,5112150040,146930
2358,p1605,20151012,4670,4656,4680,4772,4642,4752,4724,96,68,126348,5969822880,152658
2359,p1605,20151013,4752,4724,4746,4822,4692,4816,4746,92,22,111728,5304132400,147500
2360,p1605,20151014,4816,4746,4836,4836,4782,4794,4808,48,62,83598,4020011360,148962
2361,p1605,20151015,4794,4808,4828,4848,4788,4828,4816,20,8,99772,4805525000,159670
2362,p1605,20151016,4828,4816,4800,4810,4746,4774,4778,-42,-38,113646,5431287200,148180
2363,p1605,20151019,4774,4778,4760,4776,4728,4736,4752,-42,-26,71850,3414812600,153966
2364,p1605,20151020,4736,4752,4712,4720,4642,4686,4674,-66,-78,96790,4525891360,157484
2365,p1605,20151021,4686,4674,4696,4748,4692,4714,4722,40,48,109654,5179559520,165854
2366,p1605,20151022,4714,4722,4742,4796,4722,4792,4764,70,42,99054,4719428120,163148
2367,p1605,20151023,4792,4764,4786,4804,4726,4738,4752,-26,-12,143014,6796519400,172204
2368,p1605,20151026,4738,4752,4748,4756,4636,4648,4680,-104,-72,141898,6643003000,197168
2369,p1605,20151027,4648,4680,4630,4666,4558,4658,4614,-22,-66,159442,7356841200,203606
2370,p1605,20151028,4658,4614,4680,4680,4604,4630,4632,16,18,140896,6528798520,218084
2371,p1605,20151029,4630,4632,4636,4688,4628,4630,4656,-2,24,114980,5355577880,219582
2372,p1605,20151030,4630,4656,4644,4658,4604,4610,4626,-46,-30,92702,4289298600,223084
2373,p1605,20151102,4610,4626,4612,4672,4580,4658,4630,32,4,125496,5811307400,228988
2374,p1605,20151103,4658,4630,4628,4636,4548,4550,4592,-80,-38,164946,7577612840,227250
2375,p1605,20151104,4550,4592,4562,4612,4544,4610,4580,18,-12,171878,7873893520,234064
2376,p1605,20151105,4610,4580,4622,4644,4590,4608,4622,28,42,196196,9071017920,262548
2377,p1605,20151106,4608,4622,4600,4602,4502,4526,4528,-96,-94,248792,11269548680,277692
2378,p1605,20151109,4526,4528,4490,4546,4490,4524,4518,-4,-10,120840,5461811400,278802
2379,p1605,20151110,4524,4518,4552,4552,4472,4506,4502,-12,-16,123420,5557389920,282640
2380,p1605,20151111,4506,4502,4490,4504,4344,4370,4384,-132,-118,612282,26845878120,397328
2381,p1605,20151112,4370,4384,4378,4398,4366,4382,4378,-2,-6,200916,8799225400,407106
2382,p1605,20151113,4382,4378,4370,4410,4350,4378,4380,0,2,264842,11601726760,389628
2383,p1605,20151116,4378,4380,4360,4374,4340,4356,4356,-24,-24,245802,10709505480,395388
2384,p1605,20151117,4356,4356,4350,4400,4324,4378,4364,22,8,332758,14528035200,408590
2385,p1605,20151118,4378,4364,4370,4386,4308,4340,4348,-24,-16,412646,17944608360,429880
2386,p1605,20151119,4340,4348,4362,4366,4306,4316,4326,-32,-22,429322,18580490160,425098
2387,p1605,20151120,4316,4326,4316,4368,4262,4364,4312,38,-14,565242,24378869200,388274
2388,p1605,20151123,4364,4312,4350,4406,4314,4336,4350,24,38,704848,30670128960,420344
2389,p1605,20151124,4336,4350,4348,4488,4332,4464,4404,114,54,621418,27368953800,458930
2390,p1605,20151125,4464,4404,4444,4482,4432,4474,4454,70,50,483778,21551171240,482146
2391,p1605,20151126,4474,4454,4468,4604,4438,4554,4526,100,72,705296,31934560880,492516
2392,p1605,20151127,4554,4526,4560,4646,4532,4644,4596,118,70,939378,43184729200,508494
2393,p1605,20151130,4644,4596,4620,4636,4540,4598,4588,2,-8,757534,34758548200,483694
2394,p1605,20151201,4598,4588,4592,4696,4588,4638,4652,50,64,1093126,50855493840,502530
2395,p1605,20151202,4638,4652,4636,4718,4614,4664,4668,12,16,831100,38801812640,525782
2396,p1605,20151203,4664,4668,4660,4704,4602,4636,4642,-32,-26,1105406,51332808960,528666
2397,p1605,20151204,4636,4642,4648,4680,4624,4656,4648,14,6,991818,46114389800,581794
2398,p1605,20151207,4656,4648,4660,4800,4644,4788,4738,140,90,1051296,49824317360,629892
2399,p1605,20151208,4788,4738,4798,4810,4652,4690,4720,-48,-18,1012468,47801422800,597852
2400,p1605,20151209,4690,4720,4672,4718,4620,4640,4674,-80,-46,895522,41869567080,560852
2401,p1605,20151210,4640,4674,4642,4696,4624,4658,4660,-16,-14,907606,42309617920,575446
2402,p1605,20151211,4658,4660,4650,4732,4646,4730,4680,70,20,983412,46034787200,594868
2403,p1605,20151214,4730,4680,4732,4786,4702,4708,4740,28,60,1121998,53198724960,619230
2404,p1605,20151215,4708,4740,4672,4758,4656,4674,4704,-66,-36,1197876,56354835680,631128
2405,p1605,20151216,4674,4704,4668,4686,4626,4656,4654,-48,-50,1076884,50123073480,579356
2406,p1605,20151217,4656,4654,4646,4676,4554,4560,4622,-94,-32,1204136,55657118960,643092
2407,p1605,20151218,4560,4622,4562,4580,4506,4570,4546,-52,-76,1173688,53367103680,635322
2408,p1605,20151221,4570,4546,4580,4696,4548,4696,4614,150,68,1192204,55009864960,591504
2409,p1605,20151222,4696,4614,4686,4726,4670,4714,4696,100,82,979918,46030461080,595598
2410,p1605,20151223,4714,4696,4722,4740,4674,4730,4710,34,14,1074594,50631792960,614996
2411,p1605,20151224,4730,4710,4740,4780,4686,4692,4736,-18,26,1291436,61162433240,615056
2412,p1605,20151225,4692,4736,4696,4736,4676,4734,4706,-2,-30,760378,35785947920,620782
2413,p1605,20151228,4734,4706,4738,4748,4648,4650,4702,-56,-4,790392,37173251560,580234
2414,p1605,20151229,4650,4702,4632,4828,4618,4814,4690,112,-12,1374896,64507423560,655492
2415,p1605,20151230,4814,4690,4796,4868,4792,4864,4828,174,138,2192238,1.05873E+11,778876
2416,p1605,20151231,4864,4828,4848,4878,4822,4870,4850,42,22,1495872,72561896760,795220
2417,p1606,20150615,5402,5402,0,0,0,5360,5360,-42,-42,0,0,0
2418,p1606,20150616,5360,5360,0,0,0,5376,5376,16,16,0,0,0
2419,p1606,20150617,5376,5376,5220,5220,5220,5220,5220,-156,-156,2,104400,2
2420,p1606,20150618,5220,5220,5360,5360,5360,5360,5360,140,140,2,107200,2
2421,p1606,20150619,5360,5360,0,0,0,5306,5306,-54,-54,0,0,2
2422,p1606,20150623,5306,5306,0,0,0,5336,5336,30,30,0,0,2
2423,p1606,20150624,5336,5336,0,0,0,5324,5324,-12,-12,0,0,2
2424,p1606,20150625,5324,5324,0,0,0,5390,5390,66,66,0,0,2
2425,p1606,20150626,5390,5390,0,0,0,5372,5372,-18,-18,0,0,2
2426,p1606,20150629,5372,5372,0,0,0,5346,5346,-26,-26,0,0,2
2427,p1606,20150630,5346,5346,0,0,0,5254,5254,-92,-92,0,0,2
2428,p1606,20150701,5254,5254,0,0,0,5336,5336,82,82,0,0,2
2429,p1606,20150702,5336,5336,0,0,0,5298,5298,-38,-38,0,0,2
2430,p1606,20150703,5298,5298,0,0,0,5342,5342,44,44,0,0,2
2431,p1606,20150706,5342,5342,5306,5306,5188,5188,5246,-154,-96,4,209880,2
2432,p1606,20150707,5188,5246,0,0,0,5198,5198,-48,-48,0,0,2
2433,p1606,20150708,5198,5198,0,0,0,5040,5040,-158,-158,0,0,2
2434,p1606,20150709,5040,5040,0,0,0,4884,4884,-156,-156,0,0,2
2435,p1606,20150710,4884,4884,0,0,0,5066,5066,182,182,0,0,2
2436,p1606,20150713,5066,5066,0,0,0,5062,5062,-4,-4,0,0,2
2437,p1606,20150714,5062,5062,0,0,0,5134,5134,72,72,0,0,2
2438,p1606,20150715,5134,5134,0,0,0,5130,5130,-4,-4,0,0,2
2439,p1606,20150716,5130,5130,0,0,0,5046,5046,-84,-84,0,0,2
2440,p1606,20150717,5046,5046,0,0,0,5038,5038,-8,-8,0,0,2
2441,p1606,20150720,5038,5038,0,0,0,5046,5046,8,8,0,0,2
2442,p1606,20150721,5046,5046,0,0,0,5122,5122,76,76,0,0,2
2443,p1606,20150722,5122,5122,0,0,0,5144,5144,22,22,0,0,2
2444,p1606,20150723,5144,5144,5020,5020,5020,5020,5020,-124,-124,2,100400,2
2445,p1606,20150724,5020,5020,0,0,0,4996,4996,-24,-24,0,0,2
2446,p1606,20150727,4996,4996,0,0,0,4926,4926,-70,-70,0,0,2
2447,p1606,20150728,4926,4926,4854,4948,4854,4910,4900,-16,-26,26,1274160,4
2448,p1606,20150729,4910,4900,4934,4934,4934,4934,4934,34,34,2,98680,2
2449,p1606,20150730,4934,4934,0,0,0,4914,4914,-20,-20,0,0,2
2450,p1606,20150731,4914,4914,0,0,0,4932,4932,18,18,0,0,2
2451,p1606,20150803,4932,4932,0,0,0,4860,4860,-72,-72,0,0,2
2452,p1606,20150804,4860,4860,0,0,0,4808,4808,-52,-52,0,0,2
2453,p1606,20150805,4808,4808,0,0,0,4838,4838,30,30,0,0,2
2454,p1606,20150806,4838,4838,0,0,0,4778,4778,-60,-60,0,0,2
2455,p1606,20150807,4778,4778,0,0,0,4740,4740,-38,-38,0,0,2
2456,p1606,20150810,4740,4740,0,0,0,4740,4740,0,0,0,0,2
2457,p1606,20150811,4740,4740,0,0,0,4786,4786,46,46,0,0,2
2458,p1606,20150812,4786,4786,0,0,0,4808,4808,22,22,0,0,2
2459,p1606,20150813,4808,4808,0,0,0,4788,4788,-20,-20,0,0,2
2460,p1606,20150814,4788,4788,0,0,0,4790,4790,2,2,0,0,2
2461,p1606,20150817,4790,4790,0,0,0,4786,4786,-4,-4,0,0,2
2462,p1606,20150818,4786,4786,0,0,0,4786,4786,0,0,0,0,2
2463,p1606,20150819,4786,4786,0,0,0,4786,4786,0,0,0,0,2
2464,p1606,20150820,4786,4786,0,0,0,4752,4752,-34,-34,0,0,2
2465,p1606,20150821,4752,4752,0,0,0,4712,4712,-40,-40,0,0,2
2466,p1606,20150824,4712,4712,0,0,0,4574,4574,-138,-138,0,0,2
2467,p1606,20150825,4574,4574,0,0,0,4426,4426,-148,-148,0,0,2
2468,p1606,20150826,4426,4426,0,0,0,4446,4446,20,20,0,0,2
2469,p1606,20150827,4446,4446,0,0,0,4420,4420,-26,-26,0,0,2
2470,p1606,20150828,4420,4420,0,0,0,4546,4546,126,126,0,0,2
2471,p1606,20150831,4546,4546,0,0,0,4552,4552,6,6,0,0,2
2472,p1606,20150901,4552,4552,0,0,0,4590,4590,38,38,0,0,2
2473,p1606,20150902,4590,4590,0,0,0,4568,4568,-22,-22,0,0,2
2474,p1606,20150907,4568,4568,0,0,0,4526,4526,-42,-42,0,0,2
2475,p1606,20150908,4526,4526,0,0,0,4564,4564,38,38,0,0,2
2476,p1606,20150909,4564,4564,0,0,0,4626,4626,62,62,0,0,2
2477,p1606,20150910,4626,4626,0,0,0,4624,4624,-2,-2,0,0,2
2478,p1606,20150911,4624,4624,0,0,0,4676,4676,52,52,0,0,2
2479,p1606,20150914,4676,4676,0,0,0,4628,4628,-48,-48,0,0,2
2480,p1606,20150915,4628,4628,4654,4654,4544,4594,4588,-34,-40,12,550760,2
2481,p1606,20150916,4594,4588,0,0,0,4588,4588,0,0,0,0,2
2482,p1606,20150917,4588,4588,0,0,0,4596,4596,8,8,0,0,2
2483,p1606,20150918,4596,4596,0,0,0,4576,4576,-20,-20,0,0,2
2484,p1606,20150921,4576,4576,0,0,0,4542,4542,-34,-34,0,0,2
2485,p1606,20150922,4542,4542,0,0,0,4582,4582,40,40,0,0,2
2486,p1606,20150923,4582,4582,4534,4538,4534,4538,4534,-44,-48,36,1632720,6
2487,p1606,20150924,4538,4534,4556,4558,4556,4558,4556,24,22,4,182280,2
2488,p1606,20150925,4558,4556,0,0,0,4622,4622,66,66,0,0,2
2489,p1606,20150928,4622,4622,0,0,0,4700,4700,78,78,0,0,2
2490,p1606,20150929,4700,4700,0,0,0,4638,4638,-62,-62,0,0,2
2491,p1606,20150930,4638,4638,0,0,0,4676,4676,38,38,0,0,2
2492,p1606,20151008,4676,4676,4670,4670,4670,4670,4670,-6,-6,2,93400,2
2493,p1606,20151009,4670,4670,0,0,0,4676,4676,6,6,0,0,2
2494,p1606,20151012,4676,4676,4746,4746,4746,4746,4746,70,70,2,94920,2
2495,p1606,20151013,4746,4746,0,0,0,4792,4792,46,46,0,0,2
2496,p1606,20151014,4792,4792,0,0,0,4854,4854,62,62,0,0,2
2497,p1606,20151015,4854,4854,0,0,0,4862,4862,8,8,0,0,2
2498,p1606,20151016,4862,4862,0,0,0,4824,4824,-38,-38,0,0,2
2499,p1606,20151019,4824,4824,0,0,0,4798,4798,-26,-26,0,0,2
2500,p1606,20151020,4798,4798,0,0,0,4720,4720,-78,-78,0,0,2
2501,p1606,20151021,4720,4720,4762,4762,4762,4762,4762,42,42,2,95240,0
2502,p1606,20151022,4762,4762,4852,4852,4676,4806,4778,44,16,6,286680,0
2503,p1606,20151023,4806,4778,0,0,0,4766,4766,-12,-12,0,0,0
2504,p1606,20151026,4766,4766,0,0,0,4694,4694,-72,-72,0,0,0
2505,p1606,20151027,4694,4694,0,0,0,4628,4628,-66,-66,0,0,0
2506,p1606,20151028,4628,4628,0,0,0,4646,4646,18,18,0,0,0
2507,p1606,20151029,4646,4646,0,0,0,4670,4670,24,24,0,0,0
2508,p1606,20151030,4670,4670,0,0,0,4640,4640,-30,-30,0,0,0
2509,p1606,20151102,4640,4640,0,0,0,4644,4644,4,4,0,0,0
2510,p1606,20151103,4644,4644,0,0,0,4606,4606,-38,-38,0,0,0
2511,p1606,20151104,4606,4606,0,0,0,4594,4594,-12,-12,0,0,0
2512,p1606,20151105,4594,4594,0,0,0,4636,4636,42,42,0,0,0
2513,p1606,20151106,4636,4636,4636,4636,4636,4636,4636,0,0,2,92720,2
2514,p1606,20151109,4636,4636,0,0,0,4626,4626,-10,-10,0,0,2
2515,p1606,20151110,4626,4626,0,0,0,4610,4610,-16,-16,0,0,2
2516,p1606,20151111,4610,4610,0,0,0,4490,4490,-120,-120,0,0,2
2517,p1606,20151112,4490,4490,0,0,0,4484,4484,-6,-6,0,0,2
2518,p1606,20151113,4484,4484,0,0,0,4486,4486,2,2,0,0,2
2519,p1606,20151116,4486,4486,0,0,0,4462,4462,-24,-24,0,0,2
2520,p1606,20151117,4462,4462,0,0,0,4470,4470,8,8,0,0,2
2521,p1606,20151118,4470,4470,4454,4454,4372,4372,4412,-98,-58,4,176520,2
2522,p1606,20151119,4372,4412,0,0,0,4390,4390,-22,-22,0,0,2
2523,p1606,20151120,4390,4390,4300,4456,4300,4378,4414,-12,24,26,1147680,14
2524,p1606,20151123,4378,4414,4402,4454,4340,4388,4410,-26,-4,62,2734800,14
2525,p1606,20151124,4388,4410,0,0,0,4464,4464,54,54,0,0,14
2526,p1606,20151125,4464,4464,0,0,0,4514,4514,50,50,0,0,14
2527,p1606,20151126,4514,4514,4602,4606,4570,4606,4598,92,84,20,919760,12
2528,p1606,20151127,4606,4598,4680,4680,4634,4634,4656,36,58,4,186280,12
2529,p1606,20151130,4634,4656,4612,4632,4550,4604,4588,-52,-68,56,2569880,6
2530,p1606,20151201,4604,4588,0,0,0,4650,4650,62,62,0,0,6
2531,p1606,20151202,4650,4650,4628,4682,4628,4682,4654,32,4,4,186200,6
2532,p1606,20151203,4682,4654,0,0,0,4654,4654,0,0,0,0,6
2533,p1606,20151204,4654,4654,4676,4702,4676,4702,4688,48,34,12,562680,6
2534,p1606,20151207,4702,4688,4670,4734,4670,4734,4702,46,14,20,940400,6
2535,p1606,20151208,4734,4702,4782,4782,4734,4734,4758,32,56,4,190320,6
2536,p1606,20151209,4734,4758,4710,4710,4678,4678,4706,-80,-52,80,3765840,6
2537,p1606,20151210,4678,4706,4674,4710,4674,4710,4692,4,-14,4,187680,6
2538,p1606,20151211,4710,4692,4760,4776,4698,4752,4742,60,50,38,1802120,4
2539,p1606,20151214,4752,4742,4798,4826,4716,4774,4768,32,26,22,1048960,10
2540,p1606,20151215,4774,4768,4670,4744,4670,4738,4712,-30,-56,24,1131040,8
2541,p1606,20151216,4738,4712,4644,4710,4644,4710,4676,-2,-36,20,935400,8
2542,p1606,20151217,4710,4676,4618,4640,4618,4640,4628,-36,-48,4,185160,8
2543,p1606,20151218,4640,4628,4640,4654,4590,4654,4634,26,6,10,463560,16
2544,p1606,20151221,4654,4634,4672,4698,4618,4698,4672,64,38,48,2242880,36
2545,p1606,20151222,4698,4672,4742,4748,4716,4730,4736,58,64,28,1326240,10
2546,p1606,20151223,4730,4736,4734,4922,4734,4756,4786,20,50,26,1244400,16
2547,p1606,20151224,4756,4786,4814,4814,4770,4802,4788,16,2,8,383120,14
2548,p1606,20151225,4802,4788,4738,4792,4738,4768,4766,-20,-22,36,1716440,14
2549,p1606,20151228,4768,4766,4726,4752,4706,4752,4724,-14,-42,12,567080,16
2550,p1606,20151229,4752,4724,4660,4718,4660,4718,4688,-6,-36,4,187560,16
2551,p1606,20151230,4718,4688,4802,4874,4738,4874,4828,186,140,508,24536040,14
2552,p1606,20151231,4874,4828,4920,4920,4836,4918,4884,90,56,10,488560,14
2553,p1607,20150715,4996,4996,0,0,0,4994,4994,-2,-2,0,0,0
2554,p1607,20150716,4994,4994,0,0,0,4912,4912,-82,-82,0,0,0
2555,p1607,20150717,4912,4912,0,0,0,4906,4906,-6,-6,0,0,0
2556,p1607,20150720,4906,4906,0,0,0,4912,4912,6,6,0,0,0
2557,p1607,20150721,4912,4912,0,0,0,4986,4986,74,74,0,0,0
2558,p1607,20150722,4986,4986,0,0,0,5006,5006,20,20,0,0,0
2559,p1607,20150723,5006,5006,0,0,0,4886,4886,-120,-120,0,0,0
2560,p1607,20150724,4886,4886,5180,5180,4982,4982,5080,96,194,4,203240,0
2561,p1607,20150727,4982,5080,0,0,0,5010,5010,-70,-70,0,0,0
2562,p1607,20150728,5010,5010,0,0,0,4984,4984,-26,-26,0,0,0
2563,p1607,20150729,4984,4984,0,0,0,5018,5018,34,34,0,0,0
2564,p1607,20150730,5018,5018,0,0,0,4998,4998,-20,-20,0,0,0
2565,p1607,20150731,4998,4998,0,0,0,5016,5016,18,18,0,0,0
2566,p1607,20150803,5016,5016,0,0,0,4944,4944,-72,-72,0,0,0
2567,p1607,20150804,4944,4944,0,0,0,4892,4892,-52,-52,0,0,0
2568,p1607,20150805,4892,4892,0,0,0,4922,4922,30,30,0,0,0
2569,p1607,20150806,4922,4922,4744,4838,4744,4784,4780,-138,-142,26,1242840,2
2570,p1607,20150807,4784,4780,0,0,0,4742,4742,-38,-38,0,0,2
2571,p1607,20150810,4742,4742,4868,4868,4730,4730,4798,-12,56,8,383920,2
2572,p1607,20150811,4730,4798,4868,4868,4768,4768,4818,-30,20,4,192720,2
2573,p1607,20150812,4768,4818,0,0,0,4840,4840,22,22,0,0,2
2574,p1607,20150813,4840,4840,0,0,0,4820,4820,-20,-20,0,0,2
2575,p1607,20150814,4820,4820,0,0,0,4822,4822,2,2,0,0,2
2576,p1607,20150817,4822,4822,0,0,0,4818,4818,-4,-4,0,0,2
2577,p1607,20150818,4818,4818,0,0,0,4806,4806,-12,-12,0,0,2
2578,p1607,20150819,4806,4806,0,0,0,4744,4744,-62,-62,0,0,2
2579,p1607,20150820,4744,4744,0,0,0,4710,4710,-34,-34,0,0,2
2580,p1607,20150821,4710,4710,0,0,0,4670,4670,-40,-40,0,0,2
2581,p1607,20150824,4670,4670,0,0,0,4534,4534,-136,-136,0,0,2
2582,p1607,20150825,4534,4534,4392,4392,4392,4392,4392,-142,-142,2,87840,2
2583,p1607,20150826,4392,4392,0,0,0,4412,4412,20,20,0,0,2
2584,p1607,20150827,4412,4412,0,0,0,4386,4386,-26,-26,0,0,2
2585,p1607,20150828,4386,4386,0,0,0,4510,4510,124,124,0,0,2
2586,p1607,20150831,4510,4510,0,0,0,4516,4516,6,6,0,0,2
2587,p1607,20150901,4516,4516,0,0,0,4554,4554,38,38,0,0,2
2588,p1607,20150902,4554,4554,0,0,0,4532,4532,-22,-22,0,0,2
2589,p1607,20150907,4532,4532,0,0,0,4490,4490,-42,-42,0,0,2
2590,p1607,20150908,4490,4490,0,0,0,4528,4528,38,38,0,0,2
2591,p1607,20150909,4528,4528,0,0,0,4590,4590,62,62,0,0,2
2592,p1607,20150910,4590,4590,0,0,0,4588,4588,-2,-2,0,0,2
2593,p1607,20150911,4588,4588,0,0,0,4640,4640,52,52,0,0,2
2594,p1607,20150914,4640,4640,4608,4642,4484,4642,4594,2,-46,8,367520,4
2595,p1607,20150915,4642,4594,4690,4690,4690,4690,4690,96,96,2,93800,2
2596,p1607,20150916,4690,4690,0,0,0,4610,4610,-80,-80,0,0,2
2597,p1607,20150917,4610,4610,0,0,0,4618,4618,8,8,0,0,2
2598,p1607,20150918,4618,4618,4474,4474,4474,4474,4474,-144,-144,2,89480,2
2599,p1607,20150921,4474,4474,4484,4484,4484,4484,4484,10,10,2,89680,0
2600,p1607,20150922,4484,4484,0,0,0,4524,4524,40,40,0,0,0
2601,p1607,20150923,4524,4524,0,0,0,4478,4478,-46,-46,0,0,0
2602,p1607,20150924,4478,4478,0,0,0,4498,4498,20,20,0,0,0
2603,p1607,20150925,4498,4498,0,0,0,4562,4562,64,64,0,0,0
2604,p1607,20150928,4562,4562,0,0,0,4638,4638,76,76,0,0,0
2605,p1607,20150929,4638,4638,0,0,0,4578,4578,-60,-60,0,0,0
2606,p1607,20150930,4578,4578,0,0,0,4614,4614,36,36,0,0,0
2607,p1607,20151008,4614,4614,0,0,0,4610,4610,-4,-4,0,0,0
2608,p1607,20151009,4610,4610,0,0,0,4614,4614,4,4,0,0,0
2609,p1607,20151012,4614,4614,0,0,0,4682,4682,68,68,0,0,0
2610,p1607,20151013,4682,4682,0,0,0,4702,4702,20,20,0,0,0
2611,p1607,20151014,4702,4702,0,0,0,4762,4762,60,60,0,0,0
2612,p1607,20151015,4762,4762,0,0,0,4768,4768,6,6,0,0,0
2613,p1607,20151016,4768,4768,0,0,0,4732,4732,-36,-36,0,0,0
2614,p1607,20151019,4732,4732,0,0,0,4708,4708,-24,-24,0,0,0
2615,p1607,20151020,4708,4708,0,0,0,4632,4632,-76,-76,0,0,0
2616,p1607,20151021,4632,4632,0,0,0,4672,4672,40,40,0,0,0
2617,p1607,20151022,4672,4672,0,0,0,4686,4686,14,14,0,0,0
2618,p1607,20151023,4686,4686,0,0,0,4676,4676,-10,-10,0,0,0
2619,p1607,20151026,4676,4676,0,0,0,4606,4606,-70,-70,0,0,0
2620,p1607,20151027,4606,4606,0,0,0,4542,4542,-64,-64,0,0,0
2621,p1607,20151028,4542,4542,0,0,0,4558,4558,16,16,0,0,0
2622,p1607,20151029,4558,4558,0,0,0,4580,4580,22,22,0,0,0
2623,p1607,20151030,4580,4580,0,0,0,4552,4552,-28,-28,0,0,0
2624,p1607,20151102,4552,4552,0,0,0,4554,4554,2,2,0,0,0
2625,p1607,20151103,4554,4554,0,0,0,4518,4518,-36,-36,0,0,0
2626,p1607,20151104,4518,4518,0,0,0,4508,4508,-10,-10,0,0,0
2627,p1607,20151105,4508,4508,0,0,0,4548,4548,40,40,0,0,0
2628,p1607,20151106,4548,4548,0,0,0,4548,4548,0,0,0,0,0
2629,p1607,20151109,4548,4548,0,0,0,4538,4538,-10,-10,0,0,0
2630,p1607,20151110,4538,4538,0,0,0,4522,4522,-16,-16,0,0,0
2631,p1607,20151111,4522,4522,0,0,0,4404,4404,-118,-118,0,0,0
2632,p1607,20151112,4404,4404,0,0,0,4398,4398,-6,-6,0,0,0
2633,p1607,20151113,4398,4398,0,0,0,4400,4400,2,2,0,0,0
2634,p1607,20151116,4400,4400,0,0,0,4376,4376,-24,-24,0,0,0
2635,p1607,20151117,4376,4376,0,0,0,4384,4384,8,8,0,0,0
2636,p1607,20151118,4384,4384,0,0,0,4328,4328,-56,-56,0,0,0
2637,p1607,20151119,4328,4328,0,0,0,4308,4308,-20,-20,0,0,0
2638,p1607,20151120,4308,4308,0,0,0,4330,4330,22,22,0,0,0
2639,p1607,20151123,4330,4330,0,0,0,4328,4328,-2,-2,0,0,0
2640,p1607,20151124,4328,4328,0,0,0,4380,4380,52,52,0,0,0
2641,p1607,20151125,4380,4380,0,0,0,4428,4428,48,48,0,0,0
2642,p1607,20151126,4428,4428,0,0,0,4510,4510,82,82,0,0,0
2643,p1607,20151127,4510,4510,0,0,0,4566,4566,56,56,0,0,0
2644,p1607,20151130,4566,4566,0,0,0,4500,4500,-66,-66,0,0,0
2645,p1607,20151201,4500,4500,0,0,0,4562,4562,62,62,0,0,0
2646,p1607,20151202,4562,4562,0,0,0,4564,4564,2,2,0,0,0
2647,p1607,20151203,4564,4564,4738,4738,4652,4652,4694,88,130,4,187800,0
2648,p1607,20151204,4652,4694,0,0,0,4728,4728,34,34,0,0,0
2649,p1607,20151207,4728,4728,0,0,0,4742,4742,14,14,0,0,0
2650,p1607,20151208,4742,4742,0,0,0,4798,4798,56,56,0,0,0
2651,p1607,20151209,4798,4798,0,0,0,4746,4746,-52,-52,0,0,0
2652,p1607,20151210,4746,4746,0,0,0,4732,4732,-14,-14,0,0,0
2653,p1607,20151211,4732,4732,0,0,0,4782,4782,50,50,0,0,0
2654,p1607,20151214,4782,4782,0,0,0,4808,4808,26,26,0,0,0
2655,p1607,20151215,4808,4808,0,0,0,4752,4752,-56,-56,0,0,0
2656,p1607,20151216,4752,4752,0,0,0,4716,4716,-36,-36,0,0,0
2657,p1607,20151217,4716,4716,0,0,0,4668,4668,-48,-48,0,0,0
2658,p1607,20151218,4668,4668,0,0,0,4674,4674,6,6,0,0,0
2659,p1607,20151221,4674,4674,0,0,0,4712,4712,38,38,0,0,0
2660,p1607,20151222,4712,4712,0,0,0,4776,4776,64,64,0,0,0
2661,p1607,20151223,4776,4776,4872,4872,4752,4872,4830,96,54,12,579760,4
2662,p1607,20151224,4872,4830,0,0,0,4832,4832,2,2,0,0,4
2663,p1607,20151225,4832,4832,0,0,0,4810,4810,-22,-22,0,0,4
2664,p1607,20151228,4810,4810,4760,4760,4760,4760,4760,-50,-50,4,190400,0
2665,p1607,20151229,4760,4760,0,0,0,4724,4724,-36,-36,0,0,0
2666,p1607,20151230,4724,4724,0,0,0,4864,4864,140,140,0,0,0
2667,p1607,20151231,4864,4864,0,0,0,4920,4920,56,56,0,0,0
2668,p1608,20150817,4764,4764,0,0,0,4762,4762,-2,-2,0,0,0
2669,p1608,20150818,4762,4762,0,0,0,4750,4750,-12,-12,0,0,0
2670,p1608,20150819,4750,4750,0,0,0,4750,4750,0,0,0,0,0
2671,p1608,20150820,4750,4750,0,0,0,4750,4750,0,0,0,0,0
2672,p1608,20150821,4750,4750,0,0,0,4710,4710,-40,-40,0,0,0
2673,p1608,20150824,4710,4710,0,0,0,4572,4572,-138,-138,0,0,0
2674,p1608,20150825,4572,4572,0,0,0,4430,4430,-142,-142,0,0,0
2675,p1608,20150826,4430,4430,0,0,0,4450,4450,20,20,0,0,0
2676,p1608,20150827,4450,4450,0,0,0,4424,4424,-26,-26,0,0,0
2677,p1608,20150828,4424,4424,0,0,0,4550,4550,126,126,0,0,0
2678,p1608,20150831,4550,4550,0,0,0,4556,4556,6,6,0,0,0
2679,p1608,20150901,4556,4556,0,0,0,4594,4594,38,38,0,0,0
2680,p1608,20150902,4594,4594,0,0,0,4572,4572,-22,-22,0,0,0
2681,p1608,20150907,4572,4572,0,0,0,4530,4530,-42,-42,0,0,0
2682,p1608,20150908,4530,4530,0,0,0,4568,4568,38,38,0,0,0
2683,p1608,20150909,4568,4568,0,0,0,4630,4630,62,62,0,0,0
2684,p1608,20150910,4630,4630,0,0,0,4628,4628,-2,-2,0,0,0
2685,p1608,20150911,4628,4628,4500,4638,4500,4638,4568,10,-60,200,9138000,0
2686,p1608,20150914,4638,4568,0,0,0,4524,4524,-44,-44,0,0,0
2687,p1608,20150915,4524,4524,0,0,0,4618,4618,94,94,0,0,0
2688,p1608,20150916,4618,4618,0,0,0,4540,4540,-78,-78,0,0,0
2689,p1608,20150917,4540,4540,0,0,0,4548,4548,8,8,0,0,0
2690,p1608,20150918,4548,4548,0,0,0,4408,4408,-140,-140,0,0,0
2691,p1608,20150921,4408,4408,0,0,0,4416,4416,8,8,0,0,0
2692,p1608,20150922,4416,4416,0,0,0,4454,4454,38,38,0,0,0
2693,p1608,20150923,4454,4454,0,0,0,4408,4408,-46,-46,0,0,0
2694,p1608,20150924,4408,4408,0,0,0,4428,4428,20,20,0,0,0
2695,p1608,20150925,4428,4428,0,0,0,4492,4492,64,64,0,0,0
2696,p1608,20150928,4492,4492,0,0,0,4568,4568,76,76,0,0,0
2697,p1608,20150929,4568,4568,0,0,0,4508,4508,-60,-60,0,0,0
2698,p1608,20150930,4508,4508,0,0,0,4544,4544,36,36,0,0,0
2699,p1608,20151008,4544,4544,0,0,0,4540,4540,-4,-4,0,0,0
2700,p1608,20151009,4540,4540,0,0,0,4544,4544,4,4,0,0,0
2701,p1608,20151012,4544,4544,0,0,0,4724,4724,180,180,0,0,0
2702,p1608,20151013,4724,4724,0,0,0,4820,4820,96,96,0,0,0
2703,p1608,20151014,4820,4820,0,0,0,4882,4882,62,62,0,0,0
2704,p1608,20151015,4882,4882,0,0,0,4882,4882,0,0,0,0,0
2705,p1608,20151016,4882,4882,0,0,0,4844,4844,-38,-38,0,0,0
2706,p1608,20151019,4844,4844,0,0,0,4818,4818,-26,-26,0,0,0
2707,p1608,20151020,4818,4818,0,0,0,4740,4740,-78,-78,0,0,0
2708,p1608,20151021,4740,4740,0,0,0,4782,4782,42,42,0,0,0
2709,p1608,20151022,4782,4782,0,0,0,4798,4798,16,16,0,0,0
2710,p1608,20151023,4798,4798,0,0,0,4786,4786,-12,-12,0,0,0
2711,p1608,20151026,4786,4786,0,0,0,4714,4714,-72,-72,0,0,0
2712,p1608,20151027,4714,4714,0,0,0,4648,4648,-66,-66,0,0,0
2713,p1608,20151028,4648,4648,0,0,0,4666,4666,18,18,0,0,0
2714,p1608,20151029,4666,4666,0,0,0,4690,4690,24,24,0,0,0
2715,p1608,20151030,4690,4690,0,0,0,4660,4660,-30,-30,0,0,0
2716,p1608,20151102,4660,4660,4758,4758,4758,4758,4758,98,98,4,190320,4
2717,p1608,20151103,4758,4758,4686,4686,4686,4686,4686,-72,-72,2,93720,4
2718,p1608,20151104,4686,4686,0,0,0,4674,4674,-12,-12,0,0,4
2719,p1608,20151105,4674,4674,0,0,0,4716,4716,42,42,0,0,4
2720,p1608,20151106,4716,4716,0,0,0,4716,4716,0,0,0,0,4
2721,p1608,20151109,4716,4716,0,0,0,4716,4716,0,0,0,0,4
2722,p1608,20151110,4716,4716,0,0,0,4646,4646,-70,-70,0,0,4
2723,p1608,20151111,4646,4646,4500,4500,4500,4500,4500,-146,-146,2,90000,4
2724,p1608,20151112,4500,4500,0,0,0,4494,4494,-6,-6,0,0,4
2725,p1608,20151113,4494,4494,0,0,0,4496,4496,2,2,0,0,4
2726,p1608,20151116,4496,4496,0,0,0,4472,4472,-24,-24,0,0,4
2727,p1608,20151117,4472,4472,0,0,0,4480,4480,8,8,0,0,4
2728,p1608,20151118,4480,4480,0,0,0,4422,4422,-58,-58,0,0,4
2729,p1608,20151119,4422,4422,0,0,0,4400,4400,-22,-22,0,0,4
2730,p1608,20151120,4400,4400,4390,4390,4390,4390,4390,-10,-10,4,175600,8
2731,p1608,20151123,4390,4390,0,0,0,4388,4388,-2,-2,0,0,8
2732,p1608,20151124,4388,4388,0,0,0,4442,4442,54,54,0,0,8
2733,p1608,20151125,4442,4442,4558,4558,4558,4558,4558,116,116,2,91160,6
2734,p1608,20151126,4558,4558,0,0,0,4642,4642,84,84,0,0,6
2735,p1608,20151127,4642,4642,0,0,0,4700,4700,58,58,0,0,6
2736,p1608,20151130,4700,4700,0,0,0,4632,4632,-68,-68,0,0,6
2737,p1608,20151201,4632,4632,0,0,0,4696,4696,64,64,0,0,6
2738,p1608,20151202,4696,4696,0,0,0,4696,4696,0,0,0,0,6
2739,p1608,20151203,4696,4696,0,0,0,4828,4828,132,132,0,0,6
2740,p1608,20151204,4828,4828,0,0,0,4862,4862,34,34,0,0,6
2741,p1608,20151207,4862,4862,0,0,0,4876,4876,14,14,0,0,6
2742,p1608,20151208,4876,4876,4784,4784,4784,4784,4784,-92,-92,4,191360,4
2743,p1608,20151209,4784,4784,0,0,0,4784,4784,0,0,0,0,4
2744,p1608,20151210,4784,4784,0,0,0,4770,4770,-14,-14,0,0,4
2745,p1608,20151211,4770,4770,0,0,0,4820,4820,50,50,0,0,4
2746,p1608,20151214,4820,4820,0,0,0,4846,4846,26,26,0,0,4
2747,p1608,20151215,4846,4846,0,0,0,4790,4790,-56,-56,0,0,4
2748,p1608,20151216,4790,4790,4704,4704,4704,4704,4704,-86,-86,2,94080,6
2749,p1608,20151217,4704,4704,0,0,0,4656,4656,-48,-48,0,0,6
2750,p1608,20151218,4656,4656,0,0,0,4662,4662,6,6,0,0,6
2751,p1608,20151221,4662,4662,0,0,0,4700,4700,38,38,0,0,6
2752,p1608,20151222,4700,4700,0,0,0,4764,4764,64,64,0,0,6
2753,p1608,20151223,4764,4764,0,0,0,4816,4816,52,52,0,0,6
2754,p1608,20151224,4816,4816,0,0,0,4818,4818,2,2,0,0,6
2755,p1608,20151225,4818,4818,0,0,0,4796,4796,-22,-22,0,0,6
2756,p1608,20151228,4796,4796,0,0,0,4748,4748,-48,-48,0,0,6
2757,p1608,20151229,4748,4748,0,0,0,4712,4712,-36,-36,0,0,6
2758,p1608,20151230,4712,4712,0,0,0,4852,4852,140,140,0,0,6
2759,p1608,20151231,4852,4852,0,0,0,4854,4854,2,2,0,0,6
2760,p1609,20150917,4570,4570,4586,4596,4544,4550,4572,-20,2,602,27531080,412
2761,p1609,20150918,4550,4572,4550,4568,4520,4520,4542,-52,-30,416,18900240,634
2762,p1609,20150921,4520,4542,4488,4540,4472,4540,4498,-2,-44,296,13315360,668
2763,p1609,20150922,4540,4498,4544,4550,4492,4496,4524,-2,26,1392,62974200,1374
2764,p1609,20150923,4496,4524,4494,4506,4464,4506,4492,-18,-32,1630,73220680,1836
2765,p1609,20150924,4506,4492,4524,4540,4500,4528,4520,36,28,1670,75498360,2626
2766,p1609,20150925,4528,4520,4512,4624,4502,4598,4578,78,58,2324,106416160,3444
2767,p1609,20150928,4598,4578,4666,4670,4632,4640,4646,62,68,2326,108089040,4448
2768,p1609,20150929,4640,4646,4652,4660,4542,4588,4582,-58,-64,2230,102198920,5056
2769,p1609,20150930,4588,4582,4620,4652,4606,4632,4634,50,52,4506,208844600,5990
2770,p1609,20151008,4632,4634,4658,4702,4628,4640,4648,6,14,2630,122281200,5756
2771,p1609,20151009,4640,4648,4636,4704,4616,4674,4662,26,14,3144,146609360,6346
2772,p1609,20151012,4674,4662,4674,4798,4656,4776,4748,114,86,7152,339593880,8556
2773,p1609,20151013,4776,4748,4766,4848,4722,4842,4772,94,24,5458,260507840,10228
2774,p1609,20151014,4842,4772,4826,4858,4810,4816,4830,44,58,2134,103100720,10472
2775,p1609,20151015,4816,4830,4830,4876,4820,4848,4842,18,12,4208,203806000,11910
2776,p1609,20151016,4848,4842,4826,4910,4764,4792,4792,-50,-50,5318,254892880,11204
2777,p1609,20151019,4792,4792,4778,4788,4754,4754,4772,-38,-20,3590,171356080,12104
2778,p1609,20151020,4754,4772,4744,4744,4680,4718,4710,-54,-62,7674,361554800,14198
2779,p1609,20151021,4718,4710,4740,4772,4728,4750,4752,40,42,3434,163235680,14628
2780,p1609,20151022,4750,4752,4760,4816,4752,4814,4792,62,40,3510,168214480,16516
2781,p1609,20151023,4814,4792,4820,4824,4750,4760,4778,-32,-14,4812,229918880,17716
2782,p1609,20151026,4760,4778,4766,4772,4658,4666,4698,-112,-80,5088,239053840,17748
2783,p1609,20151027,4666,4698,4652,4686,4592,4684,4646,-14,-52,6360,295495400,18786
2784,p1609,20151028,4684,4646,4696,4696,4640,4664,4668,18,22,10450,487930880,22834
2785,p1609,20151029,4664,4668,4682,4720,4664,4664,4696,-4,28,5306,249197240,22808
2786,p1609,20151030,4664,4696,4682,4694,4648,4652,4670,-44,-26,5946,277789440,23516
2787,p1609,20151102,4652,4670,4664,4700,4622,4688,4670,18,0,5746,268366720,24634
2788,p1609,20151103,4688,4670,4660,4676,4624,4626,4654,-44,-16,14878,692485960,25636
2789,p1609,20151104,4626,4654,4646,4698,4620,4694,4666,40,12,20564,959712520,33330
2790,p1609,20151105,4694,4666,4696,4726,4670,4688,4696,22,30,17228,809258320,34512
2791,p1609,20151106,4688,4696,4680,4684,4584,4600,4612,-96,-84,12758,588521200,32376
2792,p1609,20151109,4600,4612,4610,4620,4572,4596,4592,-16,-20,5192,238475760,31352
2793,p1609,20151110,4596,4592,4622,4624,4546,4578,4570,-14,-22,6938,317110560,30652
2794,p1609,20151111,4578,4570,4570,4580,4388,4464,4482,-106,-88,26144,1171787960,38132
2795,p1609,20151112,4464,4482,4460,4500,4460,4488,4480,6,-2,8710,390331880,40744
2796,p1609,20151113,4488,4480,4470,4508,4450,4480,4482,0,2,8398,376556040,43322
2797,p1609,20151116,4480,4482,4474,4488,4442,4454,4456,-28,-26,13784,614453320,51738
2798,p1609,20151117,4454,4456,4452,4496,4424,4478,4468,22,12,6950,310533920,52952
2799,p1609,20151118,4478,4468,4476,4488,4430,4458,4452,-10,-16,11840,527272760,53754
2800,p1609,20151119,4458,4452,4472,4476,4424,4444,4442,-8,-10,14658,651334240,53042
2801,p1609,20151120,4444,4442,4440,4480,4388,4478,4432,36,-10,24052,1066089320,54722
2802,p1609,20151123,4478,4432,4470,4518,4428,4448,4468,16,36,22880,1022374760,54364
2803,p1609,20151124,4448,4468,4450,4614,4450,4590,4518,122,50,31168,1408485040,49366
2804,p1609,20151125,4590,4518,4580,4606,4556,4598,4580,80,62,12122,555227040,50760
2805,p1609,20151126,4598,4580,4600,4706,4560,4658,4632,78,52,36488,1690455320,57664
2806,p1609,20151127,4658,4632,4638,4740,4630,4740,4690,108,58,24724,1159752240,58628
2807,p1609,20151130,4740,4690,4736,4738,4638,4696,4684,6,-6,14910,698511480,58220
2808,p1609,20151201,4696,4684,4688,4802,4686,4732,4758,48,74,16282,774893200,58578
2809,p1609,20151202,4732,4758,4732,4820,4716,4766,4778,8,20,14374,686822320,57560
2810,p1609,20151203,4766,4778,4772,4806,4704,4744,4744,-34,-34,11880,563735680,57466
2811,p1609,20151204,4744,4744,4756,4776,4732,4750,4752,6,8,15500,736623080,56784
2812,p1609,20151207,4750,4752,4760,4890,4740,4884,4852,132,100,17916,869304760,59202
2813,p1609,20151208,4884,4852,4886,4900,4752,4794,4796,-58,-56,35454,1701061560,62850
2814,p1609,20151209,4794,4796,4790,4814,4714,4734,4776,-62,-20,39586,1891154920,75070
2815,p1609,20151210,4734,4776,4736,4784,4706,4722,4744,-54,-32,28180,1337037960,81040
2816,p1609,20151211,4722,4744,4732,4774,4700,4772,4742,28,-2,29888,1417767640,85266
2817,p1609,20151214,4772,4742,4778,4822,4738,4758,4780,16,38,36170,1729363840,91992
2818,p1609,20151215,4758,4780,4730,4810,4704,4752,4768,-28,-12,32740,1561492280,85660
2819,p1609,20151216,4752,4768,4730,4764,4700,4742,4734,-26,-34,29614,1402365520,82994
2820,p1609,20151217,4742,4734,4720,4760,4650,4650,4702,-84,-32,23900,1124180720,77404
2821,p1609,20151218,4650,4702,4668,4682,4606,4678,4646,-24,-56,19182,891404880,75906
2822,p1609,20151221,4678,4646,4710,4786,4658,4784,4716,138,70,23754,1120420880,73034
2823,p1609,20151222,4784,4716,4772,4822,4770,4810,4792,94,76,16898,809961480,74082
2824,p1609,20151223,4810,4792,4814,4830,4770,4814,4800,22,8,40344,1937211880,79320
2825,p1609,20151224,4814,4800,4830,4860,4774,4778,4820,-22,20,30312,1461618600,82252
2826,p1609,20151225,4778,4820,4778,4822,4770,4822,4792,2,-28,17956,860650480,83760
2827,p1609,20151228,4822,4792,4800,4828,4744,4746,4786,-46,-6,27248,1304557840,82158
2828,p1609,20151229,4746,4786,4738,4916,4710,4900,4774,114,-12,58124,2775809960,90754
2829,p1609,20151230,4900,4774,4900,4960,4880,4950,4920,176,146,106660,5249497440,108250
2830,p1609,20151231,4950,4920,4942,4964,4916,4958,4942,38,22,42334,2092277800,108616
2831,p1610,20151022,4710,4710,0,0,0,4710,4710,0,0,0,0,0
2832,p1610,20151023,4710,4710,0,0,0,4698,4698,-12,-12,0,0,0
2833,p1610,20151026,4698,4698,0,0,0,4698,4698,0,0,0,0,0
2834,p1610,20151027,4698,4698,0,0,0,4698,4698,0,0,0,0,0
2835,p1610,20151028,4698,4698,4552,4552,4482,4482,4516,-216,-182,4,180680,4
2836,p1610,20151029,4482,4516,0,0,0,4542,4542,26,26,0,0,4
2837,p1610,20151030,4542,4542,4542,4542,4542,4542,4542,0,0,2,90840,6
2838,p1610,20151102,4542,4542,4630,4630,4630,4630,4630,88,88,2,92600,4
2839,p1610,20151103,4630,4630,0,0,0,4616,4616,-14,-14,0,0,4
2840,p1610,20151104,4616,4616,0,0,0,4626,4626,10,10,0,0,4
2841,p1610,20151105,4626,4626,0,0,0,4654,4654,28,28,0,0,4
2842,p1610,20151106,4654,4654,4644,4644,4516,4566,4574,-88,-80,6,274520,4
2843,p1610,20151109,4566,4574,0,0,0,4556,4556,-18,-18,0,0,4
2844,p1610,20151110,4556,4556,0,0,0,4536,4536,-20,-20,0,0,4
2845,p1610,20151111,4536,4536,4480,4480,4480,4480,4480,-56,-56,2,89600,2
2846,p1610,20151112,4480,4480,0,0,0,4480,4480,0,0,0,0,2
2847,p1610,20151113,4480,4480,4548,4548,4548,4548,4548,68,68,2,90960,4
2848,p1610,20151116,4548,4548,0,0,0,4522,4522,-26,-26,0,0,4
2849,p1610,20151117,4522,4522,0,0,0,4506,4506,-16,-16,0,0,4
2850,p1610,20151118,4506,4506,0,0,0,4490,4490,-16,-16,0,0,4
2851,p1610,20151119,4490,4490,0,0,0,4480,4480,-10,-10,0,0,4
2852,p1610,20151120,4480,4480,4416,4564,4410,4484,4484,4,4,34,1524880,2
2853,p1610,20151123,4484,4484,4490,4490,4490,4490,4490,6,6,2,89800,0
2854,p1610,20151124,4490,4490,0,0,0,4540,4540,50,50,0,0,0
2855,p1610,20151125,4540,4540,0,0,0,4602,4602,62,62,0,0,0
2856,p1610,20151126,4602,4602,0,0,0,4654,4654,52,52,0,0,0
2857,p1610,20151127,4654,4654,0,0,0,4712,4712,58,58,0,0,0
2858,p1610,20151130,4712,4712,0,0,0,4706,4706,-6,-6,0,0,0
2859,p1610,20151201,4706,4706,0,0,0,4780,4780,74,74,0,0,0
2860,p1610,20151202,4780,4780,0,0,0,4800,4800,20,20,0,0,0
2861,p1610,20151203,4800,4800,0,0,0,4766,4766,-34,-34,0,0,0
2862,p1610,20151204,4766,4766,0,0,0,4774,4774,8,8,0,0,0
2863,p1610,20151207,4774,4774,0,0,0,4874,4874,100,100,0,0,0
2864,p1610,20151208,4874,4874,0,0,0,4818,4818,-56,-56,0,0,0
2865,p1610,20151209,4818,4818,0,0,0,4798,4798,-20,-20,0,0,0
2866,p1610,20151210,4798,4798,0,0,0,4766,4766,-32,-32,0,0,0
2867,p1610,20151211,4766,4766,0,0,0,4764,4764,-2,-2,0,0,0
2868,p1610,20151214,4764,4764,0,0,0,4802,4802,38,38,0,0,0
2869,p1610,20151215,4802,4802,0,0,0,4790,4790,-12,-12,0,0,0
2870,p1610,20151216,4790,4790,0,0,0,4756,4756,-34,-34,0,0,0
2871,p1610,20151217,4756,4756,0,0,0,4724,4724,-32,-32,0,0,0
2872,p1610,20151218,4724,4724,0,0,0,4668,4668,-56,-56,0,0,0
2873,p1610,20151221,4668,4668,0,0,0,4738,4738,70,70,0,0,0
2874,p1610,20151222,4738,4738,0,0,0,4814,4814,76,76,0,0,0
2875,p1610,20151223,4814,4814,0,0,0,4822,4822,8,8,0,0,0
2876,p1610,20151224,4822,4822,0,0,0,4842,4842,20,20,0,0,0
2877,p1610,20151225,4842,4842,0,0,0,4814,4814,-28,-28,0,0,0
2878,p1610,20151228,4814,4814,0,0,0,4808,4808,-6,-6,0,0,0
2879,p1610,20151229,4808,4808,0,0,0,4796,4796,-12,-12,0,0,0
2880,p1610,20151230,4796,4796,0,0,0,4942,4942,146,146,0,0,0
2881,p1610,20151231,4942,4942,0,0,0,4964,4964,22,22,0,0,0
2882,p1611,20151116,4480,4480,0,0,0,4480,4480,0,0,0,0,0
2883,p1611,20151117,4480,4480,0,0,0,4492,4492,12,12,0,0,0
2884,p1611,20151118,4492,4492,0,0,0,4476,4476,-16,-16,0,0,0
2885,p1611,20151119,4476,4476,0,0,0,4466,4466,-10,-10,0,0,0
2886,p1611,20151120,4466,4466,0,0,0,4468,4468,2,2,0,0,0
2887,p1611,20151123,4468,4468,0,0,0,4472,4472,4,4,0,0,0
2888,p1611,20151124,4472,4472,0,0,0,4522,4522,50,50,0,0,0
2889,p1611,20151125,4522,4522,0,0,0,4584,4584,62,62,0,0,0
2890,p1611,20151126,4584,4584,0,0,0,4636,4636,52,52,0,0,0
2891,p1611,20151127,4636,4636,0,0,0,4694,4694,58,58,0,0,0
2892,p1611,20151130,4694,4694,0,0,0,4688,4688,-6,-6,0,0,0
2893,p1611,20151201,4688,4688,0,0,0,4688,4688,0,0,0,0,0
2894,p1611,20151202,4688,4688,0,0,0,4706,4706,18,18,0,0,0
2895,p1611,20151203,4706,4706,0,0,0,4674,4674,-32,-32,0,0,0
2896,p1611,20151204,4674,4674,4670,4670,4670,4670,4670,-4,-4,2,93400,2
2897,p1611,20151207,4670,4670,4822,4852,4822,4852,4836,182,166,4,193480,2
2898,p1611,20151208,4852,4836,5024,5024,5024,5024,5024,188,188,2,100480,2
2899,p1611,20151209,5024,5024,4918,4918,4918,4918,4918,-106,-106,2,98360,2
2900,p1611,20151210,4918,4918,0,0,0,4886,4886,-32,-32,0,0,2
2901,p1611,20151211,4886,4886,0,0,0,4884,4884,-2,-2,0,0,2
2902,p1611,20151214,4884,4884,0,0,0,4922,4922,38,38,0,0,2
2903,p1611,20151215,4922,4922,4742,4950,4742,4852,4838,-70,-84,36,1742240,12
2904,p1611,20151216,4852,4838,0,0,0,4804,4804,-34,-34,0,0,12
2905,p1611,20151217,4804,4804,0,0,0,4772,4772,-32,-32,0,0,12
2906,p1611,20151218,4772,4772,0,0,0,4716,4716,-56,-56,0,0,12
2907,p1611,20151221,4716,4716,0,0,0,4786,4786,70,70,0,0,12
2908,p1611,20151222,4786,4786,0,0,0,4862,4862,76,76,0,0,12
2909,p1611,20151223,4862,4862,0,0,0,4870,4870,8,8,0,0,12
2910,p1611,20151224,4870,4870,0,0,0,4890,4890,20,20,0,0,12
2911,p1611,20151225,4890,4890,0,0,0,4862,4862,-28,-28,0,0,12
2912,p1611,20151228,4862,4862,0,0,0,4856,4856,-6,-6,0,0,12
2913,p1611,20151229,4856,4856,0,0,0,4844,4844,-12,-12,0,0,12
2914,p1611,20151230,4844,4844,0,0,0,4992,4992,148,148,0,0,12
2915,p1611,20151231,4992,4992,0,0,0,5014,5014,22,22,0,0,12
2916,p1612,20151215,4742,4742,4880,4880,4600,4782,4754,40,12,6,285240,0
2917,p1612,20151216,4782,4754,0,0,0,4722,4722,-32,-32,0,0,0
2918,p1612,20151217,4722,4722,0,0,0,4692,4692,-30,-30,0,0,0
2919,p1612,20151218,4692,4692,0,0,0,4638,4638,-54,-54,0,0,0
2920,p1612,20151221,4638,4638,0,0,0,4706,4706,68,68,0,0,0
2921,p1612,20151222,4706,4706,0,0,0,4780,4780,74,74,0,0,0
2922,p1612,20151223,4780,4780,0,0,0,4786,4786,6,6,0,0,0
2923,p1612,20151224,4786,4786,0,0,0,4804,4804,18,18,0,0,0
2924,p1612,20151225,4804,4804,0,0,0,4778,4778,-26,-26,0,0,0
2925,p1612,20151228,4778,4778,0,0,0,4774,4774,-4,-4,0,0,0
2926,p1612,20151229,4774,4774,0,0,0,4764,4764,-10,-10,0,0,0
2927,p1612,20151230,4764,4764,0,0,0,4908,4908,144,144,0,0,0
2928,p1612,20151231,4908,4908,0,0,0,4928,4928,20,20,0,0,0
