,合约,日期,前收盘价,前结算价,开盘价,最高价,最低价,收盘价,结算价,涨跌1,涨跌2,成交量,成交金额,持仓量
1,cs1503,20150105,2615,2622,2610,2613,2610,2613,2610,-9,-12,24,626460,132
2,cs1503,20150106,2613,2610,2617,2617,2560,2588,2586,-22,-24,8,206900,130
3,cs1503,20150107,2588,2586,2627,2627,2585,2585,2606,-1,20,4,104240,132
4,cs1503,20150108,2585,2606,0,0,0,2606,2606,0,0,0,0,132
5,cs1503,20150109,2606,2606,2536,2612,2536,2605,2595,-1,-11,14,363340,130
6,cs1503,20150112,2605,2595,0,0,0,2595,2595,0,0,0,0,130
7,cs1503,20150113,2595,2595,0,0,0,2595,2595,0,0,0,0,130
8,cs1503,20150114,2595,2595,2626,2626,2581,2581,2588,-14,-7,14,362420,126
9,cs1503,20150115,2581,2588,2526,2588,2526,2588,2557,0,-31,4,102280,126
10,cs1503,20150116,2588,2557,0,0,0,2561,2561,4,4,0,0,126
11,cs1503,20150119,2561,2561,2650,2662,2608,2610,2632,49,71,8,210600,130
12,cs1503,20150120,2610,2632,2601,2601,2590,2590,2595,-42,-37,12,311420,120
13,cs1503,20150121,2590,2595,2656,2698,2492,2626,2574,31,-21,20,514800,120
14,cs1503,20150122,2626,2574,0,0,0,2574,2574,0,0,0,0,120
15,cs1503,20150123,2574,2574,0,0,0,2580,2580,6,6,0,0,120
16,cs1503,20150126,2580,2580,0,0,0,2580,2580,0,0,0,0,120
17,cs1503,20150127,2580,2580,2643,2645,2550,2640,2619,60,39,36,943040,126
18,cs1503,20150128,2640,2619,2667,2673,2666,2673,2668,54,49,8,213460,124
19,cs1503,20150129,2673,2668,2726,2726,2726,2726,2726,58,58,4,109040,124
20,cs1503,20150130,2726,2726,0,0,0,2726,2726,0,0,0,0,124
21,cs1503,20150202,2726,2726,0,0,0,2726,2726,0,0,0,0,124
22,cs1503,20150203,2726,2726,0,0,0,2726,2726,0,0,0,0,124
23,cs1503,20150204,2726,2726,0,0,0,2726,2726,0,0,0,0,124
24,cs1503,20150205,2726,2726,2733,2799,2698,2699,2740,-27,14,16,438460,120
25,cs1503,20150206,2699,2740,0,0,0,2740,2740,0,0,0,0,120
26,cs1503,20150209,2740,2740,0,0,0,2740,2740,0,0,0,0,120
27,cs1503,20150210,2740,2740,2776,2776,2631,2756,2715,16,-25,10,271580,120
28,cs1503,20150211,2756,2715,0,0,0,2715,2715,0,0,0,0,120
29,cs1503,20150212,2715,2715,2780,2780,2780,2780,2780,65,65,2,55600,120
30,cs1503,20150213,2780,2780,0,0,0,2780,2780,0,0,0,0,120
31,cs1503,20150216,2780,2780,2796,2796,2671,2683,2724,-97,-56,38,1035120,120
32,cs1503,20150217,2683,2724,2580,2655,2561,2573,2568,-151,-156,126,3236320,108
33,cs1503,20150225,2573,2568,2580,2580,2580,2580,2580,12,12,2,51600,108
34,cs1503,20150226,2580,2580,0,0,0,2580,2580,0,0,0,0,108
35,cs1503,20150227,2580,2580,2682,2683,2610,2683,2665,103,85,26,693080,112
36,cs1503,20150302,2683,2665,2783,2800,2700,2800,2763,135,98,12,331660,108
37,cs1503,20150303,2800,2763,0,0,0,2763,2763,0,0,0,0,108
38,cs1503,20150304,2763,2763,0,0,0,2763,2763,0,0,0,0,108
39,cs1503,20150305,2763,2763,0,0,0,2763,2763,0,0,0,0,108
40,cs1503,20150306,2763,2763,0,0,0,2763,2763,0,0,0,0,108
41,cs1503,20150309,2763,2763,0,0,0,2763,2763,0,0,0,0,108
42,cs1503,20150310,2763,2763,2820,2820,2820,2820,2820,57,57,30,846000,104
43,cs1503,20150311,2820,2820,0,0,0,2820,2820,0,0,0,0,104
44,cs1503,20150312,2820,2820,2810,2815,2810,2815,2812,-5,-8,22,618700,104
45,cs1503,20150313,2815,2812,0,0,0,2806,2806,-6,-6,0,0,0
46,cs1505,20150105,2713,2718,2718,2718,2678,2684,2691,-34,-27,13408,360861780,9790
47,cs1505,20150106,2684,2691,2689,2697,2624,2630,2652,-61,-39,28882,766008900,14276
48,cs1505,20150107,2630,2652,2640,2651,2625,2643,2639,-9,-13,16506,435739000,12144
49,cs1505,20150108,2643,2639,2640,2657,2636,2652,2648,13,9,10858,287581140,12230
50,cs1505,20150109,2652,2648,2652,2662,2637,2648,2648,0,0,12278,325231140,12758
51,cs1505,20150112,2648,2648,2649,2660,2648,2658,2653,10,5,8452,224281560,12546
52,cs1505,20150113,2658,2653,2658,2661,2638,2658,2646,5,-7,10230,270753000,13294
53,cs1505,20150114,2658,2646,2646,2665,2646,2647,2654,1,8,8676,230287260,12464
54,cs1505,20150115,2647,2654,2645,2663,2640,2662,2654,8,0,7404,196509300,12536
55,cs1505,20150116,2662,2654,2660,2693,2655,2684,2675,30,21,11940,319496940,12184
56,cs1505,20150119,2684,2675,2690,2714,2680,2701,2700,26,25,9284,250684340,10964
57,cs1505,20150120,2701,2700,2700,2708,2694,2702,2700,2,0,4142,111849340,11160
58,cs1505,20150121,2702,2700,2704,2723,2702,2711,2712,11,12,7186,194919360,10840
59,cs1505,20150122,2711,2712,2713,2714,2672,2694,2687,-18,-25,10236,275048620,11980
60,cs1505,20150123,2694,2687,2690,2703,2681,2686,2691,-1,4,4912,132217500,12616
61,cs1505,20150126,2686,2691,2695,2703,2660,2694,2690,3,-1,5054,135988080,12394
62,cs1505,20150127,2694,2690,2695,2736,2693,2728,2724,38,34,12686,345679820,11850
63,cs1505,20150128,2728,2724,2725,2763,2704,2759,2737,35,13,13162,360288020,12770
64,cs1505,20150129,2759,2737,2760,2828,2750,2780,2784,43,47,23132,644168380,13520
65,cs1505,20150130,2780,2784,2780,2795,2766,2778,2782,-6,-2,14918,415096520,13628
66,cs1505,20150202,2778,2782,2781,2812,2765,2796,2785,14,3,11744,327140880,13480
67,cs1505,20150203,2796,2785,2795,2806,2782,2792,2795,7,10,9956,278359280,13972
68,cs1505,20150204,2792,2795,2801,2817,2785,2797,2800,2,5,11042,309198520,14220
69,cs1505,20150205,2797,2800,2800,2858,2792,2814,2830,14,30,55740,1577806980,17990
70,cs1505,20150206,2814,2830,2821,2839,2815,2839,2827,9,-3,13580,383922980,16914
71,cs1505,20150209,2839,2827,2842,2873,2833,2862,2857,35,30,42018,1200678100,22138
72,cs1505,20150210,2862,2857,2868,2880,2854,2879,2868,22,11,35920,1030508040,24250
73,cs1505,20150211,2879,2868,2875,2878,2858,2862,2868,-6,0,21656,621181880,23082
74,cs1505,20150212,2862,2868,2862,2867,2830,2840,2845,-28,-23,30088,856069600,20088
75,cs1505,20150213,2840,2845,2840,2872,2837,2856,2854,11,9,21888,624880320,19640
76,cs1505,20150216,2856,2854,2858,2860,2845,2858,2852,4,-2,8348,238130380,18306
77,cs1505,20150217,2858,2852,2855,2855,2817,2825,2831,-27,-21,13600,385062660,16602
78,cs1505,20150225,2825,2831,2824,2843,2802,2810,2820,-21,-11,10708,302040940,16506
79,cs1505,20150226,2810,2820,2809,2838,2806,2828,2821,8,1,14028,395809720,17270
80,cs1505,20150227,2828,2821,2828,2865,2827,2856,2849,35,28,16064,457782720,18682
81,cs1505,20150302,2856,2849,2856,2875,2856,2861,2864,12,15,9402,269275200,18874
82,cs1505,20150303,2861,2864,2859,2860,2818,2842,2835,-22,-29,11430,324059100,16686
83,cs1505,20150304,2842,2835,2842,2873,2835,2871,2862,36,27,19288,552076320,20064
84,cs1505,20150305,2871,2862,2864,2869,2843,2848,2858,-14,-4,18946,541592720,17514
85,cs1505,20150306,2848,2858,2845,2863,2834,2838,2844,-20,-14,10942,311280160,15954
86,cs1505,20150309,2838,2844,2836,2865,2834,2863,2850,19,6,17332,494048720,18218
87,cs1505,20150310,2863,2850,2862,2935,2861,2914,2902,64,52,97354,2825256320,40330
88,cs1505,20150311,2914,2902,2913,2975,2913,2959,2953,57,51,121256,3581499440,48316
89,cs1505,20150312,2959,2953,2966,2966,2930,2957,2946,4,-7,66786,1967604340,46238
90,cs1505,20150313,2957,2946,2958,2995,2943,2973,2972,27,26,77968,2317770860,48800
91,cs1505,20150316,2973,2972,2969,3006,2962,2988,2986,16,14,98416,2939633260,52990
92,cs1505,20150317,2988,2986,2989,2998,2975,2993,2987,7,1,38734,1157105660,53352
93,cs1505,20150318,2993,2987,2997,2997,2952,2960,2971,-27,-16,48746,1448512700,43062
94,cs1505,20150319,2960,2971,2969,2973,2942,2952,2954,-19,-17,36680,1083830660,39252
95,cs1505,20150320,2952,2954,2951,2987,2946,2963,2970,9,16,47472,1409923820,39014
96,cs1505,20150323,2963,2970,2981,2990,2961,2975,2973,5,3,18256,542890940,37638
97,cs1505,20150324,2975,2973,2985,3060,2979,3036,3024,63,51,72272,2185682100,41254
98,cs1505,20150325,3036,3024,3040,3050,3007,3025,3028,1,4,36818,1115099240,39576
99,cs1505,20150326,3025,3028,3025,3047,3011,3037,3032,9,4,25556,774881080,41702
100,cs1505,20150327,3037,3032,3041,3089,3020,3073,3062,41,30,86776,2657601700,43870
101,cs1505,20150330,3073,3062,3079,3087,3045,3080,3069,18,7,27382,840520100,45362
102,cs1505,20150331,3080,3069,3079,3100,3063,3071,3078,2,9,33536,1032548960,44528
103,cs1505,20150401,3071,3078,3065,3069,2980,3010,3010,-68,-68,63596,1914868340,30346
104,cs1505,20150402,3010,3010,3012,3032,2988,3000,3006,-10,-4,21272,639574740,28582
105,cs1505,20150403,3000,3006,3010,3010,2970,3003,2991,-3,-15,15642,468001180,24952
106,cs1505,20150407,3003,2991,2995,3009,2975,2998,2997,7,6,7214,216246540,23032
107,cs1505,20150408,2998,2997,3000,3001,2930,2961,2966,-36,-31,21356,633432700,16422
108,cs1505,20150409,2961,2966,2970,2974,2945,2951,2954,-15,-12,5880,173719740,14794
109,cs1505,20150410,2951,2954,2956,2959,2931,2948,2941,-6,-13,6948,204406780,11280
110,cs1505,20150413,2948,2941,2948,2951,2931,2933,2939,-8,-2,5664,166468560,8280
111,cs1505,20150414,2933,2939,2948,2948,2916,2920,2923,-19,-16,2958,86488980,7406
112,cs1505,20150415,2920,2923,2909,2926,2855,2885,2879,-38,-44,4766,137245780,5516
113,cs1505,20150416,2885,2879,2900,2900,2870,2876,2876,-3,-3,1942,55862280,4044
114,cs1505,20150417,2876,2876,2872,2889,2865,2884,2877,8,1,1448,41666160,3204
115,cs1505,20150420,2884,2877,2880,2889,2873,2889,2881,12,4,550,15847380,2838
116,cs1505,20150421,2889,2881,2889,2934,2885,2897,2901,16,20,844,24490880,2582
117,cs1505,20150422,2897,2901,2920,2920,2900,2918,2909,17,8,526,15303660,2190
118,cs1505,20150423,2918,2909,2912,2915,2902,2915,2908,6,-1,184,5351940,2054
119,cs1505,20150424,2915,2908,2915,2915,2900,2901,2905,-7,-3,322,9354660,1842
120,cs1505,20150427,2901,2905,2894,2928,2893,2901,2902,-4,-3,470,13640200,1642
121,cs1505,20150428,2901,2902,2910,2915,2900,2904,2906,2,4,490,14242760,1512
122,cs1505,20150429,2904,2906,2905,2905,2886,2894,2892,-12,-14,260,7521460,1302
123,cs1505,20150430,2894,2892,2911,2915,2851,2893,2894,1,2,588,17016820,926
124,cs1505,20150504,2893,2894,2855,2908,2850,2850,2852,-44,-42,308,8785360,534
125,cs1505,20150505,2850,2852,0,0,0,2852,2852,0,0,0,0,534
126,cs1505,20150506,2852,2852,0,0,0,2852,2852,0,0,0,0,534
127,cs1505,20150507,2852,2852,0,0,0,2852,2852,0,0,0,0,534
128,cs1505,20150508,2852,2852,0,0,0,2852,2852,0,0,0,0,534
129,cs1505,20150511,2852,2852,2860,2880,2855,2855,2872,3,20,148,4251640,386
130,cs1505,20150512,2855,2872,2854,2854,2853,2853,2853,-19,-19,114,3253220,272
131,cs1505,20150513,2853,2853,0,0,0,2853,2853,0,0,0,0,272
132,cs1505,20150514,2853,2853,2900,2900,2900,2900,2900,47,47,120,3480000,272
133,cs1505,20150515,2900,2900,0,0,0,2865,2865,-35,-35,0,0,0
134,cs1507,20150105,2758,2758,0,0,0,2731,2731,-27,-27,0,0,4
135,cs1507,20150106,2731,2731,0,0,0,2731,2731,0,0,0,0,4
136,cs1507,20150107,2731,2731,0,0,0,2731,2731,0,0,0,0,4
137,cs1507,20150108,2731,2731,0,0,0,2731,2731,0,0,0,0,4
138,cs1507,20150109,2731,2731,0,0,0,2731,2731,0,0,0,0,4
139,cs1507,20150112,2731,2731,0,0,0,2731,2731,0,0,0,0,4
140,cs1507,20150113,2731,2731,0,0,0,2731,2731,0,0,0,0,4
141,cs1507,20150114,2731,2731,0,0,0,2731,2731,0,0,0,0,4
142,cs1507,20150115,2731,2731,0,0,0,2731,2731,0,0,0,0,4
143,cs1507,20150116,2731,2731,0,0,0,2731,2731,0,0,0,0,4
144,cs1507,20150119,2731,2731,0,0,0,2731,2731,0,0,0,0,4
145,cs1507,20150120,2731,2731,0,0,0,2731,2731,0,0,0,0,4
146,cs1507,20150121,2731,2731,0,0,0,2731,2731,0,0,0,0,4
147,cs1507,20150122,2731,2731,0,0,0,2706,2706,-25,-25,0,0,4
148,cs1507,20150123,2706,2706,0,0,0,2710,2710,4,4,0,0,4
149,cs1507,20150126,2710,2710,0,0,0,2710,2710,0,0,0,0,4
150,cs1507,20150127,2710,2710,0,0,0,2744,2744,34,34,0,0,4
151,cs1507,20150128,2744,2744,0,0,0,2757,2757,13,13,0,0,4
152,cs1507,20150129,2757,2757,2867,2867,2867,2867,2867,110,110,22,630740,24
153,cs1507,20150130,2867,2867,2900,2900,2900,2900,2900,33,33,2,58000,24
154,cs1507,20150202,2900,2900,0,0,0,2900,2900,0,0,0,0,24
155,cs1507,20150203,2900,2900,0,0,0,2900,2900,0,0,0,0,24
156,cs1507,20150204,2900,2900,2898,2898,2898,2898,2898,-2,-2,2,57960,24
157,cs1507,20150205,2898,2898,2898,2940,2898,2921,2928,23,30,24,702780,30
158,cs1507,20150206,2921,2928,0,0,0,2928,2928,0,0,0,0,30
159,cs1507,20150209,2928,2928,0,0,0,2928,2928,0,0,0,0,30
160,cs1507,20150210,2928,2928,0,0,0,2928,2928,0,0,0,0,30
161,cs1507,20150211,2928,2928,0,0,0,2929,2929,1,1,0,0,30
162,cs1507,20150212,2929,2929,0,0,0,2931,2931,2,2,0,0,30
163,cs1507,20150213,2931,2931,0,0,0,2932,2932,1,1,0,0,30
164,cs1507,20150216,2932,2932,2932,3049,2932,2954,2978,22,46,6,178700,30
165,cs1507,20150217,2954,2978,0,0,0,2959,2959,-19,-19,0,0,30
166,cs1507,20150225,2959,2959,0,0,0,2950,2950,-9,-9,0,0,30
167,cs1507,20150226,2950,2950,0,0,0,2950,2950,0,0,0,0,30
168,cs1507,20150227,2950,2950,0,0,0,2950,2950,0,0,0,0,30
169,cs1507,20150302,2950,2950,0,0,0,2950,2950,0,0,0,0,30
170,cs1507,20150303,2950,2950,0,0,0,2950,2950,0,0,0,0,30
171,cs1507,20150304,2950,2950,2957,2960,2957,2960,2958,10,8,20,591740,46
172,cs1507,20150305,2960,2958,0,0,0,2958,2958,0,0,0,0,46
173,cs1507,20150306,2958,2958,0,0,0,2958,2958,0,0,0,0,46
174,cs1507,20150309,2958,2958,0,0,0,2958,2958,0,0,0,0,46
175,cs1507,20150310,2958,2958,0,0,0,2958,2958,0,0,0,0,46
176,cs1507,20150311,2958,2958,0,0,0,2958,2958,0,0,0,0,46
177,cs1507,20150312,2958,2958,0,0,0,2958,2958,0,0,0,0,46
178,cs1507,20150313,2958,2958,0,0,0,2958,2958,0,0,0,0,46
179,cs1507,20150316,2958,2958,0,0,0,2958,2958,0,0,0,0,46
180,cs1507,20150317,2958,2958,0,0,0,2958,2958,0,0,0,0,46
181,cs1507,20150318,2958,2958,0,0,0,2958,2958,0,0,0,0,46
182,cs1507,20150319,2958,2958,0,0,0,2958,2958,0,0,0,0,46
183,cs1507,20150320,2958,2958,0,0,0,2958,2958,0,0,0,0,46
184,cs1507,20150323,2958,2958,0,0,0,2958,2958,0,0,0,0,46
185,cs1507,20150324,2958,2958,3066,3067,3065,3067,3066,109,108,20,613240,34
186,cs1507,20150325,3067,3066,2960,3084,2960,2982,3008,-84,-58,6,180520,34
187,cs1507,20150326,2982,3008,0,0,0,3008,3008,0,0,0,0,34
188,cs1507,20150327,3008,3008,2900,2900,2900,2900,2900,-108,-108,2,58000,34
189,cs1507,20150330,2900,2900,3001,3016,3001,3016,3006,116,106,6,180380,38
190,cs1507,20150331,3016,3006,0,0,0,3006,3006,0,0,0,0,38
191,cs1507,20150401,3006,3006,3006,3006,3006,3006,3006,0,0,2,60120,36
192,cs1507,20150402,3006,3006,3062,3062,3062,3062,3062,56,56,2,61240,36
193,cs1507,20150403,3062,3062,3052,3052,3052,3052,3052,-10,-10,2,61040,34
194,cs1507,20150407,3052,3052,0,0,0,3052,3052,0,0,0,0,34
195,cs1507,20150408,3052,3052,0,0,0,3052,3052,0,0,0,0,34
196,cs1507,20150409,3052,3052,0,0,0,3052,3052,0,0,0,0,34
197,cs1507,20150410,3052,3052,2931,3082,2931,3082,3017,30,-35,6,181060,36
198,cs1507,20150413,3082,3017,3017,3017,3017,3017,3017,0,0,2,60340,36
199,cs1507,20150414,3017,3017,0,0,0,3017,3017,0,0,0,0,36
200,cs1507,20150415,3017,3017,0,0,0,3017,3017,0,0,0,0,36
201,cs1507,20150416,3017,3017,2956,2956,2906,2906,2950,-111,-67,18,531080,36
202,cs1507,20150417,2906,2950,0,0,0,2951,2951,1,1,0,0,36
203,cs1507,20150420,2951,2951,0,0,0,2955,2955,4,4,0,0,36
204,cs1507,20150421,2955,2955,0,0,0,2955,2955,0,0,0,0,36
205,cs1507,20150422,2955,2955,0,0,0,2963,2963,8,8,0,0,36
206,cs1507,20150423,2963,2963,2870,2870,2870,2870,2870,-93,-93,2,57400,36
207,cs1507,20150424,2870,2870,0,0,0,2870,2870,0,0,0,0,36
208,cs1507,20150427,2870,2870,0,0,0,2870,2870,0,0,0,0,36
209,cs1507,20150428,2870,2870,0,0,0,2870,2870,0,0,0,0,36
210,cs1507,20150429,2870,2870,2899,2910,2758,2910,2891,40,21,24,693900,18
211,cs1507,20150430,2910,2891,0,0,0,2891,2891,0,0,0,0,18
212,cs1507,20150504,2891,2891,0,0,0,2850,2850,-41,-41,0,0,18
213,cs1507,20150505,2850,2850,0,0,0,2850,2850,0,0,0,0,18
214,cs1507,20150506,2850,2850,2964,2964,2884,2964,2924,114,74,8,233920,18
215,cs1507,20150507,2964,2924,0,0,0,2924,2924,0,0,0,0,18
216,cs1507,20150508,2924,2924,0,0,0,2924,2924,0,0,0,0,18
217,cs1507,20150511,2924,2924,0,0,0,2924,2924,0,0,0,0,18
218,cs1507,20150512,2924,2924,3018,3018,2820,2820,2919,-104,-5,4,116760,18
219,cs1507,20150513,2820,2919,0,0,0,2919,2919,0,0,0,0,18
220,cs1507,20150514,2919,2919,0,0,0,2919,2919,0,0,0,0,18
221,cs1507,20150515,2919,2919,0,0,0,2919,2919,0,0,0,0,18
222,cs1507,20150518,2919,2919,0,0,0,2919,2919,0,0,0,0,18
223,cs1507,20150519,2919,2919,0,0,0,2919,2919,0,0,0,0,18
224,cs1507,20150520,2919,2919,0,0,0,2919,2919,0,0,0,0,18
225,cs1507,20150521,2919,2919,0,0,0,2919,2919,0,0,0,0,18
226,cs1507,20150522,2919,2919,0,0,0,2919,2919,0,0,0,0,18
227,cs1507,20150525,2919,2919,0,0,0,2919,2919,0,0,0,0,18
228,cs1507,20150526,2919,2919,0,0,0,2919,2919,0,0,0,0,18
229,cs1507,20150527,2919,2919,0,0,0,2919,2919,0,0,0,0,18
230,cs1507,20150528,2919,2919,0,0,0,2919,2919,0,0,0,0,18
231,cs1507,20150529,2919,2919,2850,2850,2850,2850,2850,-69,-69,2,57000,18
232,cs1507,20150601,2850,2850,2850,2850,2850,2850,2850,0,0,2,57000,18
233,cs1507,20150602,2850,2850,0,0,0,2850,2850,0,0,0,0,18
234,cs1507,20150603,2850,2850,0,0,0,2850,2850,0,0,0,0,18
235,cs1507,20150604,2850,2850,0,0,0,2850,2850,0,0,0,0,18
236,cs1507,20150605,2850,2850,0,0,0,2850,2850,0,0,0,0,18
237,cs1507,20150608,2850,2850,2849,2849,2736,2787,2789,-63,-61,10,278960,18
238,cs1507,20150609,2787,2789,0,0,0,2789,2789,0,0,0,0,18
239,cs1507,20150610,2789,2789,2848,2848,2703,2809,2794,20,5,8,223520,16
240,cs1507,20150611,2809,2794,0,0,0,2794,2794,0,0,0,0,16
241,cs1507,20150612,2794,2794,0,0,0,2794,2794,0,0,0,0,16
242,cs1507,20150615,2794,2794,2870,2870,2694,2757,2750,-37,-44,20,550180,12
243,cs1507,20150616,2757,2750,2750,2750,2750,2750,2750,0,0,2,55000,12
244,cs1507,20150617,2750,2750,0,0,0,2750,2750,0,0,0,0,12
245,cs1507,20150618,2750,2750,0,0,0,2750,2750,0,0,0,0,12
246,cs1507,20150619,2750,2750,0,0,0,2750,2750,0,0,0,0,12
247,cs1507,20150623,2750,2750,2849,2849,2749,2749,2799,-1,49,4,111960,12
248,cs1507,20150624,2749,2799,0,0,0,2799,2799,0,0,0,0,12
249,cs1507,20150625,2799,2799,0,0,0,2799,2799,0,0,0,0,12
250,cs1507,20150626,2799,2799,0,0,0,2799,2799,0,0,0,0,12
251,cs1507,20150629,2799,2799,0,0,0,2799,2799,0,0,0,0,12
252,cs1507,20150630,2799,2799,2910,2910,2910,2910,2910,111,111,2,58200,12
253,cs1507,20150701,2910,2910,2736,2850,2736,2850,2844,-60,-66,210,5973600,200
254,cs1507,20150702,2850,2844,0,0,0,2844,2844,0,0,0,0,200
255,cs1507,20150703,2844,2844,2875,2875,2875,2875,2875,31,31,12,345000,212
256,cs1507,20150706,2875,2875,2875,2875,2875,2875,2875,0,0,30,862500,42
257,cs1507,20150707,2875,2875,0,0,0,2875,2875,0,0,0,0,42
258,cs1507,20150708,2875,2875,0,0,0,2875,2875,0,0,0,0,42
259,cs1507,20150709,2875,2875,0,0,0,2875,2875,0,0,0,0,42
260,cs1507,20150710,2875,2875,0,0,0,2875,2875,0,0,0,0,42
261,cs1507,20150713,2875,2875,0,0,0,2875,2875,0,0,0,0,42
262,cs1507,20150714,2875,2875,0,0,0,2849,2849,-26,-26,0,0,0
263,cs1509,20150105,2837,2838,2845,2845,2818,2841,2832,3,-6,1392,39426760,2328
264,cs1509,20150106,2841,2832,2842,2849,2779,2779,2810,-53,-22,2484,69817480,3064
265,cs1509,20150107,2779,2810,2775,2803,2775,2798,2792,-12,-18,818,22840760,3204
266,cs1509,20150108,2798,2792,2798,2814,2794,2810,2804,18,12,720,20192100,3294
267,cs1509,20150109,2810,2804,2805,2815,2794,2806,2803,2,-1,854,23940320,3504
268,cs1509,20150112,2806,2803,2806,2813,2804,2813,2809,10,6,530,14892700,3432
269,cs1509,20150113,2813,2809,2814,2815,2794,2814,2805,5,-4,1242,34841240,3346
270,cs1509,20150114,2814,2805,2809,2820,2807,2810,2811,5,6,626,17601580,3242
271,cs1509,20150115,2810,2811,2811,2821,2805,2820,2813,9,2,324,9116480,3192
272,cs1509,20150116,2820,2813,2807,2847,2807,2843,2831,30,18,1064,30126840,2896
273,cs1509,20150119,2843,2831,2840,2868,2836,2862,2856,31,25,586,16739240,2908
274,cs1509,20150120,2862,2856,2860,2868,2858,2868,2862,12,6,234,6698960,2898
275,cs1509,20150121,2868,2862,2873,2885,2872,2877,2878,15,16,932,26832100,3096
276,cs1509,20150122,2877,2878,2881,2881,2849,2868,2862,-10,-16,1316,37665000,3408
277,cs1509,20150123,2868,2862,2874,2880,2862,2867,2869,5,7,636,18247640,3440
278,cs1509,20150126,2867,2869,2866,2891,2853,2888,2879,19,10,1008,29029160,3486
279,cs1509,20150127,2888,2879,2890,2942,2888,2936,2921,57,42,2056,60061840,3870
280,cs1509,20150128,2936,2921,2935,2945,2915,2936,2930,15,9,1634,47877600,4128
281,cs1509,20150129,2936,2930,2937,2960,2929,2940,2942,10,12,1300,38253040,4262
282,cs1509,20150130,2940,2942,2931,2955,2926,2942,2940,0,-2,888,26110720,4358
283,cs1509,20150202,2942,2940,2941,2959,2931,2952,2941,12,1,948,27888340,4626
284,cs1509,20150203,2952,2941,2965,2965,2944,2954,2951,13,10,836,24678380,4688
285,cs1509,20150204,2954,2951,2970,2977,2961,2972,2969,21,18,1712,50844900,5300
286,cs1509,20150205,2972,2969,2970,3017,2966,2998,2999,29,30,6918,207476320,7716
287,cs1509,20150206,2998,2999,2998,3012,2995,3009,3004,10,5,2700,81125080,8252
288,cs1509,20150209,3009,3004,3009,3034,3007,3032,3022,28,18,4462,134852900,9680
289,cs1509,20150210,3032,3022,3034,3058,3031,3056,3045,34,23,7426,226188560,11588
290,cs1509,20150211,3056,3045,3080,3080,3042,3057,3056,12,11,6686,204350100,12498
291,cs1509,20150212,3057,3056,3060,3060,3027,3032,3036,-24,-20,8438,256250860,12104
292,cs1509,20150213,3032,3036,3035,3065,3023,3048,3046,12,10,8236,250914100,13236
293,cs1509,20150216,3048,3046,3050,3060,3043,3059,3052,13,6,3648,111345000,13326
294,cs1509,20150217,3059,3052,3056,3056,3025,3034,3038,-18,-14,3182,96670080,13256
295,cs1509,20150225,3034,3038,3034,3045,3004,3010,3026,-28,-12,3810,115305540,13402
296,cs1509,20150226,3010,3026,3016,3016,2986,2998,2999,-28,-27,10708,321193700,12482
297,cs1509,20150227,2998,2999,3006,3030,2998,3023,3019,24,20,5732,173080660,12676
298,cs1509,20150302,3023,3019,3030,3033,3018,3024,3024,5,5,4228,127861360,13390
299,cs1509,20150303,3024,3024,3024,3027,2999,3020,3011,-4,-13,6996,210662840,11334
300,cs1509,20150304,3020,3011,3015,3054,3015,3051,3040,40,29,8828,268431720,13692
301,cs1509,20150305,3051,3040,3040,3060,3015,3021,3035,-19,-5,8612,261427320,12504
302,cs1509,20150306,3021,3035,3016,3031,3005,3016,3018,-19,-17,5868,177110980,12760
303,cs1509,20150309,3016,3018,3015,3031,3001,3022,3018,4,0,7878,237761100,13142
304,cs1509,20150310,3022,3018,3023,3066,3022,3064,3050,46,32,14976,456867880,13910
305,cs1509,20150311,3064,3050,3058,3099,3032,3048,3068,-2,18,23272,714129080,14776
306,cs1509,20150312,3048,3068,3052,3052,3027,3047,3040,-21,-28,10104,307256900,15534
307,cs1509,20150313,3047,3040,3050,3078,3040,3061,3059,21,19,20146,616373000,17632
308,cs1509,20150316,3061,3059,3056,3072,3039,3067,3057,8,-2,21508,657709820,19334
309,cs1509,20150317,3067,3057,3070,3082,3059,3075,3072,18,15,8872,272571200,20108
310,cs1509,20150318,3075,3072,3061,3082,3028,3031,3050,-41,-22,18166,554094240,17926
311,cs1509,20150319,3031,3050,3055,3055,3001,3011,3021,-39,-29,22624,683563500,19972
312,cs1509,20150320,3011,3021,3006,3034,3005,3027,3021,6,0,18592,561787620,21726
313,cs1509,20150323,3027,3021,3033,3052,3031,3049,3042,28,21,13296,404522520,21270
314,cs1509,20150324,3049,3042,3060,3095,3050,3086,3077,44,35,31608,972660080,25610
315,cs1509,20150325,3086,3077,3088,3108,3065,3079,3085,2,8,30762,949076760,26766
316,cs1509,20150326,3079,3085,3079,3088,3062,3080,3074,-5,-11,14360,441556300,27768
317,cs1509,20150327,3080,3074,3070,3097,3067,3090,3084,16,10,41482,1279639040,29874
318,cs1509,20150330,3090,3084,3091,3092,3057,3074,3071,-10,-13,27092,832008100,28446
319,cs1509,20150331,3074,3071,3079,3085,3043,3053,3055,-18,-16,20698,632451180,25128
320,cs1509,20150401,3053,3055,3045,3053,2987,3008,3012,-47,-43,48224,1452696680,29138
321,cs1509,20150402,3008,3012,3020,3027,2991,3014,3009,2,-3,23914,719604300,30214
322,cs1509,20150403,3014,3009,3013,3014,2996,3009,3004,0,-5,20966,629978300,30572
323,cs1509,20150407,3009,3004,3014,3014,2976,3000,2996,-4,-8,24478,733505840,30830
324,cs1509,20150408,3000,2996,3000,3013,2952,2964,2977,-32,-19,63290,1884392940,37294
325,cs1509,20150409,2964,2977,2965,2970,2948,2963,2960,-14,-17,32340,957342460,39404
326,cs1509,20150410,2963,2960,2961,3004,2960,2997,2979,37,19,44112,1314422420,34322
327,cs1509,20150413,2997,2979,2984,3043,2984,3032,3020,53,41,76314,2305045040,38024
328,cs1509,20150414,3032,3020,3035,3038,2989,2998,3010,-22,-10,45220,1361431140,35440
329,cs1509,20150415,2998,3010,2999,3001,2914,2936,2946,-74,-64,88170,2598288040,36824
330,cs1509,20150416,2936,2946,2947,2958,2926,2942,2943,-4,-3,37092,1091858780,35880
331,cs1509,20150417,2942,2943,2945,2971,2937,2968,2957,25,14,33852,1001202780,33326
332,cs1509,20150420,2968,2957,2971,2983,2937,2948,2952,-9,-5,31106,918467980,33046
333,cs1509,20150421,2948,2952,2950,2963,2928,2946,2944,-6,-8,31260,920491820,33506
334,cs1509,20150422,2946,2944,2942,2961,2938,2956,2954,12,10,20688,611137060,32608
335,cs1509,20150423,2956,2954,2953,2973,2953,2956,2961,2,7,21454,635419440,33134
336,cs1509,20150424,2956,2961,2963,2967,2922,2953,2941,-8,-20,42390,1246810940,33994
337,cs1509,20150427,2953,2941,2945,2956,2938,2951,2949,10,8,14366,423654060,34494
338,cs1509,20150428,2951,2949,2952,2983,2942,2952,2964,3,15,45442,1347243600,33776
339,cs1509,20150429,2952,2964,2955,2955,2930,2947,2942,-17,-22,25622,753808140,33128
340,cs1509,20150430,2947,2942,2949,2979,2948,2975,2965,33,23,28902,857035200,33998
341,cs1509,20150504,2975,2965,2966,3016,2966,2995,3000,30,35,47982,1439924940,35870
342,cs1509,20150505,2995,3000,2998,3002,2983,2998,2991,-2,-9,21168,633309440,33638
343,cs1509,20150506,2998,2991,3001,3001,2989,2997,2994,6,3,15402,461248320,31018
344,cs1509,20150507,2997,2994,2995,3032,2983,3009,3015,15,21,67812,2044640060,32020
345,cs1509,20150508,3009,3015,3000,3007,2988,2995,2996,-20,-19,23924,716959300,29482
346,cs1509,20150511,2995,2996,3000,3014,2986,2992,2995,-4,-1,17034,510261480,28848
347,cs1509,20150512,2992,2995,2989,3010,2983,3009,2998,14,3,18532,555656080,29836
348,cs1509,20150513,3009,2998,3002,3025,3002,3016,3016,18,18,22320,673215320,31118
349,cs1509,20150514,3016,3016,3016,3027,3005,3025,3016,9,0,25634,773221320,30264
350,cs1509,20150515,3025,3016,3030,3039,3020,3024,3028,8,12,24632,746085500,32276
351,cs1509,20150518,3024,3028,3026,3026,3009,3013,3014,-15,-14,13512,407344420,30044
352,cs1509,20150519,3013,3014,3015,3022,3005,3017,3013,3,-1,14586,439556700,30626
353,cs1509,20150520,3017,3013,3011,3025,2997,3008,3007,-5,-6,27680,832586580,29426
354,cs1509,20150521,3008,3007,3011,3016,3001,3011,3008,4,1,12350,371593480,28500
355,cs1509,20150522,3011,3008,3011,3013,2995,3004,3004,-4,-4,14832,445616820,27560
356,cs1509,20150525,3004,3004,2997,3000,2961,2962,2981,-42,-23,26002,775209880,25490
357,cs1509,20150526,2962,2981,2966,2978,2930,2933,2956,-48,-25,31174,921740580,25056
358,cs1509,20150527,2933,2956,2928,2942,2890,2894,2912,-62,-44,27890,812293000,27060
359,cs1509,20150528,2894,2912,2912,2918,2892,2911,2905,-1,-7,24832,721599240,26330
360,cs1509,20150529,2911,2905,2912,2931,2907,2922,2921,17,16,15792,461301240,24580
361,cs1509,20150601,2922,2921,2930,2948,2930,2931,2936,10,15,11798,346426980,24782
362,cs1509,20150602,2931,2936,2928,2946,2922,2945,2932,9,-4,7616,223350000,24344
363,cs1509,20150603,2945,2932,2946,2946,2920,2925,2931,-7,-1,10942,320720120,24230
364,cs1509,20150604,2925,2931,2920,2927,2877,2909,2904,-22,-27,31070,902365380,25712
365,cs1509,20150605,2909,2904,2910,2913,2873,2874,2890,-30,-14,15198,439232800,27738
366,cs1509,20150608,2874,2890,2862,2882,2817,2876,2847,-14,-43,46204,1315819980,31482
367,cs1509,20150609,2876,2847,2880,2890,2866,2879,2877,32,30,12972,373248200,31802
368,cs1509,20150610,2879,2877,2885,2888,2852,2871,2865,-6,-12,20344,582942480,31256
369,cs1509,20150611,2871,2865,2867,2888,2867,2880,2878,15,13,11806,339778420,30198
370,cs1509,20150612,2880,2878,2877,2877,2846,2872,2862,-6,-16,17136,490547140,31556
371,cs1509,20150615,2872,2862,2840,2863,2813,2836,2835,-26,-27,24688,700029340,37170
372,cs1509,20150616,2836,2835,2840,2879,2828,2872,2853,37,18,16854,480893860,38778
373,cs1509,20150617,2872,2853,2874,2887,2865,2871,2874,18,21,12160,349564640,37970
374,cs1509,20150618,2871,2874,2870,2898,2869,2883,2883,9,9,11930,344019280,36766
375,cs1509,20150619,2883,2883,2883,2894,2867,2877,2876,-6,-7,9794,281726040,35658
376,cs1509,20150623,2877,2876,2885,2920,2866,2874,2889,-2,13,13790,398437700,34454
377,cs1509,20150624,2874,2889,2872,2879,2851,2872,2863,-17,-26,18352,525498960,33156
378,cs1509,20150625,2872,2863,2872,2877,2852,2853,2860,-10,-3,10748,307470920,36062
379,cs1509,20150626,2853,2860,2860,2866,2846,2862,2855,2,-5,12668,361753700,33246
380,cs1509,20150629,2862,2855,2871,2876,2839,2839,2850,-16,-5,12822,365493300,33800
381,cs1509,20150630,2839,2850,2845,2845,2820,2834,2832,-16,-18,9882,279887200,33058
382,cs1509,20150701,2834,2832,2848,2889,2845,2858,2860,26,28,10032,286949280,31530
383,cs1509,20150702,2858,2860,2860,2860,2821,2839,2840,-21,-20,5954,169123800,31586
384,cs1509,20150703,2839,2840,2844,2857,2839,2854,2851,14,11,7222,205950540,31202
385,cs1509,20150706,2854,2851,2852,2869,2848,2857,2858,6,7,9878,282319660,30584
386,cs1509,20150707,2857,2858,2858,2875,2851,2856,2865,-2,7,11536,330620900,29864
387,cs1509,20150708,2856,2865,2818,2860,2756,2814,2798,-51,-67,111586,3122320140,33862
388,cs1509,20150709,2814,2798,2849,2891,2842,2879,2867,81,69,49548,1420906660,23010
389,cs1509,20150710,2879,2867,2870,2895,2858,2860,2875,-7,8,21554,619731300,22794
390,cs1509,20150713,2860,2875,2860,2913,2847,2851,2870,-24,-5,18820,540210220,22536
391,cs1509,20150714,2851,2870,2870,2873,2850,2852,2859,-18,-11,6572,187936880,21762
392,cs1509,20150715,2852,2859,2848,2859,2841,2852,2852,-7,-7,3930,112101680,21238
393,cs1509,20150716,2852,2852,2858,2890,2850,2887,2868,35,16,14868,426531200,22576
394,cs1509,20150717,2887,2868,2887,2900,2872,2892,2888,24,20,11596,334900360,23400
395,cs1509,20150720,2892,2888,2890,2890,2822,2840,2855,-48,-33,11518,328847440,21562
396,cs1509,20150721,2840,2855,2840,2847,2831,2843,2839,-12,-16,7586,215436340,21856
397,cs1509,20150722,2843,2839,2841,2853,2836,2846,2845,7,6,6164,175366160,21194
398,cs1509,20150723,2846,2845,2849,2851,2838,2841,2842,-4,-3,4436,126099000,20616
399,cs1509,20150724,2841,2842,2840,2844,2818,2834,2834,-8,-8,6172,174964000,19548
400,cs1509,20150727,2834,2834,2835,2835,2775,2777,2792,-57,-42,9206,257072420,19414
401,cs1509,20150728,2777,2792,2760,2813,2757,2803,2787,11,-5,4138,115329140,18676
402,cs1509,20150729,2803,2787,2814,2829,2797,2821,2815,34,28,4352,122514940,17652
403,cs1509,20150730,2821,2815,2820,2820,2792,2797,2808,-18,-7,1390,39035700,17306
404,cs1509,20150731,2797,2808,2800,2806,2791,2802,2799,-6,-9,1490,41719740,16854
405,cs1509,20150803,2802,2799,2797,2800,2750,2766,2771,-33,-28,2658,73659360,16706
406,cs1509,20150804,2766,2771,2769,2781,2757,2778,2771,7,0,3382,93746800,16290
407,cs1509,20150805,2778,2771,2781,2781,2760,2768,2765,-3,-6,3542,97956820,15508
408,cs1509,20150806,2768,2765,2808,2808,2758,2763,2764,-2,-1,1842,50917340,15374
409,cs1509,20150807,2763,2764,2758,2770,2754,2768,2762,4,-2,1588,43866120,15252
410,cs1509,20150810,2768,2762,2765,2770,2759,2765,2763,3,1,2234,61735360,14814
411,cs1509,20150811,2765,2763,2772,2799,2765,2768,2773,5,10,1368,37937180,14310
412,cs1509,20150812,2768,2773,2760,2775,2760,2767,2769,-6,-4,440,12187040,14106
413,cs1509,20150813,2767,2769,2760,2787,2760,2776,2767,7,-2,1808,50044680,14050
414,cs1509,20150814,2776,2767,2770,2770,2765,2769,2767,2,0,282,7803680,13920
415,cs1509,20150817,2769,2767,2780,2780,2765,2775,2767,8,0,970,26847860,13648
416,cs1509,20150818,2775,2767,2779,2779,2765,2766,2767,-1,0,382,10570500,13338
417,cs1509,20150819,2766,2767,2764,2773,2764,2771,2768,4,1,288,7972140,13104
418,cs1509,20150820,2771,2768,2766,2785,2766,2784,2777,16,9,346,9608840,12978
419,cs1509,20150821,2784,2777,2776,2790,2765,2765,2778,-12,1,550,15279260,12618
420,cs1509,20150824,2765,2778,2755,2788,2741,2774,2765,-4,-13,342,9459220,12380
421,cs1509,20150825,2774,2765,2794,2834,2780,2780,2786,15,21,268,7467820,12344
422,cs1509,20150826,2780,2786,2770,2785,2770,2782,2773,-4,-13,1420,39386860,12212
423,cs1509,20150827,2782,2773,2771,2777,2713,2744,2763,-29,-10,868,23987540,11888
424,cs1509,20150828,2744,2763,2764,2818,2759,2760,2764,-3,1,1466,40521180,10438
425,cs1509,20150831,2760,2764,2765,2765,2654,2679,2723,-85,-41,732,19932480,10084
426,cs1509,20150901,2679,2723,2720,2720,2670,2670,2698,-53,-25,144,3885500,9940
427,cs1509,20150902,2670,2698,2775,2775,2670,2670,2673,-28,-25,1682,44963500,8260
428,cs1509,20150907,2670,2673,2710,2710,2630,2630,2692,-43,19,240,6462000,8260
429,cs1509,20150908,2630,2692,2635,2635,2635,2635,2635,-57,-57,60,1581000,8260
430,cs1509,20150909,2635,2635,0,0,0,2635,2635,0,0,0,0,8260
431,cs1509,20150910,2635,2635,2650,2700,2650,2700,2655,65,20,112,2974000,8248
432,cs1509,20150911,2700,2655,0,0,0,2655,2655,0,0,0,0,8248
433,cs1509,20150914,2655,2655,2600,2600,2600,2600,2600,-55,-55,200,5200000,5248
434,cs1509,20150915,2600,2600,2755,2755,2755,2755,2755,155,155,108,2975400,5248
435,cs1509,20150916,2755,2755,0,0,0,2672,2672,-83,-83,0,0,0
436,cs1511,20150105,2716,2716,0,0,0,2716,2716,0,0,0,0,14
437,cs1511,20150106,2716,2716,2670,2670,2670,2670,2670,-46,-46,2,53400,12
438,cs1511,20150107,2670,2670,0,0,0,2670,2670,0,0,0,0,12
439,cs1511,20150108,2670,2670,2703,2704,2703,2704,2703,34,33,6,162200,8
440,cs1511,20150109,2704,2703,0,0,0,2703,2703,0,0,0,0,8
441,cs1511,20150112,2703,2703,0,0,0,2703,2703,0,0,0,0,8
442,cs1511,20150113,2703,2703,0,0,0,2703,2703,0,0,0,0,8
443,cs1511,20150114,2703,2703,0,0,0,2703,2703,0,0,0,0,8
444,cs1511,20150115,2703,2703,0,0,0,2703,2703,0,0,0,0,8
445,cs1511,20150116,2703,2703,0,0,0,2703,2703,0,0,0,0,8
446,cs1511,20150119,2703,2703,2749,2797,2749,2797,2773,94,70,4,110920,8
447,cs1511,20150120,2797,2773,2728,2728,2727,2728,2727,-45,-46,10,272780,6
448,cs1511,20150121,2728,2727,2727,2727,2722,2722,2724,-5,-3,4,108980,6
449,cs1511,20150122,2722,2724,2761,2762,2761,2762,2761,38,37,4,110460,2
450,cs1511,20150123,2762,2761,0,0,0,2761,2761,0,0,0,0,2
451,cs1511,20150126,2761,2761,0,0,0,2761,2761,0,0,0,0,2
452,cs1511,20150127,2761,2761,0,0,0,2761,2761,0,0,0,0,2
453,cs1511,20150128,2761,2761,0,0,0,2761,2761,0,0,0,0,2
454,cs1511,20150129,2761,2761,0,0,0,2761,2761,0,0,0,0,2
455,cs1511,20150130,2761,2761,2827,2827,2827,2827,2827,66,66,2,56540,4
456,cs1511,20150202,2827,2827,0,0,0,2827,2827,0,0,0,0,4
457,cs1511,20150203,2827,2827,0,0,0,2827,2827,0,0,0,0,4
458,cs1511,20150204,2827,2827,0,0,0,2827,2827,0,0,0,0,4
459,cs1511,20150205,2827,2827,2906,2906,2796,2796,2851,-31,24,4,114040,4
460,cs1511,20150206,2796,2851,0,0,0,2851,2851,0,0,0,0,4
461,cs1511,20150209,2851,2851,0,0,0,2851,2851,0,0,0,0,4
462,cs1511,20150210,2851,2851,0,0,0,2851,2851,0,0,0,0,4
463,cs1511,20150211,2851,2851,0,0,0,2851,2851,0,0,0,0,4
464,cs1511,20150212,2851,2851,0,0,0,2851,2851,0,0,0,0,4
465,cs1511,20150213,2851,2851,0,0,0,2851,2851,0,0,0,0,4
466,cs1511,20150216,2851,2851,0,0,0,2851,2851,0,0,0,0,4
467,cs1511,20150217,2851,2851,0,0,0,2851,2851,0,0,0,0,4
468,cs1511,20150225,2851,2851,0,0,0,2851,2851,0,0,0,0,4
469,cs1511,20150226,2851,2851,0,0,0,2851,2851,0,0,0,0,4
470,cs1511,20150227,2851,2851,0,0,0,2851,2851,0,0,0,0,4
471,cs1511,20150302,2851,2851,0,0,0,2875,2875,24,24,0,0,4
472,cs1511,20150303,2875,2875,0,0,0,2875,2875,0,0,0,0,4
473,cs1511,20150304,2875,2875,0,0,0,2881,2881,6,6,0,0,4
474,cs1511,20150305,2881,2881,0,0,0,2881,2881,0,0,0,0,4
475,cs1511,20150306,2881,2881,0,0,0,2881,2881,0,0,0,0,4
476,cs1511,20150309,2881,2881,0,0,0,2881,2881,0,0,0,0,4
477,cs1511,20150310,2881,2881,2856,2947,2856,2947,2901,66,20,4,116060,4
478,cs1511,20150311,2947,2901,0,0,0,2901,2901,0,0,0,0,4
479,cs1511,20150312,2901,2901,2969,2969,2969,2969,2969,68,68,2,59380,4
480,cs1511,20150313,2969,2969,0,0,0,2969,2969,0,0,0,0,4
481,cs1511,20150316,2969,2969,2853,2853,2853,2853,2853,-116,-116,2,57060,4
482,cs1511,20150317,2853,2853,0,0,0,2866,2866,13,13,0,0,4
483,cs1511,20150318,2866,2866,0,0,0,2866,2866,0,0,0,0,4
484,cs1511,20150319,2866,2866,0,0,0,2866,2866,0,0,0,0,4
485,cs1511,20150320,2866,2866,2957,2957,2867,2867,2912,1,46,4,116480,4
486,cs1511,20150323,2867,2912,0,0,0,2912,2912,0,0,0,0,4
487,cs1511,20150324,2912,2912,0,0,0,2912,2912,0,0,0,0,4
488,cs1511,20150325,2912,2912,0,0,0,2912,2912,0,0,0,0,4
489,cs1511,20150326,2912,2912,0,0,0,2912,2912,0,0,0,0,4
490,cs1511,20150327,2912,2912,0,0,0,2912,2912,0,0,0,0,4
491,cs1511,20150330,2912,2912,0,0,0,2912,2912,0,0,0,0,4
492,cs1511,20150331,2912,2912,0,0,0,2912,2912,0,0,0,0,4
493,cs1511,20150401,2912,2912,0,0,0,2912,2912,0,0,0,0,4
494,cs1511,20150402,2912,2912,2970,2970,2831,2831,2900,-81,-12,4,116020,4
495,cs1511,20150403,2831,2900,0,0,0,2900,2900,0,0,0,0,4
496,cs1511,20150407,2900,2900,0,0,0,2896,2896,-4,-4,0,0,4
497,cs1511,20150408,2896,2896,0,0,0,2896,2896,0,0,0,0,4
498,cs1511,20150409,2896,2896,0,0,0,2896,2896,0,0,0,0,4
499,cs1511,20150410,2896,2896,0,0,0,2896,2896,0,0,0,0,4
500,cs1511,20150413,2896,2896,0,0,0,2896,2896,0,0,0,0,4
501,cs1511,20150414,2896,2896,0,0,0,2888,2888,-8,-8,0,0,4
502,cs1511,20150415,2888,2888,2830,2830,2830,2830,2830,-58,-58,2,56600,4
503,cs1511,20150416,2830,2830,0,0,0,2830,2830,0,0,0,0,4
504,cs1511,20150417,2830,2830,0,0,0,2830,2830,0,0,0,0,4
505,cs1511,20150420,2830,2830,0,0,0,2830,2830,0,0,0,0,4
506,cs1511,20150421,2830,2830,0,0,0,2830,2830,0,0,0,0,4
507,cs1511,20150422,2830,2830,0,0,0,2830,2830,0,0,0,0,4
508,cs1511,20150423,2830,2830,0,0,0,2831,2831,1,1,0,0,4
509,cs1511,20150424,2831,2831,0,0,0,2831,2831,0,0,0,0,4
510,cs1511,20150427,2831,2831,0,0,0,2831,2831,0,0,0,0,4
511,cs1511,20150428,2831,2831,0,0,0,2831,2831,0,0,0,0,4
512,cs1511,20150429,2831,2831,2822,2822,2822,2822,2822,-9,-9,2,56440,4
513,cs1511,20150430,2822,2822,0,0,0,2829,2829,7,7,0,0,4
514,cs1511,20150504,2829,2829,0,0,0,2849,2849,20,20,0,0,4
515,cs1511,20150505,2849,2849,0,0,0,2849,2849,0,0,0,0,4
516,cs1511,20150506,2849,2849,2841,2841,2841,2841,2841,-8,-8,2,56820,4
517,cs1511,20150507,2841,2841,2911,2911,2848,2909,2879,68,38,8,230340,4
518,cs1511,20150508,2909,2879,0,0,0,2861,2861,-18,-18,0,0,4
519,cs1511,20150511,2861,2861,2899,2899,2822,2870,2854,9,-7,8,228340,4
520,cs1511,20150512,2870,2854,0,0,0,2856,2856,2,2,0,0,4
521,cs1511,20150513,2856,2856,0,0,0,2873,2873,17,17,0,0,4
522,cs1511,20150514,2873,2873,2887,2887,2887,2887,2887,14,14,2,57740,4
523,cs1511,20150515,2887,2887,0,0,0,2898,2898,11,11,0,0,4
524,cs1511,20150518,2898,2898,0,0,0,2894,2894,-4,-4,0,0,4
525,cs1511,20150519,2894,2894,0,0,0,2894,2894,0,0,0,0,4
526,cs1511,20150520,2894,2894,0,0,0,2890,2890,-4,-4,0,0,4
527,cs1511,20150521,2890,2890,0,0,0,2890,2890,0,0,0,0,4
528,cs1511,20150522,2890,2890,0,0,0,2887,2887,-3,-3,0,0,4
529,cs1511,20150525,2887,2887,0,0,0,2865,2865,-22,-22,0,0,4
530,cs1511,20150526,2865,2865,2822,2846,2822,2846,2834,-19,-31,4,113360,2
531,cs1511,20150527,2846,2834,0,0,0,2792,2792,-42,-42,0,0,2
532,cs1511,20150528,2792,2792,0,0,0,2792,2792,0,0,0,0,2
533,cs1511,20150529,2792,2792,0,0,0,2807,2807,15,15,0,0,2
534,cs1511,20150601,2807,2807,2786,2786,2786,2786,2786,-21,-21,4,111440,4
535,cs1511,20150602,2786,2786,0,0,0,2783,2783,-3,-3,0,0,4
536,cs1511,20150603,2783,2783,0,0,0,2783,2783,0,0,0,0,4
537,cs1511,20150604,2783,2783,0,0,0,2758,2758,-25,-25,0,0,4
538,cs1511,20150605,2758,2758,0,0,0,2745,2745,-13,-13,0,0,4
539,cs1511,20150608,2745,2745,0,0,0,2705,2705,-40,-40,0,0,4
540,cs1511,20150609,2705,2705,0,0,0,2733,2733,28,28,0,0,4
541,cs1511,20150610,2733,2733,0,0,0,2722,2722,-11,-11,0,0,4
542,cs1511,20150611,2722,2722,0,0,0,2734,2734,12,12,0,0,4
543,cs1511,20150612,2734,2734,0,0,0,2719,2719,-15,-15,0,0,4
544,cs1511,20150615,2719,2719,0,0,0,2694,2694,-25,-25,0,0,4
545,cs1511,20150616,2694,2694,0,0,0,2711,2711,17,17,0,0,4
546,cs1511,20150617,2711,2711,0,0,0,2730,2730,19,19,0,0,4
547,cs1511,20150618,2730,2730,0,0,0,2738,2738,8,8,0,0,4
548,cs1511,20150619,2738,2738,0,0,0,2732,2732,-6,-6,0,0,4
549,cs1511,20150623,2732,2732,0,0,0,2744,2744,12,12,0,0,4
550,cs1511,20150624,2744,2744,0,0,0,2720,2720,-24,-24,0,0,4
551,cs1511,20150625,2720,2720,2776,2776,2776,2776,2776,56,56,2,55520,2
552,cs1511,20150626,2776,2776,0,0,0,2772,2772,-4,-4,0,0,2
553,cs1511,20150629,2772,2772,0,0,0,2768,2768,-4,-4,0,0,2
554,cs1511,20150630,2768,2768,2759,2759,2692,2692,2725,-76,-43,4,109020,2
555,cs1511,20150701,2692,2725,0,0,0,2751,2751,26,26,0,0,2
556,cs1511,20150702,2751,2751,0,0,0,2732,2732,-19,-19,0,0,2
557,cs1511,20150703,2732,2732,0,0,0,2742,2742,10,10,0,0,2
558,cs1511,20150706,2742,2742,0,0,0,2748,2748,6,6,0,0,2
559,cs1511,20150707,2748,2748,0,0,0,2754,2754,6,6,0,0,2
560,cs1511,20150708,2754,2754,0,0,0,2690,2690,-64,-64,0,0,2
561,cs1511,20150709,2690,2690,0,0,0,2756,2756,66,66,0,0,2
562,cs1511,20150710,2756,2756,0,0,0,2763,2763,7,7,0,0,2
563,cs1511,20150713,2763,2763,0,0,0,2759,2759,-4,-4,0,0,2
564,cs1511,20150714,2759,2759,0,0,0,2749,2749,-10,-10,0,0,2
565,cs1511,20150715,2749,2749,0,0,0,2743,2743,-6,-6,0,0,2
566,cs1511,20150716,2743,2743,0,0,0,2758,2758,15,15,0,0,2
567,cs1511,20150717,2758,2758,0,0,0,2777,2777,19,19,0,0,2
568,cs1511,20150720,2777,2777,0,0,0,2746,2746,-31,-31,0,0,2
569,cs1511,20150721,2746,2746,0,0,0,2731,2731,-15,-15,0,0,2
570,cs1511,20150722,2731,2731,0,0,0,2736,2736,5,5,0,0,2
571,cs1511,20150723,2736,2736,0,0,0,2734,2734,-2,-2,0,0,2
572,cs1511,20150724,2734,2734,0,0,0,2727,2727,-7,-7,0,0,2
573,cs1511,20150727,2727,2727,0,0,0,2687,2687,-40,-40,0,0,2
574,cs1511,20150728,2687,2687,0,0,0,2683,2683,-4,-4,0,0,2
575,cs1511,20150729,2683,2683,0,0,0,2709,2709,26,26,0,0,2
576,cs1511,20150730,2709,2709,0,0,0,2703,2703,-6,-6,0,0,2
577,cs1511,20150731,2703,2703,0,0,0,2695,2695,-8,-8,0,0,2
578,cs1511,20150803,2695,2695,0,0,0,2669,2669,-26,-26,0,0,2
579,cs1511,20150804,2669,2669,0,0,0,2669,2669,0,0,0,0,2
580,cs1511,20150805,2669,2669,0,0,0,2664,2664,-5,-5,0,0,2
581,cs1511,20150806,2664,2664,0,0,0,2664,2664,0,0,0,0,2
582,cs1511,20150807,2664,2664,0,0,0,2663,2663,-1,-1,0,0,2
583,cs1511,20150810,2663,2663,0,0,0,2663,2663,0,0,0,0,2
584,cs1511,20150811,2663,2663,0,0,0,2672,2672,9,9,0,0,2
585,cs1511,20150812,2672,2672,0,0,0,2669,2669,-3,-3,0,0,2
586,cs1511,20150813,2669,2669,0,0,0,2668,2668,-1,-1,0,0,2
587,cs1511,20150814,2668,2668,0,0,0,2668,2668,0,0,0,0,2
588,cs1511,20150817,2668,2668,0,0,0,2668,2668,0,0,0,0,2
589,cs1511,20150818,2668,2668,0,0,0,2668,2668,0,0,0,0,2
590,cs1511,20150819,2668,2668,0,0,0,2668,2668,0,0,0,0,2
591,cs1511,20150820,2668,2668,0,0,0,2676,2676,8,8,0,0,2
592,cs1511,20150821,2676,2676,0,0,0,2676,2676,0,0,0,0,2
593,cs1511,20150824,2676,2676,0,0,0,2664,2664,-12,-12,0,0,2
594,cs1511,20150825,2664,2664,0,0,0,2684,2684,20,20,0,0,2
595,cs1511,20150826,2684,2684,0,0,0,2672,2672,-12,-12,0,0,2
596,cs1511,20150827,2672,2672,0,0,0,2663,2663,-9,-9,0,0,2
597,cs1511,20150828,2663,2663,0,0,0,2663,2663,0,0,0,0,2
598,cs1511,20150831,2663,2663,0,0,0,2624,2624,-39,-39,0,0,2
599,cs1511,20150901,2624,2624,0,0,0,2600,2600,-24,-24,0,0,2
600,cs1511,20150902,2600,2600,0,0,0,2576,2576,-24,-24,0,0,2
601,cs1511,20150907,2576,2576,0,0,0,2594,2594,18,18,0,0,2
602,cs1511,20150908,2594,2594,0,0,0,2540,2540,-54,-54,0,0,2
603,cs1511,20150909,2540,2540,0,0,0,2540,2540,0,0,0,0,2
604,cs1511,20150910,2540,2540,0,0,0,2559,2559,19,19,0,0,2
605,cs1511,20150911,2559,2559,0,0,0,2559,2559,0,0,0,0,2
606,cs1511,20150914,2559,2559,0,0,0,2506,2506,-53,-53,0,0,2
607,cs1511,20150915,2506,2506,0,0,0,2606,2606,100,100,0,0,2
608,cs1511,20150916,2606,2606,0,0,0,2606,2606,0,0,0,0,2
609,cs1511,20150917,2606,2606,0,0,0,2606,2606,0,0,0,0,2
610,cs1511,20150918,2606,2606,0,0,0,2606,2606,0,0,0,0,2
611,cs1511,20150921,2606,2606,0,0,0,2606,2606,0,0,0,0,2
612,cs1511,20150922,2606,2606,2708,2708,2708,2708,2708,102,102,2,54160,2
613,cs1511,20150923,2708,2708,0,0,0,2708,2708,0,0,0,0,2
614,cs1511,20150924,2708,2708,0,0,0,2708,2708,0,0,0,0,2
615,cs1511,20150925,2708,2708,0,0,0,2708,2708,0,0,0,0,2
616,cs1511,20150928,2708,2708,2669,2669,2669,2669,2669,-39,-39,16,427040,18
617,cs1511,20150929,2669,2669,0,0,0,2669,2669,0,0,0,0,18
618,cs1511,20150930,2669,2669,0,0,0,2669,2669,0,0,0,0,18
619,cs1511,20151008,2669,2669,0,0,0,2669,2669,0,0,0,0,18
620,cs1511,20151009,2669,2669,0,0,0,2669,2669,0,0,0,0,18
621,cs1511,20151012,2669,2669,0,0,0,2669,2669,0,0,0,0,18
622,cs1511,20151013,2669,2669,0,0,0,2563,2563,-106,-106,0,0,18
623,cs1511,20151014,2563,2563,0,0,0,2410,2410,-153,-153,0,0,18
624,cs1511,20151015,2410,2410,2240,2518,2218,2218,2270,-192,-140,24,544940,2
625,cs1511,20151016,2218,2270,2327,2327,2180,2180,2253,-90,-17,4,90140,2
626,cs1511,20151019,2180,2253,0,0,0,2253,2253,0,0,0,0,2
627,cs1511,20151020,2253,2253,0,0,0,2253,2253,0,0,0,0,2
628,cs1511,20151021,2253,2253,0,0,0,2253,2253,0,0,0,0,2
629,cs1511,20151022,2253,2253,0,0,0,2253,2253,0,0,0,0,2
630,cs1511,20151023,2253,2253,0,0,0,2253,2253,0,0,0,0,2
631,cs1511,20151026,2253,2253,0,0,0,2253,2253,0,0,0,0,2
632,cs1511,20151027,2253,2253,2163,2163,2163,2163,2163,-90,-90,2,43260,2
633,cs1511,20151028,2163,2163,0,0,0,2077,2077,-86,-86,0,0,2
634,cs1511,20151029,2077,2077,0,0,0,2077,2077,0,0,0,0,2
635,cs1511,20151030,2077,2077,0,0,0,2077,2077,0,0,0,0,2
636,cs1511,20151102,2077,2077,2077,2077,2077,2077,2077,0,0,2,41540,0
637,cs1511,20151103,2077,2077,0,0,0,2077,2077,0,0,0,0,0
638,cs1511,20151104,2077,2077,0,0,0,2077,2077,0,0,0,0,0
639,cs1511,20151105,2077,2077,0,0,0,2077,2077,0,0,0,0,0
640,cs1511,20151106,2077,2077,0,0,0,2077,2077,0,0,0,0,0
641,cs1511,20151109,2077,2077,0,0,0,2077,2077,0,0,0,0,0
642,cs1511,20151110,2077,2077,0,0,0,2077,2077,0,0,0,0,0
643,cs1511,20151111,2077,2077,0,0,0,2077,2077,0,0,0,0,0
644,cs1511,20151112,2077,2077,0,0,0,2077,2077,0,0,0,0,0
645,cs1511,20151113,2077,2077,0,0,0,2077,2077,0,0,0,0,0
646,cs1601,20150119,2813,2813,2800,2800,2674,2707,2743,-106,-70,12,329240,10
647,cs1601,20150120,2707,2743,0,0,0,2743,2743,0,0,0,0,10
648,cs1601,20150121,2743,2743,2756,2756,2676,2711,2721,-32,-22,18,489880,16
649,cs1601,20150122,2711,2721,2720,2720,2720,2720,2720,-1,-1,2,54400,18
650,cs1601,20150123,2720,2720,2756,2756,2697,2697,2726,-23,6,4,109060,20
651,cs1601,20150126,2697,2726,0,0,0,2726,2726,0,0,0,0,20
652,cs1601,20150127,2726,2726,0,0,0,2726,2726,0,0,0,0,20
653,cs1601,20150128,2726,2726,2720,2720,2720,2720,2749,-6,23,8,219940,20
654,cs1601,20150129,2720,2749,2759,2759,2739,2750,2745,1,-4,26,713840,32
655,cs1601,20150130,2750,2745,0,0,0,2745,2745,0,0,0,0,32
656,cs1601,20150202,2745,2745,0,0,0,2745,2745,0,0,0,0,32
657,cs1601,20150203,2745,2745,0,0,0,2745,2745,0,0,0,0,32
658,cs1601,20150204,2745,2745,2764,2766,2692,2716,2735,-29,-10,26,711300,30
659,cs1601,20150205,2716,2735,2731,2755,2731,2741,2748,6,13,84,2309020,96
660,cs1601,20150206,2741,2748,2748,2748,2735,2747,2744,-1,-4,30,823460,110
661,cs1601,20150209,2747,2744,2750,2750,2736,2746,2741,2,-3,76,2083780,142
662,cs1601,20150210,2746,2741,2747,2760,2741,2760,2750,19,9,280,7700020,348
663,cs1601,20150211,2760,2750,2757,2765,2755,2760,2759,10,9,90,2483540,342
664,cs1601,20150212,2760,2759,2750,2763,2750,2754,2757,-5,-2,264,7278880,554
665,cs1601,20150213,2754,2757,2765,2780,2757,2768,2773,11,16,58,1608780,592
666,cs1601,20150216,2768,2773,0,0,0,2773,2773,0,0,0,0,592
667,cs1601,20150217,2773,2773,2741,2758,2741,2752,2752,-21,-21,12,330320,594
668,cs1601,20150225,2752,2752,2743,2743,2737,2737,2740,-15,-12,58,1589340,618
669,cs1601,20150226,2737,2740,2741,2741,2710,2732,2724,-8,-16,130,3541780,732
670,cs1601,20150227,2732,2724,2734,2755,2734,2750,2746,26,22,90,2471440,732
671,cs1601,20150302,2750,2746,2750,2759,2747,2753,2750,7,4,74,2035580,732
672,cs1601,20150303,2753,2750,2741,2743,2734,2741,2737,-9,-13,24,657100,728
673,cs1601,20150304,2741,2737,2747,2767,2747,2755,2758,18,21,78,2151680,740
674,cs1601,20150305,2755,2758,2743,2755,2740,2740,2746,-18,-12,18,494420,742
675,cs1601,20150306,2740,2746,2756,2756,2736,2747,2750,1,4,42,1155220,752
676,cs1601,20150309,2747,2750,2735,2750,2730,2750,2736,0,-14,18,492580,752
677,cs1601,20150310,2750,2736,2753,2770,2753,2766,2764,30,28,28,774060,750
678,cs1601,20150311,2766,2764,2789,2799,2760,2775,2781,11,17,106,2948740,776
679,cs1601,20150312,2775,2781,2760,2773,2758,2769,2763,-12,-18,60,1658300,794
680,cs1601,20150313,2769,2763,2766,2775,2753,2769,2769,6,6,146,4043600,844
681,cs1601,20150316,2769,2769,2782,2783,2764,2774,2774,5,5,64,1775700,856
682,cs1601,20150317,2774,2774,2773,2775,2773,2774,2774,0,0,6,166440,860
683,cs1601,20150318,2774,2774,2765,2770,2755,2755,2762,-19,-12,42,1160040,884
684,cs1601,20150319,2755,2762,2751,2755,2734,2743,2744,-19,-18,110,3018440,968
685,cs1601,20150320,2743,2744,2742,2754,2740,2753,2745,9,1,200,5491340,1130
686,cs1601,20150323,2753,2745,2755,2770,2754,2768,2760,23,15,84,2318700,1136
687,cs1601,20150324,2768,2760,2769,2789,2768,2780,2778,20,18,456,12669780,1182
688,cs1601,20150325,2780,2778,2783,2792,2758,2780,2770,2,-8,408,11302220,1192
689,cs1601,20150326,2780,2770,2779,2794,2772,2786,2786,16,16,636,17721960,1588
690,cs1601,20150327,2786,2786,2793,2798,2769,2792,2784,6,-2,170,4732800,1650
691,cs1601,20150330,2792,2784,2786,2789,2775,2784,2781,0,-3,114,3171080,1648
692,cs1601,20150331,2784,2781,2780,2781,2756,2761,2764,-20,-17,324,8957940,1734
693,cs1601,20150401,2761,2764,2765,2765,2712,2736,2734,-28,-30,536,14658320,1946
694,cs1601,20150402,2736,2734,2739,2755,2725,2731,2745,-3,11,922,25309380,2112
695,cs1601,20150403,2731,2745,2747,2752,2744,2748,2747,3,2,142,3901280,2118
696,cs1601,20150407,2748,2747,2752,2755,2745,2755,2751,8,4,296,8145840,2130
697,cs1601,20150408,2755,2751,2751,2755,2715,2718,2723,-33,-28,398,10837980,2272
698,cs1601,20150409,2718,2723,2715,2725,2693,2711,2713,-12,-10,234,6349380,2236
699,cs1601,20150410,2711,2713,2715,2742,2710,2737,2723,24,10,488,13292500,2222
700,cs1601,20150413,2737,2723,2733,2783,2729,2776,2762,53,39,1222,33753960,2560
701,cs1601,20150414,2776,2762,2777,2788,2754,2760,2773,-2,11,524,14531140,2542
702,cs1601,20150415,2760,2773,2737,2740,2700,2713,2715,-60,-58,380,10318660,2652
703,cs1601,20150416,2713,2715,2725,2740,2717,2737,2728,22,13,160,4365260,2672
704,cs1601,20150417,2737,2728,2731,2746,2725,2746,2735,18,7,160,4377020,2642
705,cs1601,20150420,2746,2735,2737,2737,2727,2730,2729,-5,-6,86,2347380,2706
706,cs1601,20150421,2730,2729,2723,2742,2720,2734,2729,5,0,164,4476160,2750
707,cs1601,20150422,2734,2729,2702,2737,2702,2734,2724,5,-5,160,4359220,2718
708,cs1601,20150423,2734,2724,2746,2747,2733,2735,2742,11,18,244,6691060,2760
709,cs1601,20150424,2735,2742,2728,2739,2721,2729,2728,-13,-14,376,10259240,2818
710,cs1601,20150427,2729,2728,2734,2737,2721,2732,2731,4,3,192,5243840,2786
711,cs1601,20150428,2732,2731,2740,2740,2726,2726,2731,-5,0,706,19286200,3124
712,cs1601,20150429,2726,2731,2727,2732,2709,2722,2719,-9,-12,362,9844260,3238
713,cs1601,20150430,2722,2719,2728,2740,2722,2740,2733,21,14,232,6340680,3286
714,cs1601,20150504,2740,2733,2745,2765,2742,2755,2758,22,25,1048,28913600,3588
715,cs1601,20150505,2755,2758,2750,2755,2747,2750,2749,-8,-9,492,13529460,3632
716,cs1601,20150506,2750,2749,2752,2758,2745,2750,2751,1,2,436,11997640,3812
717,cs1601,20150507,2750,2751,2746,2768,2738,2747,2757,-4,6,1010,27854980,4150
718,cs1601,20150508,2747,2757,2741,2757,2731,2743,2745,-14,-12,554,15211860,4148
719,cs1601,20150511,2743,2745,2750,2752,2740,2745,2746,0,1,280,7691580,4158
720,cs1601,20150512,2745,2746,2740,2758,2739,2756,2750,10,4,356,9790040,4176
721,cs1601,20150513,2756,2750,2763,2775,2750,2750,2760,0,10,668,18441160,4374
722,cs1601,20150514,2750,2760,2750,2762,2746,2755,2753,-5,-7,196,5396020,4376
723,cs1601,20150515,2755,2753,2765,2768,2748,2756,2756,3,3,606,16706720,4614
724,cs1601,20150518,2756,2756,2749,2754,2733,2744,2743,-12,-13,376,10315640,4538
725,cs1601,20150519,2744,2743,2742,2753,2740,2748,2745,5,2,336,9226060,4532
726,cs1601,20150520,2748,2745,2746,2749,2730,2740,2738,-5,-7,592,16209980,4566
727,cs1601,20150521,2740,2738,2743,2743,2724,2732,2731,-6,-7,630,17209200,4588
728,cs1601,20150522,2732,2731,2740,2740,2721,2725,2726,-6,-5,446,12160880,4750
729,cs1601,20150525,2725,2726,2730,2730,2686,2686,2705,-40,-21,1236,33442200,4964
730,cs1601,20150526,2686,2705,2688,2702,2686,2691,2695,-14,-10,1268,34175440,5222
731,cs1601,20150527,2691,2695,2676,2680,2627,2653,2662,-42,-33,1324,35254080,5488
732,cs1601,20150528,2653,2662,2666,2668,2657,2663,2662,1,0,576,15334120,5454
733,cs1601,20150529,2663,2662,2665,2679,2660,2675,2670,13,8,748,19972260,5204
734,cs1601,20150601,2675,2670,2681,2687,2677,2685,2682,15,12,484,12981360,5162
735,cs1601,20150602,2685,2682,2682,2691,2675,2691,2684,9,2,518,13903780,5100
736,cs1601,20150603,2691,2684,2691,2695,2680,2689,2686,5,2,544,14612980,5038
737,cs1601,20150604,2689,2686,2686,2688,2651,2669,2671,-17,-15,3022,80717980,5350
738,cs1601,20150605,2669,2671,2669,2669,2641,2642,2651,-29,-20,1184,31390240,5624
739,cs1601,20150608,2642,2651,2602,2648,2577,2636,2609,-15,-42,4888,127562400,6646
740,cs1601,20150609,2636,2609,2640,2652,2632,2637,2641,28,32,1666,43999580,7008
741,cs1601,20150610,2637,2641,2638,2638,2618,2628,2627,-13,-14,2088,54859460,7386
742,cs1601,20150611,2628,2627,2628,2649,2627,2648,2640,21,13,1202,31734220,7116
743,cs1601,20150612,2648,2640,2638,2653,2631,2648,2638,8,-2,932,24591720,7300
744,cs1601,20150615,2648,2638,2636,2645,2628,2640,2635,2,-3,948,24986120,7484
745,cs1601,20150616,2640,2635,2650,2668,2649,2660,2656,25,21,932,24758220,7744
746,cs1601,20150617,2660,2656,2662,2665,2650,2652,2659,-4,3,804,21381140,8026
747,cs1601,20150618,2652,2659,2650,2660,2645,2649,2653,-10,-6,598,15865900,8122
748,cs1601,20150619,2649,2653,2649,2650,2643,2648,2645,-5,-8,478,12646260,8186
749,cs1601,20150623,2648,2645,2658,2687,2642,2643,2649,-2,4,818,21676300,8412
750,cs1601,20150624,2643,2649,2648,2648,2629,2636,2635,-13,-14,1094,28833960,8432
751,cs1601,20150625,2636,2635,2640,2640,2630,2630,2634,-5,-1,430,11326880,8516
752,cs1601,20150626,2630,2634,2639,2641,2630,2637,2635,3,1,540,14231640,8510
753,cs1601,20150629,2637,2635,2636,2640,2622,2627,2630,-8,-5,854,22467020,8514
754,cs1601,20150630,2627,2630,2617,2629,2607,2622,2622,-8,-8,564,14790960,8430
755,cs1601,20150701,2622,2622,2650,2661,2632,2645,2641,23,19,1038,27422100,8348
756,cs1601,20150702,2645,2641,2646,2649,2631,2645,2641,4,0,1114,29428500,8396
757,cs1601,20150703,2645,2641,2643,2650,2643,2649,2647,8,6,824,21813220,8564
758,cs1601,20150706,2649,2647,2646,2649,2631,2634,2641,-13,-6,958,25303420,8742
759,cs1601,20150707,2634,2641,2635,2643,2581,2600,2616,-41,-25,1602,41909400,9210
760,cs1601,20150708,2600,2616,2560,2600,2520,2571,2551,-45,-65,2608,66537780,8978
761,cs1601,20150709,2571,2551,2586,2635,2585,2604,2610,53,59,4406,115029740,11160
762,cs1601,20150710,2604,2610,2620,2634,2600,2601,2612,-9,2,1666,43530080,12002
763,cs1601,20150713,2601,2612,2601,2620,2591,2591,2599,-21,-13,1222,31762660,12348
764,cs1601,20150714,2591,2599,2600,2610,2550,2571,2571,-28,-28,2594,66704360,13672
765,cs1601,20150715,2571,2571,2572,2572,2536,2553,2554,-18,-17,1934,49398960,14150
766,cs1601,20150716,2553,2554,2550,2573,2505,2558,2546,4,-8,9600,244461460,15274
767,cs1601,20150717,2558,2546,2558,2571,2538,2565,2559,19,13,3986,102004480,16568
768,cs1601,20150720,2565,2559,2550,2566,2550,2557,2554,-2,-5,2312,59065820,15802
769,cs1601,20150721,2557,2554,2561,2566,2534,2539,2542,-15,-12,3316,84325560,16964
770,cs1601,20150722,2539,2542,2540,2545,2528,2536,2536,-6,-6,3918,99364040,18060
771,cs1601,20150723,2536,2536,2536,2541,2522,2530,2529,-6,-7,3490,88291980,18418
772,cs1601,20150724,2530,2529,2529,2532,2490,2490,2506,-39,-23,5852,146686880,19542
773,cs1601,20150727,2490,2506,2480,2486,2424,2442,2443,-64,-63,10246,250411280,22202
774,cs1601,20150728,2442,2443,2443,2453,2425,2438,2437,-5,-6,10194,248525620,24504
775,cs1601,20150729,2438,2437,2439,2454,2439,2448,2446,11,9,5058,123767420,25018
776,cs1601,20150730,2448,2446,2450,2457,2428,2428,2440,-18,-6,7418,181012020,26628
777,cs1601,20150731,2428,2440,2433,2448,2430,2441,2440,1,0,8214,200446520,25714
778,cs1601,20150803,2441,2440,2435,2436,2392,2409,2413,-31,-27,20690,499346840,28260
779,cs1601,20150804,2409,2413,2410,2429,2387,2394,2402,-19,-11,16192,388981180,29016
780,cs1601,20150805,2394,2402,2402,2409,2380,2403,2395,1,-7,14308,342749880,31058
781,cs1601,20150806,2403,2395,2408,2411,2389,2393,2394,-2,-1,7088,169710620,31952
782,cs1601,20150807,2393,2394,2400,2400,2371,2374,2378,-20,-16,9034,214888620,32988
783,cs1601,20150810,2374,2378,2373,2390,2338,2350,2355,-28,-23,29562,696263640,41166
784,cs1601,20150811,2350,2355,2358,2381,2358,2361,2368,6,13,20562,487079620,40434
785,cs1601,20150812,2361,2368,2355,2366,2344,2352,2355,-16,-13,17340,408409360,46058
786,cs1601,20150813,2352,2355,2340,2410,2334,2405,2387,50,32,48152,1149468820,38790
787,cs1601,20150814,2405,2387,2404,2437,2402,2415,2422,28,35,33966,822873160,33942
788,cs1601,20150817,2415,2422,2419,2436,2404,2430,2424,8,2,16734,405695920,34492
789,cs1601,20150818,2430,2424,2427,2448,2407,2420,2420,-4,-4,13478,326168180,34530
790,cs1601,20150819,2420,2420,2428,2428,2395,2402,2405,-18,-15,18974,456444780,35674
791,cs1601,20150820,2402,2405,2401,2413,2375,2379,2394,-26,-11,17438,417630840,36848
792,cs1601,20150821,2379,2394,2381,2391,2363,2372,2377,-22,-17,13322,316727040,37836
793,cs1601,20150824,2372,2377,2365,2372,2345,2367,2360,-10,-17,25742,607759100,35932
794,cs1601,20150825,2367,2360,2370,2415,2370,2395,2391,35,31,30620,732281840,36902
795,cs1601,20150826,2395,2391,2400,2405,2384,2390,2395,-1,4,16864,404048120,38084
796,cs1601,20150827,2390,2395,2393,2395,2361,2375,2374,-20,-21,28318,672279560,41368
797,cs1601,20150828,2375,2374,2389,2407,2374,2375,2391,1,17,27300,652764780,41414
798,cs1601,20150831,2375,2391,2378,2378,2303,2309,2352,-82,-39,35024,823893920,44224
799,cs1601,20150901,2309,2352,2318,2340,2292,2312,2313,-40,-39,37382,864796860,45208
800,cs1601,20150902,2312,2313,2313,2313,2289,2308,2301,-5,-12,33166,763292360,48220
801,cs1601,20150907,2308,2301,2301,2321,2284,2291,2300,-10,-1,37204,855813000,54920
802,cs1601,20150908,2291,2300,2295,2324,2295,2323,2307,23,7,22160,511305360,52884
803,cs1601,20150909,2323,2307,2337,2343,2299,2301,2318,-6,11,39758,921644360,66624
804,cs1601,20150910,2301,2318,2300,2312,2264,2301,2288,-17,-30,81900,1874355880,79166
805,cs1601,20150911,2301,2288,2305,2323,2301,2304,2311,16,23,34206,790772000,79096
806,cs1601,20150914,2304,2311,2309,2316,2278,2282,2288,-29,-23,44248,1012550300,84198
807,cs1601,20150915,2282,2288,2289,2292,2269,2282,2279,-6,-9,35166,801513960,85658
808,cs1601,20150916,2282,2279,2289,2308,2283,2302,2296,23,17,51320,1178809260,85120
809,cs1601,20150917,2302,2296,2308,2310,2280,2289,2292,-7,-4,35002,802252820,84886
810,cs1601,20150918,2289,2292,2290,2295,2244,2252,2263,-40,-29,99692,2256508580,89758
811,cs1601,20150921,2252,2263,2300,2304,2261,2267,2279,4,16,78894,1798399260,83478
812,cs1601,20150922,2267,2279,2269,2273,2233,2239,2248,-40,-31,76178,1712891920,89894
813,cs1601,20150923,2239,2248,2228,2240,2216,2234,2229,-14,-19,73938,1648423260,94030
814,cs1601,20150924,2234,2229,2239,2249,2229,2234,2236,5,7,29916,669199920,91940
815,cs1601,20150925,2234,2236,2232,2245,2224,2228,2234,-8,-2,30298,676882800,97030
816,cs1601,20150928,2228,2234,2227,2235,2219,2229,2229,-5,-5,25588,570454840,93088
817,cs1601,20150929,2229,2229,2227,2227,2188,2192,2200,-37,-29,47366,1042228200,90054
818,cs1601,20150930,2192,2200,2190,2198,2143,2145,2161,-55,-39,63752,1377946580,89764
819,cs1601,20151008,2145,2161,2145,2145,2037,2041,2065,-120,-96,168204,3474676500,100424
820,cs1601,20151009,2041,2065,2042,2090,2037,2065,2067,0,2,170228,3519137020,96170
821,cs1601,20151012,2065,2067,2070,2086,2037,2048,2054,-19,-13,104436,2145919620,100508
822,cs1601,20151013,2048,2054,2052,2052,1983,1999,1999,-55,-55,273952,5478273460,139320
823,cs1601,20151014,1999,1999,1980,2009,1966,1979,1987,-20,-12,307042,6103804400,163424
824,cs1601,20151015,1979,1987,1979,2000,1971,1980,1989,-7,2,193130,3841731060,159558
825,cs1601,20151016,1980,1989,1988,1989,1961,1981,1974,-8,-15,219190,4327976660,158146
826,cs1601,20151019,1981,1974,1980,1984,1946,1948,1969,-26,-5,224298,4418319960,188280
827,cs1601,20151020,1948,1969,1950,1965,1941,1953,1953,-16,-16,178186,3481250540,175566
828,cs1601,20151021,1953,1953,1953,1973,1946,1952,1957,-1,4,138044,2702559020,172900
829,cs1601,20151022,1952,1957,1958,1964,1903,1914,1923,-43,-34,413896,7959842060,213386
830,cs1601,20151023,1914,1923,1910,1926,1890,1919,1909,-4,-14,297504,5681390040,214108
831,cs1601,20151026,1919,1909,1918,1963,1916,1947,1945,38,36,390200,7592518280,209006
832,cs1601,20151027,1947,1945,1947,1992,1940,1985,1970,40,25,360684,7105946220,216482
833,cs1601,20151028,1985,1970,1985,1985,1943,1944,1957,-26,-13,295810,5789892940,223148
834,cs1601,20151029,1944,1957,1946,1980,1937,1970,1962,13,5,356126,6987291040,217354
835,cs1601,20151030,1970,1962,1967,1991,1952,1963,1972,1,10,380236,7498867680,213868
836,cs1601,20151102,1963,1972,1977,1982,1965,1976,1974,4,2,207030,4088453360,216308
837,cs1601,20151103,1976,1974,1971,2004,1965,1990,1988,16,14,372512,7408059620,188994
838,cs1601,20151104,1990,1988,1997,2032,1992,2023,2019,35,31,340662,6879945140,156880
839,cs1601,20151105,2023,2019,2015,2047,2015,2042,2036,23,17,280308,5708238080,160092
840,cs1601,20151106,2042,2036,2042,2087,2023,2081,2057,45,21,410764,8450791380,211306
841,cs1601,20151109,2081,2057,2085,2117,2059,2097,2089,40,32,743814,15538770940,228186
842,cs1601,20151110,2097,2089,2091,2103,2066,2085,2084,-4,-5,619364,12911250380,231834
843,cs1601,20151111,2085,2084,2082,2116,2077,2116,2097,32,13,543008,11387989400,253466
844,cs1601,20151112,2116,2097,2117,2180,2116,2180,2152,83,55,1008772,21711349940,268264
845,cs1601,20151113,2180,2152,2199,2222,2184,2220,2201,68,49,659276,14515315260,207130
846,cs1601,20151116,2220,2201,2217,2219,2186,2212,2203,11,2,611624,13477365000,206586
847,cs1601,20151117,2212,2203,2216,2217,2179,2205,2195,2,-8,441506,9692629260,183564
848,cs1601,20151118,2205,2195,2210,2215,2179,2196,2195,1,0,342690,7522269080,188834
849,cs1601,20151119,2196,2195,2191,2193,2160,2184,2176,-11,-19,293108,6378273700,170374
850,cs1601,20151120,2184,2176,2195,2237,2175,2198,2200,22,24,470214,10346075880,140244
851,cs1601,20151123,2198,2200,2207,2238,2195,2223,2217,23,17,270388,5995053780,133690
852,cs1601,20151124,2223,2217,2235,2295,2224,2235,2250,18,33,314162,7071191600,111110
853,cs1601,20151125,2235,2250,2247,2268,2212,2268,2241,18,-9,201920,4525512060,103138
854,cs1601,20151126,2268,2241,2270,2285,2256,2257,2269,16,28,124500,2825534360,92800
855,cs1601,20151127,2257,2269,2262,2298,2248,2289,2278,20,9,115754,2637937980,89714
856,cs1601,20151130,2289,2278,2279,2295,2270,2280,2279,2,1,84756,1931614680,89986
857,cs1601,20151201,2280,2279,2288,2288,2254,2259,2263,-20,-16,58258,1318669220,85790
858,cs1601,20151202,2259,2263,2260,2270,2253,2261,2261,-2,-2,28192,637495880,80602
859,cs1601,20151203,2261,2261,2258,2270,2253,2264,2262,3,1,17634,398940640,78998
860,cs1601,20151204,2264,2262,2258,2262,2206,2217,2223,-45,-39,96284,2141224060,73422
861,cs1601,20151207,2217,2223,2216,2234,2180,2192,2201,-31,-22,63414,1395796520,57414
862,cs1601,20151208,2192,2201,2188,2207,2169,2190,2188,-11,-13,47582,1041504940,47044
863,cs1601,20151209,2190,2188,2182,2195,2171,2182,2180,-6,-8,24924,543558500,42366
864,cs1601,20151210,2182,2180,2187,2209,2180,2208,2195,28,15,24258,532527680,43454
865,cs1601,20151211,2208,2195,2212,2213,2165,2211,2200,16,5,21554,474311300,45256
866,cs1601,20151214,2211,2200,2206,2227,2205,2223,2216,23,16,11596,257072300,43780
867,cs1601,20151215,2223,2216,2222,2256,2222,2248,2241,32,25,20684,463570740,35766
868,cs1601,20151216,2248,2241,2248,2271,2247,2269,2260,28,19,15846,358191500,39242
869,cs1601,20151217,2269,2260,2270,2304,2265,2304,2291,44,31,14716,337219460,41582
870,cs1601,20151218,2304,2291,2300,2310,2285,2298,2299,7,8,19384,445644460,43428
871,cs1601,20151221,2298,2299,2295,2301,2289,2298,2296,-1,-3,13896,319179920,42986
872,cs1601,20151222,2298,2296,2300,2313,2244,2255,2292,-41,-4,21816,500049540,41190
873,cs1601,20151223,2255,2292,2255,2261,2248,2255,2255,-37,-37,9258,208837460,37116
874,cs1601,20151224,2255,2255,2255,2263,2248,2255,2256,0,1,6030,136046160,36100
875,cs1601,20151225,2255,2256,2255,2284,2252,2256,2263,0,7,4214,95386580,34504
876,cs1601,20151228,2256,2263,2255,2260,2188,2218,2225,-45,-38,10050,223631980,28988
877,cs1601,20151229,2218,2225,2222,2266,2222,2252,2252,27,27,2350,52936300,28108
878,cs1601,20151230,2252,2252,2252,2267,2251,2261,2263,9,11,5632,127473040,25440
879,cs1601,20151231,2261,2263,2263,2280,2237,2239,2267,-24,4,16016,363099500,22734
880,cs1603,20150316,2769,2769,0,0,0,2769,2769,0,0,0,0,0
881,cs1603,20150317,2769,2769,0,0,0,2769,2769,0,0,0,0,0
882,cs1603,20150318,2769,2769,0,0,0,2769,2769,0,0,0,0,0
883,cs1603,20150319,2769,2769,2712,2843,2712,2843,2777,74,8,4,111100,2
884,cs1603,20150320,2843,2777,0,0,0,2777,2777,0,0,0,0,2
885,cs1603,20150323,2777,2777,0,0,0,2777,2777,0,0,0,0,2
886,cs1603,20150324,2777,2777,0,0,0,2777,2777,0,0,0,0,2
887,cs1603,20150325,2777,2777,2799,2799,2799,2799,2799,22,22,2,55980,2
888,cs1603,20150326,2799,2799,0,0,0,2799,2799,0,0,0,0,2
889,cs1603,20150327,2799,2799,0,0,0,2799,2799,0,0,0,0,2
890,cs1603,20150330,2799,2799,2703,2703,2703,2703,2703,-96,-96,2,54060,0
891,cs1603,20150331,2703,2703,0,0,0,2712,2712,9,9,0,0,0
892,cs1603,20150401,2712,2712,0,0,0,2712,2712,0,0,0,0,0
893,cs1603,20150402,2712,2712,0,0,0,2712,2712,0,0,0,0,0
894,cs1603,20150403,2712,2712,0,0,0,2712,2712,0,0,0,0,0
895,cs1603,20150407,2712,2712,2794,2798,2632,2710,2719,-2,7,46,1250960,6
896,cs1603,20150408,2710,2719,2691,2691,2691,2691,2691,-28,-28,2,53820,6
897,cs1603,20150409,2691,2691,2697,2697,2697,2697,2697,6,6,2,53940,4
898,cs1603,20150410,2697,2697,0,0,0,2697,2697,0,0,0,0,4
899,cs1603,20150413,2697,2697,2781,2781,2781,2781,2781,84,84,2,55620,4
900,cs1603,20150414,2781,2781,0,0,0,2781,2781,0,0,0,0,4
901,cs1603,20150415,2781,2781,0,0,0,2723,2723,-58,-58,0,0,4
902,cs1603,20150416,2723,2723,2685,2685,2685,2685,2685,-38,-38,4,107400,8
903,cs1603,20150417,2685,2685,2782,2782,2782,2782,2782,97,97,4,111280,4
904,cs1603,20150420,2782,2782,0,0,0,2782,2782,0,0,0,0,4
905,cs1603,20150421,2782,2782,0,0,0,2761,2761,-21,-21,0,0,4
906,cs1603,20150422,2761,2761,0,0,0,2761,2761,0,0,0,0,4
907,cs1603,20150423,2761,2761,0,0,0,2761,2761,0,0,0,0,4
908,cs1603,20150424,2761,2761,0,0,0,2761,2761,0,0,0,0,4
909,cs1603,20150427,2761,2761,0,0,0,2761,2761,0,0,0,0,4
910,cs1603,20150428,2761,2761,0,0,0,2757,2757,-4,-4,0,0,4
911,cs1603,20150429,2757,2757,2751,2754,2751,2754,2752,-3,-5,4,110100,8
912,cs1603,20150430,2754,2752,0,0,0,2752,2752,0,0,0,0,8
913,cs1603,20150504,2752,2752,2765,2765,2765,2765,2765,13,13,2,55300,6
914,cs1603,20150505,2765,2765,2712,2782,2712,2782,2723,17,-42,14,381240,20
915,cs1603,20150506,2782,2723,2779,2779,2779,2779,2779,56,56,10,277900,30
916,cs1603,20150507,2779,2779,2746,2829,2746,2781,2792,2,13,54,1508140,28
917,cs1603,20150508,2781,2792,0,0,0,2792,2792,0,0,0,0,28
918,cs1603,20150511,2792,2792,2811,2811,2758,2774,2778,-18,-14,100,2778220,38
919,cs1603,20150512,2774,2778,0,0,0,2778,2778,0,0,0,0,38
920,cs1603,20150513,2778,2778,2772,2777,2772,2777,2774,-1,-4,8,221940,38
921,cs1603,20150514,2777,2774,2772,2772,2772,2772,2772,-2,-2,2,55440,36
922,cs1603,20150515,2772,2772,2782,2786,2782,2786,2784,14,12,4,111360,38
923,cs1603,20150518,2786,2784,2797,2797,2783,2783,2790,-1,6,4,111600,36
924,cs1603,20150519,2783,2790,0,0,0,2792,2792,2,2,0,0,36
925,cs1603,20150520,2792,2792,0,0,0,2785,2785,-7,-7,0,0,36
926,cs1603,20150521,2785,2785,0,0,0,2778,2778,-7,-7,0,0,36
927,cs1603,20150522,2778,2778,0,0,0,2773,2773,-5,-5,0,0,36
928,cs1603,20150525,2773,2773,2747,2747,2747,2747,2747,-26,-26,6,164820,34
929,cs1603,20150526,2747,2747,0,0,0,2747,2747,0,0,0,0,34
930,cs1603,20150527,2747,2747,2693,2702,2670,2689,2690,-58,-57,32,861080,24
931,cs1603,20150528,2689,2690,0,0,0,2690,2690,0,0,0,0,24
932,cs1603,20150529,2690,2690,0,0,0,2698,2698,8,8,0,0,24
933,cs1603,20150601,2698,2698,0,0,0,2698,2698,0,0,0,0,24
934,cs1603,20150602,2698,2698,2734,2735,2734,2735,2734,37,36,10,273420,20
935,cs1603,20150603,2735,2734,0,0,0,2736,2736,2,2,0,0,20
936,cs1603,20150604,2736,2736,2735,2735,2734,2734,2734,-2,-2,6,164080,20
937,cs1603,20150605,2734,2734,2730,2739,2730,2739,2733,5,-1,6,164000,20
938,cs1603,20150608,2739,2733,2677,2709,2677,2709,2693,-24,-40,4,107720,20
939,cs1603,20150609,2709,2693,0,0,0,2712,2712,19,19,0,0,20
940,cs1603,20150610,2712,2712,0,0,0,2712,2712,0,0,0,0,20
941,cs1603,20150611,2712,2712,0,0,0,2716,2716,4,4,0,0,20
942,cs1603,20150612,2716,2716,0,0,0,2716,2716,0,0,0,0,20
943,cs1603,20150615,2716,2716,0,0,0,2716,2716,0,0,0,0,20
944,cs1603,20150616,2716,2716,2722,2722,2722,2722,2722,6,6,2,54440,20
945,cs1603,20150617,2722,2722,0,0,0,2722,2722,0,0,0,0,20
946,cs1603,20150618,2722,2722,0,0,0,2722,2722,0,0,0,0,20
947,cs1603,20150619,2722,2722,0,0,0,2714,2714,-8,-8,0,0,20
948,cs1603,20150623,2714,2714,0,0,0,2714,2714,0,0,0,0,20
949,cs1603,20150624,2714,2714,0,0,0,2714,2714,0,0,0,0,20
950,cs1603,20150625,2714,2714,0,0,0,2714,2714,0,0,0,0,20
951,cs1603,20150626,2714,2714,0,0,0,2714,2714,0,0,0,0,20
952,cs1603,20150629,2714,2714,0,0,0,2714,2714,0,0,0,0,20
953,cs1603,20150630,2714,2714,0,0,0,2714,2714,0,0,0,0,20
954,cs1603,20150701,2714,2714,0,0,0,2714,2714,0,0,0,0,20
955,cs1603,20150702,2714,2714,0,0,0,2714,2714,0,0,0,0,20
956,cs1603,20150703,2714,2714,0,0,0,2717,2717,3,3,0,0,20
957,cs1603,20150706,2717,2717,0,0,0,2717,2717,0,0,0,0,20
958,cs1603,20150707,2717,2717,0,0,0,2717,2717,0,0,0,0,20
959,cs1603,20150708,2717,2717,2637,2637,2637,2637,2637,-80,-80,2,52740,18
960,cs1603,20150709,2637,2637,2650,2650,2650,2650,2650,13,13,2,53000,16
961,cs1603,20150710,2650,2650,0,0,0,2652,2652,2,2,0,0,16
962,cs1603,20150713,2652,2652,2711,2711,2655,2668,2683,16,31,8,214680,16
963,cs1603,20150714,2668,2683,0,0,0,2655,2655,-28,-28,0,0,16
964,cs1603,20150715,2655,2655,0,0,0,2638,2638,-17,-17,0,0,16
965,cs1603,20150716,2638,2638,0,0,0,2638,2638,0,0,0,0,16
966,cs1603,20150717,2638,2638,0,0,0,2651,2651,13,13,0,0,16
967,cs1603,20150720,2651,2651,0,0,0,2651,2651,0,0,0,0,16
968,cs1603,20150721,2651,2651,0,0,0,2649,2649,-2,-2,0,0,16
969,cs1603,20150722,2649,2649,0,0,0,2649,2649,0,0,0,0,16
970,cs1603,20150723,2649,2649,0,0,0,2649,2649,0,0,0,0,16
971,cs1603,20150724,2649,2649,2599,2599,2544,2544,2570,-105,-79,16,411320,20
972,cs1603,20150727,2544,2570,2495,2496,2495,2496,2495,-74,-75,6,149740,18
973,cs1603,20150728,2496,2495,2519,2519,2519,2519,2519,24,24,2,50380,18
974,cs1603,20150729,2519,2519,2519,2522,2519,2522,2520,3,1,6,151200,16
975,cs1603,20150730,2522,2520,2521,2521,2521,2521,2521,1,1,2,50420,16
976,cs1603,20150731,2521,2521,2445,2445,2445,2445,2445,-76,-76,2,48900,14
977,cs1603,20150803,2445,2445,0,0,0,2445,2445,0,0,0,0,14
978,cs1603,20150804,2445,2445,0,0,0,2445,2445,0,0,0,0,14
979,cs1603,20150805,2445,2445,0,0,0,2445,2445,0,0,0,0,14
980,cs1603,20150806,2445,2445,0,0,0,2445,2445,0,0,0,0,14
981,cs1603,20150807,2445,2445,0,0,0,2445,2445,0,0,0,0,14
982,cs1603,20150810,2445,2445,2445,2445,2434,2434,2439,-11,-6,4,97580,16
983,cs1603,20150811,2434,2439,2455,2455,2428,2455,2446,16,7,6,146760,14
984,cs1603,20150812,2455,2446,0,0,0,2446,2446,0,0,0,0,14
985,cs1603,20150813,2446,2446,0,0,0,2479,2479,33,33,0,0,14
986,cs1603,20150814,2479,2479,0,0,0,2515,2515,36,36,0,0,14
987,cs1603,20150817,2515,2515,2483,2483,2483,2483,2483,-32,-32,2,49660,14
988,cs1603,20150818,2483,2483,0,0,0,2479,2479,-4,-4,0,0,14
989,cs1603,20150819,2479,2479,2419,2419,2419,2419,2419,-60,-60,4,96760,14
990,cs1603,20150820,2419,2419,2439,2440,2412,2412,2432,-7,13,8,194620,18
991,cs1603,20150821,2412,2432,2450,2450,2450,2450,2450,18,18,2,49000,18
992,cs1603,20150824,2450,2450,0,0,0,2433,2433,-17,-17,0,0,18
993,cs1603,20150825,2433,2433,0,0,0,2433,2433,0,0,0,0,18
994,cs1603,20150826,2433,2433,0,0,0,2437,2437,4,4,0,0,18
995,cs1603,20150827,2437,2437,0,0,0,2416,2416,-21,-21,0,0,18
996,cs1603,20150828,2416,2416,0,0,0,2433,2433,17,17,0,0,18
997,cs1603,20150831,2433,2433,0,0,0,2394,2394,-39,-39,0,0,18
998,cs1603,20150901,2394,2394,2355,2355,2299,2299,2307,-95,-87,14,322980,12
999,cs1603,20150902,2299,2307,0,0,0,2296,2296,-11,-11,0,0,12
1000,cs1603,20150907,2296,2296,0,0,0,2296,2296,0,0,0,0,12
1001,cs1603,20150908,2296,2296,2319,2319,2292,2292,2310,-4,14,6,138600,10
1002,cs1603,20150909,2292,2310,2400,2400,2308,2329,2391,19,81,50,1195660,52
1003,cs1603,20150910,2329,2391,2328,2343,2324,2324,2334,-67,-57,8,186760,56
1004,cs1603,20150911,2324,2334,2342,2342,2342,2342,2342,8,8,2,46840,54
1005,cs1603,20150914,2342,2342,0,0,0,2327,2327,-15,-15,0,0,54
1006,cs1603,20150915,2327,2327,2302,2302,2296,2296,2299,-31,-28,12,275960,54
1007,cs1603,20150916,2296,2299,2315,2335,2314,2319,2319,20,20,10,231960,52
1008,cs1603,20150917,2319,2319,0,0,0,2319,2319,0,0,0,0,52
1009,cs1603,20150918,2319,2319,2314,2314,2314,2314,2314,-5,-5,2,46280,52
1010,cs1603,20150921,2314,2314,2309,2309,2309,2309,2309,-5,-5,4,92360,54
1011,cs1603,20150922,2309,2309,2269,2269,2269,2269,2269,-40,-40,2,45380,56
1012,cs1603,20150923,2269,2269,0,0,0,2269,2269,0,0,0,0,56
1013,cs1603,20150924,2269,2269,0,0,0,2269,2269,0,0,0,0,56
1014,cs1603,20150925,2269,2269,0,0,0,2269,2269,0,0,0,0,56
1015,cs1603,20150928,2269,2269,0,0,0,2269,2269,0,0,0,0,56
1016,cs1603,20150929,2269,2269,0,0,0,2240,2240,-29,-29,0,0,56
1017,cs1603,20150930,2240,2240,2173,2180,2111,2130,2141,-110,-99,10,214100,58
1018,cs1603,20151008,2130,2141,2139,2139,2018,2092,2081,-49,-60,46,957420,50
1019,cs1603,20151009,2092,2081,2118,2149,2114,2114,2126,33,45,10,212680,50
1020,cs1603,20151012,2114,2126,2110,2115,2100,2110,2108,-16,-18,12,253060,50
1021,cs1603,20151013,2110,2108,2094,2098,2027,2051,2043,-57,-65,52,1062660,48
1022,cs1603,20151014,2051,2043,2049,2049,2021,2021,2032,-22,-11,16,325140,52
1023,cs1603,20151015,2021,2032,1993,2024,1993,2024,2013,-8,-19,6,120780,50
1024,cs1603,20151016,2024,2013,2000,2018,1990,2018,2002,5,-11,18,360360,50
1025,cs1603,20151019,2018,2002,2012,2017,1990,1990,2004,-12,2,10,200400,52
1026,cs1603,20151020,1990,2004,2056,2056,1961,1995,1997,-9,-7,10,199760,50
1027,cs1603,20151021,1995,1997,0,0,0,1997,1997,0,0,0,0,50
1028,cs1603,20151022,1997,1997,1968,1975,1965,1965,1968,-32,-29,16,314900,50
1029,cs1603,20151023,1965,1968,1986,1986,1965,1982,1977,14,9,6,118660,50
1030,cs1603,20151026,1982,1977,2014,2017,2007,2008,2012,31,35,12,241440,50
1031,cs1603,20151027,2008,2012,2020,2030,2020,2030,2025,18,13,4,81000,50
1032,cs1603,20151028,2030,2025,2020,2020,2006,2006,2018,-19,-7,44,888300,50
1033,cs1603,20151029,2006,2018,2016,2016,2016,2016,2016,-2,-2,2,40320,50
1034,cs1603,20151030,2016,2016,2021,2021,1970,1998,1987,-18,-29,22,437280,48
1035,cs1603,20151102,1998,1987,2005,2005,2002,2002,2003,15,16,4,80140,48
1036,cs1603,20151103,2002,2003,2025,2025,2025,2025,2025,22,22,4,81000,48
1037,cs1603,20151104,2025,2025,2038,2106,2038,2058,2075,33,50,86,1785320,50
1038,cs1603,20151105,2058,2075,2071,2100,2024,2098,2093,23,18,50,1046800,88
1039,cs1603,20151106,2098,2093,2077,2121,2072,2120,2100,27,7,24,504140,88
1040,cs1603,20151109,2120,2100,2126,2149,2115,2136,2133,36,33,36,768220,94
1041,cs1603,20151110,2136,2133,2138,2138,2094,2108,2116,-25,-17,126,2666500,46
1042,cs1603,20151111,2108,2116,0,0,0,2114,2114,-2,-2,0,0,46
1043,cs1603,20151112,2114,2114,2134,2172,2121,2172,2154,58,40,26,560280,56
1044,cs1603,20151113,2172,2154,2162,2206,2162,2206,2192,52,38,10,219240,52
1045,cs1603,20151116,2206,2192,2190,2246,2186,2188,2203,-4,11,24,528840,58
1046,cs1603,20151117,2188,2203,2189,2208,2188,2208,2192,5,-11,10,219240,52
1047,cs1603,20151118,2208,2192,2229,2229,2180,2180,2203,-12,11,6,132200,54
1048,cs1603,20151119,2180,2203,2245,2245,2245,2245,2245,42,42,2,44900,54
1049,cs1603,20151120,2245,2245,2212,2224,2210,2210,2212,-35,-33,14,309780,52
1050,cs1603,20151123,2210,2212,0,0,0,2212,2212,0,0,0,0,52
1051,cs1603,20151124,2212,2212,2277,2277,2250,2250,2263,38,51,4,90540,52
1052,cs1603,20151125,2250,2263,0,0,0,2263,2263,0,0,0,0,52
1053,cs1603,20151126,2263,2263,2269,2269,2260,2260,2264,-3,1,4,90580,52
1054,cs1603,20151127,2260,2264,0,0,0,2283,2283,19,19,0,0,52
1055,cs1603,20151130,2283,2283,0,0,0,2283,2283,0,0,0,0,52
1056,cs1603,20151201,2283,2283,0,0,0,2283,2283,0,0,0,0,52
1057,cs1603,20151202,2283,2283,0,0,0,2283,2283,0,0,0,0,52
1058,cs1603,20151203,2283,2283,0,0,0,2283,2283,0,0,0,0,52
1059,cs1603,20151204,2283,2283,0,0,0,2275,2275,-8,-8,0,0,52
1060,cs1603,20151207,2275,2275,0,0,0,2253,2253,-22,-22,0,0,52
1061,cs1603,20151208,2253,2253,2200,2200,2166,2166,2191,-87,-62,8,175320,48
1062,cs1603,20151209,2166,2191,0,0,0,2191,2191,0,0,0,0,48
1063,cs1603,20151210,2191,2191,0,0,0,2191,2191,0,0,0,0,48
1064,cs1603,20151211,2191,2191,0,0,0,2191,2191,0,0,0,0,48
1065,cs1603,20151214,2191,2191,2123,2251,2123,2149,2157,-42,-34,12,258940,50
1066,cs1603,20151215,2149,2157,0,0,0,2167,2167,10,10,0,0,50
1067,cs1603,20151216,2167,2167,2145,2199,2145,2168,2170,1,3,6,130240,50
1068,cs1603,20151217,2168,2170,2220,2220,2170,2170,2196,0,26,6,131800,50
1069,cs1603,20151218,2170,2196,0,0,0,2196,2196,0,0,0,0,50
1070,cs1603,20151221,2196,2196,2172,2172,2170,2170,2171,-26,-25,6,130260,46
1071,cs1603,20151222,2170,2171,0,0,0,2171,2171,0,0,0,0,46
1072,cs1603,20151223,2171,2171,2140,2202,2110,2164,2161,-7,-10,28,605120,46
1073,cs1603,20151224,2164,2161,0,0,0,2161,2161,0,0,0,0,46
1074,cs1603,20151225,2161,2161,2081,2109,2081,2109,2083,-52,-78,20,416760,64
1075,cs1603,20151228,2109,2083,2080,2080,2050,2050,2065,-33,-18,4,82600,60
1076,cs1603,20151229,2050,2065,2056,2139,2056,2123,2099,58,34,136,2855940,62
1077,cs1603,20151230,2123,2099,2180,2180,2180,2180,2180,81,81,2,43600,60
1078,cs1603,20151231,2180,2180,2192,2245,2192,2229,2202,49,22,54,1189540,66
1079,cs1605,20150518,2754,2754,2827,2831,2811,2831,2825,77,71,12,339080,8
1080,cs1605,20150519,2831,2825,0,0,0,2825,2825,0,0,0,0,8
1081,cs1605,20150520,2825,2825,0,0,0,2825,2825,0,0,0,0,8
1082,cs1605,20150521,2825,2825,0,0,0,2825,2825,0,0,0,0,8
1083,cs1605,20150522,2825,2825,0,0,0,2825,2825,0,0,0,0,8
1084,cs1605,20150525,2825,2825,2808,2808,2807,2807,2807,-18,-18,28,786060,34
1085,cs1605,20150526,2807,2807,2803,2808,2797,2798,2799,-9,-8,20,559880,40
1086,cs1605,20150527,2798,2799,2798,2798,2773,2773,2777,-26,-22,36,999860,48
1087,cs1605,20150528,2773,2777,2775,2775,2760,2774,2771,-3,-6,10,277180,46
1088,cs1605,20150529,2774,2771,2779,2779,2771,2777,2776,6,5,16,444280,42
1089,cs1605,20150601,2777,2776,2776,2776,2776,2776,2776,0,0,2,55520,42
1090,cs1605,20150602,2776,2776,2776,2782,2776,2782,2781,6,5,12,333720,40
1091,cs1605,20150603,2782,2781,2767,2767,2767,2767,2767,-14,-14,2,55340,38
1092,cs1605,20150604,2767,2767,2734,2752,2734,2752,2747,-15,-20,8,219800,42
1093,cs1605,20150605,2752,2747,2720,2734,2717,2717,2728,-30,-19,14,381920,46
1094,cs1605,20150608,2717,2728,2677,2716,2677,2716,2703,-12,-25,8,216260,50
1095,cs1605,20150609,2716,2703,2748,2748,2719,2719,2729,16,26,6,163740,50
1096,cs1605,20150610,2719,2729,2724,2724,2701,2709,2709,-20,-20,10,270900,54
1097,cs1605,20150611,2709,2709,2708,2723,2708,2723,2715,14,6,4,108620,56
1098,cs1605,20150612,2723,2715,2723,2723,2708,2708,2715,-7,0,4,108620,56
1099,cs1605,20150615,2708,2715,2708,2708,2708,2708,2708,-7,-7,2,54160,56
1100,cs1605,20150616,2708,2708,2703,2703,2698,2698,2700,-10,-8,4,108020,58
1101,cs1605,20150617,2698,2700,2721,2731,2721,2723,2724,23,24,14,381420,68
1102,cs1605,20150618,2723,2724,0,0,0,2724,2724,0,0,0,0,68
1103,cs1605,20150619,2724,2724,0,0,0,2724,2724,0,0,0,0,68
1104,cs1605,20150623,2724,2724,0,0,0,2724,2724,0,0,0,0,68
1105,cs1605,20150624,2724,2724,0,0,0,2724,2724,0,0,0,0,68
1106,cs1605,20150625,2724,2724,2716,2717,2699,2699,2711,-25,-13,8,216940,72
1107,cs1605,20150626,2699,2711,0,0,0,2711,2711,0,0,0,0,72
1108,cs1605,20150629,2711,2711,0,0,0,2711,2711,0,0,0,0,72
1109,cs1605,20150630,2711,2711,2695,2695,2681,2689,2689,-22,-22,18,484040,84
1110,cs1605,20150701,2689,2689,2702,2702,2702,2702,2702,13,13,2,54040,82
1111,cs1605,20150702,2702,2702,2702,2702,2702,2702,2702,0,0,2,54040,84
1112,cs1605,20150703,2702,2702,2719,2719,2703,2703,2711,1,9,4,108440,84
1113,cs1605,20150706,2703,2711,2706,2706,2706,2706,2706,-5,-5,2,54120,84
1114,cs1605,20150707,2706,2706,2682,2682,2679,2679,2680,-27,-26,12,321660,92
1115,cs1605,20150708,2679,2680,2661,2661,2576,2576,2612,-104,-68,74,1933180,116
1116,cs1605,20150709,2576,2612,2623,2655,2613,2641,2633,29,21,34,895420,116
1117,cs1605,20150710,2641,2633,2655,2656,2644,2644,2652,11,19,8,212220,110
1118,cs1605,20150713,2644,2652,2630,2635,2620,2620,2630,-32,-22,10,263060,108
1119,cs1605,20150714,2620,2630,2600,2600,2582,2597,2595,-33,-35,26,674740,110
1120,cs1605,20150715,2597,2595,2588,2588,2588,2588,2588,-7,-7,4,103520,106
1121,cs1605,20150716,2588,2588,2594,2614,2594,2614,2603,26,15,18,468600,102
1122,cs1605,20150717,2614,2603,2606,2606,2599,2600,2600,-3,-3,20,520080,104
1123,cs1605,20150720,2600,2600,2595,2595,2595,2595,2595,-5,-5,2,51900,104
1124,cs1605,20150721,2595,2595,2591,2591,2590,2590,2590,-5,-5,4,103620,102
1125,cs1605,20150722,2590,2590,2599,2614,2599,2614,2605,24,15,6,156340,108
1126,cs1605,20150723,2614,2605,2583,2583,2580,2581,2581,-24,-24,18,464640,116
1127,cs1605,20150724,2581,2581,2541,2541,2523,2523,2528,-58,-53,26,657520,124
1128,cs1605,20150727,2523,2528,2488,2508,2430,2444,2447,-84,-81,102,2496620,184
1129,cs1605,20150728,2444,2447,2429,2439,2417,2417,2432,-30,-15,142,3454160,254
1130,cs1605,20150729,2417,2432,2430,2446,2421,2441,2434,9,2,202,4918340,354
1131,cs1605,20150730,2441,2434,2436,2446,2430,2430,2436,-4,2,158,3848880,456
1132,cs1605,20150731,2430,2436,2430,2436,2396,2410,2420,-26,-16,2000,48400880,1510
1133,cs1605,20150803,2410,2420,2393,2406,2365,2379,2386,-41,-34,672,16037080,1702
1134,cs1605,20150804,2379,2386,2379,2399,2370,2376,2380,-10,-6,712,16947440,1652
1135,cs1605,20150805,2376,2380,2375,2392,2375,2384,2382,4,2,148,3525740,1664
1136,cs1605,20150806,2384,2382,2382,2386,2374,2374,2378,-8,-4,210,4995680,1568
1137,cs1605,20150807,2374,2378,2366,2400,2350,2362,2364,-16,-14,324,7660160,1610
1138,cs1605,20150810,2362,2364,2398,2398,2322,2325,2336,-39,-28,1296,30282520,2284
1139,cs1605,20150811,2325,2336,2328,2371,2328,2357,2354,21,18,1336,31455840,2308
1140,cs1605,20150812,2357,2354,2350,2366,2340,2363,2355,9,1,928,21863480,2652
1141,cs1605,20150813,2363,2355,2358,2449,2330,2447,2416,92,61,2162,52240760,2502
1142,cs1605,20150814,2447,2416,2449,2467,2425,2431,2449,15,33,1826,44724740,2476
1143,cs1605,20150817,2431,2449,2422,2440,2422,2440,2433,-9,-16,600,14602600,2518
1144,cs1605,20150818,2440,2433,2440,2442,2430,2436,2436,3,3,202,4921800,2560
1145,cs1605,20150819,2436,2436,2438,2457,2397,2431,2416,-5,-20,1570,37934360,2648
1146,cs1605,20150820,2431,2416,2470,2470,2410,2410,2435,-6,19,560,13636400,2790
1147,cs1605,20150821,2410,2435,2416,2416,2400,2413,2407,-22,-28,280,6742200,2890
1148,cs1605,20150824,2413,2407,2393,2401,2376,2380,2387,-27,-20,394,9405640,2814
1149,cs1605,20150825,2380,2387,2385,2420,2385,2414,2408,27,21,414,9970140,2840
1150,cs1605,20150826,2414,2408,2416,2426,2407,2408,2412,0,4,246,5934480,2894
1151,cs1605,20150827,2408,2412,2410,2410,2390,2407,2400,-5,-12,248,5952960,2992
1152,cs1605,20150828,2407,2400,2421,2440,2405,2405,2410,5,10,488,11763140,3106
1153,cs1605,20150831,2405,2410,2390,2398,2351,2352,2375,-58,-35,332,7885780,3128
1154,cs1605,20150901,2352,2375,2352,2374,2332,2338,2347,-37,-28,956,22446840,3498
1155,cs1605,20150902,2338,2347,2302,2330,2298,2310,2307,-37,-40,3520,81222020,5460
1156,cs1605,20150907,2310,2307,2318,2323,2283,2293,2296,-14,-11,3536,81188520,7678
1157,cs1605,20150908,2293,2296,2298,2307,2288,2305,2295,9,-1,2526,57975780,8338
1158,cs1605,20150909,2305,2295,2323,2328,2288,2288,2299,-7,4,3002,69029460,9872
1159,cs1605,20150910,2288,2299,2289,2289,2267,2277,2278,-22,-21,4298,97925740,11632
1160,cs1605,20150911,2277,2278,2280,2289,2271,2276,2277,-2,-1,4958,112926060,13586
1161,cs1605,20150914,2276,2277,2281,2283,2238,2240,2252,-37,-25,6924,155984400,17122
1162,cs1605,20150915,2240,2252,2245,2252,2235,2241,2242,-11,-10,4468,100207720,18942
1163,cs1605,20150916,2241,2242,2245,2269,2239,2267,2254,25,12,12144,273826220,21104
1164,cs1605,20150917,2267,2254,2270,2273,2244,2253,2254,-1,0,9342,210570040,22520
1165,cs1605,20150918,2253,2254,2250,2254,2175,2182,2208,-72,-46,26904,594048700,30408
1166,cs1605,20150921,2182,2208,2218,2228,2172,2186,2187,-22,-21,23360,511096060,36356
1167,cs1605,20150922,2186,2187,2188,2188,2152,2154,2162,-33,-25,21622,467508640,40754
1168,cs1605,20150923,2154,2162,2153,2172,2142,2172,2156,10,-6,14818,319598260,38786
1169,cs1605,20150924,2172,2156,2197,2197,2151,2154,2162,-2,6,11868,256652880,41724
1170,cs1605,20150925,2154,2162,2153,2173,2148,2148,2158,-14,-4,6714,144949900,42188
1171,cs1605,20150928,2148,2158,2156,2159,2134,2145,2145,-13,-13,9644,206950100,42600
1172,cs1605,20150929,2145,2145,2141,2145,2079,2089,2102,-56,-43,16992,357237500,45046
1173,cs1605,20150930,2089,2102,2094,2099,2060,2067,2074,-35,-28,24904,516639200,54918
1174,cs1605,20151008,2067,2074,2060,2060,1990,1997,2016,-77,-58,39340,793141880,65412
1175,cs1605,20151009,1997,2016,2000,2062,1991,2024,2033,8,17,56412,1146897960,67212
1176,cs1605,20151012,2024,2033,2022,2036,1986,1991,2007,-42,-26,40028,803619100,81900
1177,cs1605,20151013,1991,2007,1985,1986,1945,1963,1959,-44,-48,69036,1353091500,98824
1178,cs1605,20151014,1963,1959,1929,1986,1917,1939,1941,-20,-18,101920,1978770240,122448
1179,cs1605,20151015,1939,1941,1940,1957,1935,1945,1950,4,9,64572,1259252720,132194
1180,cs1605,20151016,1945,1950,1940,1959,1929,1956,1944,6,-6,80176,1559167800,135444
1181,cs1605,20151019,1956,1944,1952,1974,1941,1952,1962,8,18,83454,1637642820,139624
1182,cs1605,20151020,1952,1962,1948,1958,1930,1936,1943,-26,-19,71758,1394726960,150994
1183,cs1605,20151021,1936,1943,1938,1954,1932,1940,1941,-3,-2,51326,996287160,159160
1184,cs1605,20151022,1940,1941,1945,1949,1908,1928,1925,-13,-16,117608,2264437740,169624
1185,cs1605,20151023,1928,1925,1924,1944,1917,1942,1934,17,9,89176,1724915280,176790
1186,cs1605,20151026,1942,1934,1948,1996,1942,1976,1974,42,40,157486,3109117300,195836
1187,cs1605,20151027,1976,1974,1985,1998,1956,1993,1980,19,6,152526,3021499020,213216
1188,cs1605,20151028,1993,1980,1989,1990,1951,1958,1963,-22,-17,132694,2605119280,227816
1189,cs1605,20151029,1958,1963,1960,1973,1949,1963,1963,0,0,97990,1924315260,237852
1190,cs1605,20151030,1963,1963,1964,1971,1948,1952,1960,-11,-3,81968,1607168060,248854
1191,cs1605,20151102,1952,1960,1970,1971,1956,1966,1964,6,4,61116,1200395480,244314
1192,cs1605,20151103,1966,1964,1963,2003,1960,1987,1986,23,22,189172,3758226360,242084
1193,cs1605,20151104,1987,1986,1991,2034,1989,2025,2020,39,34,211174,4267487820,233190
1194,cs1605,20151105,2025,2020,2029,2045,2022,2039,2035,19,15,172764,3517423860,267250
1195,cs1605,20151106,2039,2035,2034,2074,1991,2070,2044,35,9,211760,4329693520,298412
1196,cs1605,20151109,2070,2044,2066,2123,2057,2094,2089,50,45,492038,10283439240,295594
1197,cs1605,20151110,2094,2089,2090,2093,2015,2044,2049,-45,-40,500188,10253612880,326236
1198,cs1605,20151111,2044,2049,2040,2049,2022,2045,2035,-4,-14,269316,5482106560,341594
1199,cs1605,20151112,2045,2035,2040,2116,2025,2116,2080,81,45,818774,17032599280,325136
1200,cs1605,20151113,2116,2080,2120,2147,2107,2137,2128,57,48,603126,12835249520,290656
1201,cs1605,20151116,2137,2128,2138,2155,2100,2123,2120,-5,-8,714682,15156327760,359670
1202,cs1605,20151117,2123,2120,2127,2127,2088,2118,2105,-2,-15,754336,15884532040,393146
1203,cs1605,20151118,2118,2105,2118,2139,2097,2115,2114,10,9,832008,17596694600,418206
1204,cs1605,20151119,2115,2114,2113,2115,2059,2084,2081,-30,-33,885264,18426744240,416328
1205,cs1605,20151120,2084,2081,2090,2126,2057,2096,2087,15,6,1114406,23260547400,412706
1206,cs1605,20151123,2096,2087,2106,2134,2089,2120,2110,33,23,901642,19028362460,445400
1207,cs1605,20151124,2120,2110,2124,2193,2123,2135,2146,25,36,1386866,29765109340,456404
1208,cs1605,20151125,2135,2146,2140,2169,2111,2168,2140,22,-6,1092756,23395735800,467360
1209,cs1605,20151126,2168,2140,2177,2186,2154,2155,2167,15,27,743270,16110150160,456254
1210,cs1605,20151127,2155,2167,2153,2203,2148,2203,2183,36,16,903890,19736986660,471606
1211,cs1605,20151130,2203,2183,2198,2211,2176,2190,2191,7,8,697734,15293939720,517370
1212,cs1605,20151201,2190,2191,2197,2205,2155,2160,2171,-31,-20,721158,15661778060,523622
1213,cs1605,20151202,2160,2171,2166,2175,2153,2157,2163,-14,-8,574792,12434433380,524394
1214,cs1605,20151203,2157,2163,2154,2177,2142,2166,2162,3,-1,530784,11477310820,537388
1215,cs1605,20151204,2166,2162,2168,2171,2107,2108,2127,-54,-35,1067972,22725991200,560074
1216,cs1605,20151207,2108,2127,2105,2116,2065,2074,2084,-53,-43,967676,20173357760,533928
1217,cs1605,20151208,2074,2084,2064,2078,2036,2063,2058,-21,-26,692026,14242818380,494672
1218,cs1605,20151209,2063,2058,2066,2078,2031,2038,2047,-20,-11,641576,13135663300,518650
1219,cs1605,20151210,2038,2047,2035,2070,2028,2065,2048,18,1,667922,13685615820,516406
1220,cs1605,20151211,2065,2048,2064,2077,2051,2076,2063,28,15,488716,10082722520,490436
1221,cs1605,20151214,2076,2063,2070,2083,2053,2067,2066,4,3,510436,10546834460,491012
1222,cs1605,20151215,2067,2066,2069,2099,2068,2090,2086,24,20,605520,12635308300,459990
1223,cs1605,20151216,2090,2086,2087,2096,2078,2082,2084,-4,-2,339280,7073634620,468962
1224,cs1605,20151217,2082,2084,2084,2120,2080,2120,2102,36,18,545120,11463602960,483314
1225,cs1605,20151218,2120,2102,2120,2143,2114,2133,2130,31,28,597196,12720885420,455360
1226,cs1605,20151221,2133,2130,2135,2138,2111,2125,2123,-5,-7,510518,10839266180,434216
1227,cs1605,20151222,2125,2123,2125,2162,2092,2097,2129,-26,6,1122202,23896508680,416132
1228,cs1605,20151223,2097,2129,2093,2101,2074,2093,2086,-36,-43,618512,12906186180,408416
1229,cs1605,20151224,2093,2086,2093,2106,2080,2088,2089,2,3,515416,10771656820,419062
1230,cs1605,20151225,2088,2089,2087,2095,2061,2063,2080,-26,-9,609014,12672526960,445732
1231,cs1605,20151228,2063,2080,2055,2060,1997,1997,2023,-83,-57,1076406,21776006480,500812
1232,cs1605,20151229,1997,2023,2000,2052,2000,2043,2027,20,4,943800,19137414140,453376
1233,cs1605,20151230,2043,2027,2051,2082,2032,2044,2053,17,26,1028908,21123799500,470908
1234,cs1605,20151231,2044,2053,2041,2064,2023,2054,2046,1,-7,867142,17747321220,465646
1235,cs1607,20150715,2653,2653,0,0,0,2626,2626,-27,-27,0,0,0
1236,cs1607,20150716,2626,2626,0,0,0,2626,2626,0,0,0,0,0
1237,cs1607,20150717,2626,2626,0,0,0,2626,2626,0,0,0,0,0
1238,cs1607,20150720,2626,2626,0,0,0,2626,2626,0,0,0,0,0
1239,cs1607,20150721,2626,2626,0,0,0,2626,2626,0,0,0,0,0
1240,cs1607,20150722,2626,2626,0,0,0,2626,2626,0,0,0,0,0
1241,cs1607,20150723,2626,2626,0,0,0,2626,2626,0,0,0,0,0
1242,cs1607,20150724,2626,2626,0,0,0,2626,2626,0,0,0,0,0
1243,cs1607,20150727,2626,2626,0,0,0,2525,2525,-101,-101,0,0,0
1244,cs1607,20150728,2525,2525,0,0,0,2499,2499,-26,-26,0,0,0
1245,cs1607,20150729,2499,2499,0,0,0,2497,2497,-2,-2,0,0,0
1246,cs1607,20150730,2497,2497,0,0,0,2497,2497,0,0,0,0,0
1247,cs1607,20150731,2497,2497,0,0,0,2477,2477,-20,-20,0,0,0
1248,cs1607,20150803,2477,2477,2477,2477,2324,2350,2376,-127,-101,10,237640,2
1249,cs1607,20150804,2350,2376,2399,2409,2363,2363,2390,-13,14,8,191260,4
1250,cs1607,20150805,2363,2390,2392,2392,2392,2392,2392,2,2,2,47840,2
1251,cs1607,20150806,2392,2392,0,0,0,2392,2392,0,0,0,0,2
1252,cs1607,20150807,2392,2392,0,0,0,2392,2392,0,0,0,0,2
1253,cs1607,20150810,2392,2392,0,0,0,2392,2392,0,0,0,0,2
1254,cs1607,20150811,2392,2392,2424,2424,2424,2424,2424,32,32,2,48480,4
1255,cs1607,20150812,2424,2424,0,0,0,2424,2424,0,0,0,0,4
1256,cs1607,20150813,2424,2424,2444,2444,2444,2444,2444,20,20,2,48880,2
1257,cs1607,20150814,2444,2444,0,0,0,2444,2444,0,0,0,0,2
1258,cs1607,20150817,2444,2444,0,0,0,2444,2444,0,0,0,0,2
1259,cs1607,20150818,2444,2444,0,0,0,2444,2444,0,0,0,0,2
1260,cs1607,20150819,2444,2444,2402,2402,2402,2402,2402,-42,-42,2,48040,0
1261,cs1607,20150820,2402,2402,0,0,0,2402,2402,0,0,0,0,0
1262,cs1607,20150821,2402,2402,0,0,0,2402,2402,0,0,0,0,0
1263,cs1607,20150824,2402,2402,0,0,0,2402,2402,0,0,0,0,0
1264,cs1607,20150825,2402,2402,0,0,0,2402,2402,0,0,0,0,0
1265,cs1607,20150826,2402,2402,0,0,0,2402,2402,0,0,0,0,0
1266,cs1607,20150827,2402,2402,0,0,0,2402,2402,0,0,0,0,0
1267,cs1607,20150828,2402,2402,0,0,0,2402,2402,0,0,0,0,0
1268,cs1607,20150831,2402,2402,2494,2494,2363,2363,2428,-39,26,16,388560,0
1269,cs1607,20150901,2363,2428,0,0,0,2400,2400,-28,-28,0,0,0
1270,cs1607,20150902,2400,2400,0,0,0,2377,2377,-23,-23,0,0,0
1271,cs1607,20150907,2377,2377,0,0,0,2366,2366,-11,-11,0,0,0
1272,cs1607,20150908,2366,2366,0,0,0,2358,2358,-8,-8,0,0,0
1273,cs1607,20150909,2358,2358,0,0,0,2358,2358,0,0,0,0,0
1274,cs1607,20150910,2358,2358,0,0,0,2337,2337,-21,-21,0,0,0
1275,cs1607,20150911,2337,2337,0,0,0,2336,2336,-1,-1,0,0,0
1276,cs1607,20150914,2336,2336,0,0,0,2311,2311,-25,-25,0,0,0
1277,cs1607,20150915,2311,2311,0,0,0,2301,2301,-10,-10,0,0,0
1278,cs1607,20150916,2301,2301,0,0,0,2313,2313,12,12,0,0,0
1279,cs1607,20150917,2313,2313,0,0,0,2313,2313,0,0,0,0,0
1280,cs1607,20150918,2313,2313,0,0,0,2266,2266,-47,-47,0,0,0
1281,cs1607,20150921,2266,2266,0,0,0,2245,2245,-21,-21,0,0,0
1282,cs1607,20150922,2245,2245,0,0,0,2220,2220,-25,-25,0,0,0
1283,cs1607,20150923,2220,2220,0,0,0,2214,2214,-6,-6,0,0,0
1284,cs1607,20150924,2214,2214,0,0,0,2220,2220,6,6,0,0,0
1285,cs1607,20150925,2220,2220,0,0,0,2216,2216,-4,-4,0,0,0
1286,cs1607,20150928,2216,2216,0,0,0,2203,2203,-13,-13,0,0,0
1287,cs1607,20150929,2203,2203,0,0,0,2159,2159,-44,-44,0,0,0
1288,cs1607,20150930,2159,2159,0,0,0,2131,2131,-28,-28,0,0,0
1289,cs1607,20151008,2131,2131,0,0,0,2072,2072,-59,-59,0,0,0
1290,cs1607,20151009,2072,2072,2050,2050,2050,2050,2050,-22,-22,2,41000,2
1291,cs1607,20151012,2050,2050,0,0,0,2024,2024,-26,-26,0,0,2
1292,cs1607,20151013,2024,2024,0,0,0,1976,1976,-48,-48,0,0,2
1293,cs1607,20151014,1976,1976,0,0,0,1958,1958,-18,-18,0,0,2
1294,cs1607,20151015,1958,1958,0,0,0,1967,1967,9,9,0,0,2
1295,cs1607,20151016,1967,1967,0,0,0,1961,1961,-6,-6,0,0,2
1296,cs1607,20151019,1961,1961,0,0,0,1979,1979,18,18,0,0,2
1297,cs1607,20151020,1979,1979,0,0,0,1960,1960,-19,-19,0,0,2
1298,cs1607,20151021,1960,1960,1895,1998,1895,1998,1930,38,-30,6,115800,4
1299,cs1607,20151022,1998,1930,1927,1927,1927,1927,1927,-3,-3,2,38540,2
1300,cs1607,20151023,1927,1927,0,0,0,1936,1936,9,9,0,0,2
1301,cs1607,20151026,1936,1936,0,0,0,1976,1976,40,40,0,0,2
1302,cs1607,20151027,1976,1976,0,0,0,1982,1982,6,6,0,0,2
1303,cs1607,20151028,1982,1982,0,0,0,1965,1965,-17,-17,0,0,2
1304,cs1607,20151029,1965,1965,1946,1946,1946,1946,1946,-19,-19,2,38920,0
1305,cs1607,20151030,1946,1946,0,0,0,1944,1944,-2,-2,0,0,0
1306,cs1607,20151102,1944,1944,0,0,0,1947,1947,3,3,0,0,0
1307,cs1607,20151103,1947,1947,0,0,0,1968,1968,21,21,0,0,0
1308,cs1607,20151104,1968,1968,0,0,0,2001,2001,33,33,0,0,0
1309,cs1607,20151105,2001,2001,0,0,0,2015,2015,14,14,0,0,0
1310,cs1607,20151106,2015,2015,0,0,0,2023,2023,8,8,0,0,0
1311,cs1607,20151109,2023,2023,0,0,0,2067,2067,44,44,0,0,0
1312,cs1607,20151110,2067,2067,0,0,0,2028,2028,-39,-39,0,0,0
1313,cs1607,20151111,2028,2028,0,0,0,2015,2015,-13,-13,0,0,0
1314,cs1607,20151112,2015,2015,0,0,0,2059,2059,44,44,0,0,0
1315,cs1607,20151113,2059,2059,2141,2141,2109,2109,2134,50,75,10,213460,10
1316,cs1607,20151116,2109,2134,2158,2158,2101,2125,2120,-9,-14,14,296800,8
1317,cs1607,20151117,2125,2120,2122,2122,2063,2089,2091,-31,-29,10,209180,10
1318,cs1607,20151118,2089,2091,0,0,0,2091,2091,0,0,0,0,10
1319,cs1607,20151119,2091,2091,2100,2100,2100,2100,2100,9,9,2,42000,10
1320,cs1607,20151120,2100,2100,2093,2142,2090,2142,2108,42,8,6,126500,8
1321,cs1607,20151123,2142,2108,0,0,0,2131,2131,23,23,0,0,8
1322,cs1607,20151124,2131,2131,0,0,0,2167,2167,36,36,0,0,8
1323,cs1607,20151125,2167,2167,2198,2252,2198,2252,2225,85,58,4,89000,10
1324,cs1607,20151126,2252,2225,2203,2212,2203,2210,2208,-15,-17,12,265060,14
1325,cs1607,20151127,2210,2208,2210,2210,2210,2210,2210,2,2,4,88400,12
1326,cs1607,20151130,2210,2210,2233,2233,2132,2191,2200,-19,-10,12,264060,14
1327,cs1607,20151201,2191,2200,0,0,0,2180,2180,-20,-20,0,0,14
1328,cs1607,20151202,2180,2180,0,0,0,2172,2172,-8,-8,0,0,14
1329,cs1607,20151203,2172,2172,0,0,0,2171,2171,-1,-1,0,0,14
1330,cs1607,20151204,2171,2171,2170,2170,2170,2170,2170,-1,-1,8,173600,14
1331,cs1607,20151207,2170,2170,2141,2141,2121,2121,2134,-49,-36,6,128060,16
1332,cs1607,20151208,2121,2134,2101,2101,2101,2101,2101,-33,-33,2,42020,18
1333,cs1607,20151209,2101,2101,0,0,0,2090,2090,-11,-11,0,0,18
1334,cs1607,20151210,2090,2090,2099,2099,2099,2099,2099,9,9,2,41980,16
1335,cs1607,20151211,2099,2099,0,0,0,2104,2104,5,5,0,0,16
1336,cs1607,20151214,2104,2104,2105,2105,2105,2105,2105,1,1,2,42100,18
1337,cs1607,20151215,2105,2105,2123,2125,2123,2123,2123,18,18,8,169900,18
1338,cs1607,20151216,2123,2123,2112,2113,2112,2112,2112,-11,-11,8,168980,18
1339,cs1607,20151217,2112,2112,2120,2135,2073,2135,2107,23,-5,44,927300,18
1340,cs1607,20151218,2135,2107,2142,2142,2142,2142,2142,35,35,2,42840,16
1341,cs1607,20151221,2142,2142,0,0,0,2135,2135,-7,-7,0,0,16
1342,cs1607,20151222,2135,2135,2120,2120,2120,2120,2120,-15,-15,2,42400,16
1343,cs1607,20151223,2120,2120,2129,2129,2051,2051,2093,-69,-27,6,125620,18
1344,cs1607,20151224,2051,2093,0,0,0,2096,2096,3,3,0,0,18
1345,cs1607,20151225,2096,2096,0,0,0,2087,2087,-9,-9,0,0,18
1346,cs1607,20151228,2087,2087,0,0,0,2004,2004,-83,-83,0,0,18
1347,cs1607,20151229,2004,2004,0,0,0,2007,2007,3,3,0,0,18
1348,cs1607,20151230,2007,2007,2050,2050,1941,2040,2038,33,31,20,407620,18
1349,cs1607,20151231,2040,2038,0,0,0,2032,2032,-6,-6,0,0,18
1350,cs1609,20150917,2242,2242,2266,2283,2218,2218,2253,-24,11,3716,83758480,3086
1351,cs1609,20150918,2218,2253,2203,2222,2163,2180,2186,-73,-67,4474,97824900,5586
1352,cs1609,20150921,2180,2186,2193,2205,2106,2123,2129,-63,-57,8040,171223760,9292
1353,cs1609,20150922,2123,2129,2128,2128,2086,2086,2104,-43,-25,2174,45759720,9786
1354,cs1609,20150923,2086,2104,2095,2096,2074,2096,2085,-8,-19,1356,28280560,9950
1355,cs1609,20150924,2096,2085,2096,2111,2072,2076,2084,-9,-1,1640,34184820,10182
1356,cs1609,20150925,2076,2084,2081,2099,2079,2083,2087,-1,3,1108,23131380,10082
1357,cs1609,20150928,2083,2087,2088,2090,2074,2077,2080,-10,-7,572,11903020,10122
1358,cs1609,20150929,2077,2080,2066,2082,2003,2010,2023,-70,-57,2390,48369160,10612
1359,cs1609,20150930,2010,2023,2016,2016,1998,2004,2010,-19,-13,4222,84885520,11940
1360,cs1609,20151008,2004,2010,2010,2010,1950,1956,1965,-54,-45,8684,170668740,16674
1361,cs1609,20151009,1956,1965,1957,1999,1952,1967,1979,2,14,12238,242250500,19272
1362,cs1609,20151012,1967,1979,1968,1974,1936,1937,1951,-42,-28,8392,163754900,24062
1363,cs1609,20151013,1937,1951,1940,1940,1914,1930,1923,-21,-28,15640,300864300,30810
1364,cs1609,20151014,1930,1923,1912,1935,1905,1922,1920,-1,-3,14946,287042120,37846
1365,cs1609,20151015,1922,1920,1925,1935,1918,1926,1929,6,9,10276,198227100,38548
1366,cs1609,20151016,1926,1929,1928,1935,1914,1929,1926,0,-3,12376,238398460,40640
1367,cs1609,20151019,1929,1926,1926,1946,1921,1924,1933,-2,7,10700,206863640,44988
1368,cs1609,20151020,1924,1933,1924,1927,1910,1918,1919,-15,-14,10508,201674880,48244
1369,cs1609,20151021,1918,1919,1918,1938,1913,1920,1927,1,8,13462,259483560,49866
1370,cs1609,20151022,1920,1927,1926,1929,1893,1899,1904,-28,-23,17104,325679480,55444
1371,cs1609,20151023,1899,1904,1899,1909,1890,1904,1899,0,-5,8242,156548620,55772
1372,cs1609,20151026,1904,1899,1901,1948,1900,1927,1929,28,30,25724,496306540,55500
1373,cs1609,20151027,1927,1929,1931,1952,1919,1951,1937,22,8,16586,321411980,53844
1374,cs1609,20151028,1951,1937,1948,1949,1926,1927,1931,-10,-6,7558,145984560,53950
1375,cs1609,20151029,1927,1931,1930,1948,1921,1937,1937,6,6,9596,185928260,55552
1376,cs1609,20151030,1937,1937,1940,1957,1928,1932,1942,-5,5,13118,254756660,57966
1377,cs1609,20151102,1932,1942,1937,1954,1935,1943,1944,1,2,13950,271303300,56392
1378,cs1609,20151103,1943,1944,1943,1969,1942,1964,1960,20,16,23786,466325060,55990
1379,cs1609,20151104,1964,1960,1965,1999,1963,1991,1988,31,28,23098,459356780,63500
1380,cs1609,20151105,1991,1988,1990,2010,1987,1999,2001,11,13,12816,256509160,66498
1381,cs1609,20151106,1999,2001,1992,2022,1966,2018,2008,17,7,14282,286784020,69338
1382,cs1609,20151109,2018,2008,2028,2069,2020,2049,2044,41,36,61834,1264465840,84990
1383,cs1609,20151110,2049,2044,2045,2046,1971,1985,2001,-59,-43,48996,980532940,89028
1384,cs1609,20151111,1985,2001,1980,1990,1959,1984,1979,-17,-22,33300,659084620,85392
1385,cs1609,20151112,1984,1979,1971,2040,1963,2028,2011,49,32,101978,2051023160,95058
1386,cs1609,20151113,2028,2011,2022,2051,2014,2037,2033,26,22,49350,1003743500,94710
1387,cs1609,20151116,2037,2033,2050,2061,2017,2035,2040,2,7,43982,897524800,99028
1388,cs1609,20151117,2035,2040,2046,2046,2015,2043,2027,3,-13,30390,616098460,106740
1389,cs1609,20151118,2043,2027,2040,2080,2036,2056,2058,29,31,73236,1507546840,116278
1390,cs1609,20151119,2056,2058,2056,2056,2012,2031,2028,-27,-30,46352,940028420,109276
1391,cs1609,20151120,2031,2028,2036,2051,1995,2021,2014,-7,-14,71544,1441482340,114120
1392,cs1609,20151123,2021,2014,2020,2050,2012,2043,2033,29,19,31134,633143760,120044
1393,cs1609,20151124,2043,2033,2048,2092,2043,2048,2060,15,27,60816,1252925960,128924
1394,cs1609,20151125,2048,2060,2059,2069,2030,2067,2051,7,-9,63160,1296015600,156312
1395,cs1609,20151126,2067,2051,2080,2081,2058,2063,2070,12,19,46288,958173720,159324
1396,cs1609,20151127,2063,2070,2067,2103,2056,2103,2088,33,18,54080,1129560080,171268
1397,cs1609,20151130,2103,2088,2080,2107,2079,2090,2094,2,6,34078,713716840,177478
1398,cs1609,20151201,2090,2094,2094,2102,2063,2067,2075,-27,-19,29226,606448840,174516
1399,cs1609,20151202,2067,2075,2064,2080,2063,2065,2069,-10,-6,30078,622361100,177530
1400,cs1609,20151203,2065,2069,2063,2078,2054,2070,2065,1,-4,19528,403367020,177320
1401,cs1609,20151204,2070,2065,2076,2076,2012,2013,2036,-52,-29,76162,1550701600,164094
1402,cs1609,20151207,2013,2036,2013,2019,1968,1979,1989,-57,-47,85178,1694418520,173128
1403,cs1609,20151208,1979,1989,1970,1983,1945,1968,1962,-21,-27,57452,1127408860,175968
1404,cs1609,20151209,1968,1962,1969,1985,1940,1940,1953,-22,-9,57882,1130926560,184756
1405,cs1609,20151210,1940,1953,1940,1973,1936,1968,1949,15,-4,68870,1342920920,179074
1406,cs1609,20151211,1968,1949,1968,1975,1955,1974,1965,25,16,41194,809831060,181916
1407,cs1609,20151214,1974,1965,1972,1975,1942,1951,1956,-14,-9,59868,1171095060,189592
1408,cs1609,20151215,1951,1956,1958,1977,1955,1966,1969,10,13,43310,852863980,187616
1409,cs1609,20151216,1966,1969,1969,1971,1956,1957,1963,-12,-6,26014,510815960,191000
1410,cs1609,20151217,1957,1963,1955,1980,1938,1972,1965,9,2,47236,928236200,196332
1411,cs1609,20151218,1972,1965,1980,2024,1966,2015,1993,50,28,68340,1362607060,182538
1412,cs1609,20151221,2015,1993,2020,2020,1997,2008,2008,15,15,67000,1345396580,194860
1413,cs1609,20151222,2008,2008,2007,2038,1977,1979,2003,-29,-5,161074,3226759100,204284
1414,cs1609,20151223,1979,2003,1968,1980,1956,1972,1967,-31,-36,63162,1242729420,210518
1415,cs1609,20151224,1972,1967,1974,1980,1953,1961,1963,-6,-4,59680,1171722100,219148
1416,cs1609,20151225,1961,1963,1960,1965,1921,1923,1942,-40,-21,113316,2200877320,236136
1417,cs1609,20151228,1923,1942,1915,1915,1865,1865,1887,-77,-55,197136,3720997960,286584
1418,cs1609,20151229,1865,1887,1853,1885,1846,1876,1863,-11,-24,318216,5931506000,322926
1419,cs1609,20151230,1876,1863,1876,1910,1876,1891,1892,28,29,324966,6150694240,278722
1420,cs1609,20151231,1891,1892,1886,1906,1877,1896,1894,4,2,116544,2207365860,271736
1421,cs1611,20151116,2011,2011,0,0,0,2011,2011,0,0,0,0,0
1422,cs1611,20151117,2011,2011,2039,2088,2039,2088,2083,77,72,20,416620,20
1423,cs1611,20151118,2088,2083,2001,2041,2001,2041,2010,-42,-73,26,522740,6
1424,cs1611,20151119,2041,2010,2011,2011,2005,2005,2007,-5,-3,6,120420,10
1425,cs1611,20151120,2005,2007,0,0,0,2007,2007,0,0,0,0,10
1426,cs1611,20151123,2007,2007,2027,2050,2027,2050,2038,43,31,4,81540,8
1427,cs1611,20151124,2050,2038,0,0,0,2038,2038,0,0,0,0,8
1428,cs1611,20151125,2038,2038,0,0,0,2038,2038,0,0,0,0,8
1429,cs1611,20151126,2038,2038,2119,2119,2111,2111,2115,73,77,4,84600,10
1430,cs1611,20151127,2111,2115,0,0,0,2115,2115,0,0,0,0,10
1431,cs1611,20151130,2115,2115,2090,2090,2089,2089,2089,-26,-26,4,83580,10
1432,cs1611,20151201,2089,2089,2121,2121,2070,2070,2095,-19,6,4,83820,10
1433,cs1611,20151202,2070,2095,0,0,0,2095,2095,0,0,0,0,10
1434,cs1611,20151203,2095,2095,0,0,0,2086,2086,-9,-9,0,0,10
1435,cs1611,20151204,2086,2086,2085,2086,2085,2085,2085,-1,-1,6,125120,10
1436,cs1611,20151207,2085,2085,2003,2005,2003,2005,2004,-80,-81,4,80160,14
1437,cs1611,20151208,2005,2004,0,0,0,2004,2004,0,0,0,0,14
1438,cs1611,20151209,2004,2004,2010,2010,2010,2010,2010,6,6,2,40200,16
1439,cs1611,20151210,2010,2010,0,0,0,2010,2010,0,0,0,0,16
1440,cs1611,20151211,2010,2010,1962,1966,1961,1966,1963,-44,-47,28,549700,26
1441,cs1611,20151214,1966,1963,1936,1948,1930,1948,1940,-15,-23,12,232820,32
1442,cs1611,20151215,1948,1940,0,0,0,1940,1940,0,0,0,0,32
1443,cs1611,20151216,1940,1940,1950,1950,1950,1950,1950,10,10,4,78000,32
1444,cs1611,20151217,1950,1950,0,0,0,1950,1950,0,0,0,0,32
1445,cs1611,20151218,1950,1950,0,0,0,1963,1963,13,13,0,0,32
1446,cs1611,20151221,1963,1963,1955,1963,1955,1963,1959,0,-4,4,78360,32
1447,cs1611,20151222,1963,1959,2004,2004,1980,1980,1990,21,31,12,238860,28
1448,cs1611,20151223,1980,1990,1952,1970,1952,1970,1964,-20,-26,14,274980,36
1449,cs1611,20151224,1970,1964,0,0,0,1964,1964,0,0,0,0,36
1450,cs1611,20151225,1964,1964,1940,1942,1940,1942,1941,-22,-23,6,116480,40
1451,cs1611,20151228,1942,1941,1888,1888,1865,1865,1879,-76,-62,10,187900,42
1452,cs1611,20151229,1865,1879,1880,1880,1878,1878,1879,-1,0,4,75160,46
1453,cs1611,20151230,1878,1879,1933,1933,1882,1882,1894,3,15,12,227340,42
1454,cs1611,20151231,1882,1894,1889,1905,1889,1895,1899,1,5,20,379980,52
