1,c1501,20150105,2265,2271,2251,2271,2245,2255,2257,-16,-14,5862,132363340,7506
2,c1501,20150106,2255,2257,2240,2240,2240,2240,2240,-17,-17,170,3808000,3434
3,c1501,20150107,2240,2240,2228,2249,2228,2235,2229,-5,-11,374,8339500,3256
4,c1501,20150108,2235,2229,2235,2249,2235,2249,2244,20,15,6,134660,3256
5,c1501,20150109,2249,2244,2239,2239,2230,2235,2233,-9,-11,46,1027380,2282
6,c1501,20150112,2235,2233,2250,2250,2250,2250,2250,17,17,2,45000,2280
7,c1501,20150113,2250,2250,2280,2280,2250,2250,2275,0,25,116,2640000,2164
8,c1501,20150114,2250,2275,0,0,0,2268,2268,-7,-7,0,0,2164
9,c1501,20150115,2268,2268,2250,2270,2250,2270,2256,2,-12,6,135400,2158
10,c1501,20150116,2270,2256,0,0,0,2256,2256,0,0,0,0,0
11,c1503,20150105,2329,2329,2309,2336,2294,2320,2314,-9,-15,82,1897900,18
12,c1503,20150106,2320,2314,2323,2336,2318,2323,2325,9,11,128,2977080,18
13,c1503,20150107,2323,2325,2310,2310,2269,2294,2293,-31,-32,62,1422200,28
14,c1503,20150108,2294,2293,2296,2305,2278,2291,2294,-2,1,90,2065320,22
15,c1503,20150109,2291,2294,2302,2302,2280,2302,2294,8,0,6,137680,22
16,c1503,20150112,2302,2294,2255,2307,2255,2296,2293,2,-1,92,2110380,24
17,c1503,20150113,2296,2293,2281,2306,2281,2296,2293,3,0,60,1376020,18
18,c1503,20150114,2296,2293,0,0,0,2293,2293,0,0,0,0,18
19,c1503,20150115,2293,2293,2278,2294,2276,2283,2284,-10,-9,94,2146960,16
20,c1503,20150116,2283,2284,2290,2303,2278,2285,2288,1,4,62,1418620,14
21,c1503,20150119,2285,2288,2276,2296,2276,2281,2288,-7,0,14,320380,16
22,c1503,20150120,2281,2288,2284,2297,2280,2297,2289,9,1,18,412120,14
23,c1503,20150121,2297,2289,2308,2308,2290,2299,2297,10,8,132,3032360,14
24,c1503,20150122,2299,2297,2267,2297,2267,2292,2288,-5,-9,48,1098540,14
25,c1503,20150123,2292,2288,2294,2294,2285,2287,2289,-1,1,42,961420,14
26,c1503,20150126,2287,2289,2289,2289,2289,2289,2289,0,0,2,45780,12
27,c1503,20150127,2289,2289,0,0,0,2299,2299,10,10,0,0,12
28,c1503,20150128,2299,2299,0,0,0,2299,2299,0,0,0,0,12
29,c1503,20150129,2299,2299,2318,2318,2281,2298,2297,-1,-2,38,873020,10
30,c1503,20150130,2298,2297,2282,2301,2282,2291,2293,-6,-4,14,321080,12
31,c1503,20150202,2291,2293,2278,2313,2273,2286,2290,-7,-3,40,916080,12
32,c1503,20150203,2286,2290,2264,2302,2264,2294,2287,4,-3,24,549080,12
33,c1503,20150204,2294,2287,2291,2331,2282,2302,2306,15,19,132,3044260,10
34,c1503,20150205,2302,2306,2341,2341,2309,2309,2327,3,21,6,139660,10
35,c1503,20150206,2309,2327,0,0,0,2327,2327,0,0,0,0,10
36,c1503,20150209,2327,2327,2334,2334,2334,2334,2334,7,7,2,46680,12
37,c1503,20150210,2334,2334,2353,2418,2305,2338,2333,4,-1,34,793420,12
38,c1503,20150211,2338,2333,0,0,0,2333,2333,0,0,0,0,12
39,c1503,20150212,2333,2333,0,0,0,2333,2333,0,0,0,0,12
40,c1503,20150213,2333,2333,2262,2404,2262,2286,2303,-47,-30,8,184300,12
41,c1503,20150216,2286,2303,2260,2260,2260,2260,2260,-43,-43,2,45200,12
42,c1503,20150217,2260,2260,0,0,0,2260,2260,0,0,0,0,12
43,c1503,20150225,2260,2260,0,0,0,2260,2260,0,0,0,0,12
44,c1503,20150226,2260,2260,2171,2266,2171,2246,2208,-14,-52,28,618460,8
45,c1503,20150227,2246,2208,2270,2296,2208,2208,2267,0,59,8,181400,0
46,c1503,20150302,2208,2267,0,0,0,2267,2267,0,0,0,0,0
47,c1503,20150303,2267,2267,0,0,0,2267,2267,0,0,0,0,0
48,c1503,20150304,2267,2267,0,0,0,2267,2267,0,0,0,0,0
49,c1503,20150305,2267,2267,0,0,0,2267,2267,0,0,0,0,0
50,c1503,20150306,2267,2267,0,0,0,2267,2267,0,0,0,0,0
51,c1503,20150309,2267,2267,0,0,0,2267,2267,0,0,0,0,0
52,c1503,20150310,2267,2267,0,0,0,2267,2267,0,0,0,0,0
53,c1503,20150311,2267,2267,0,0,0,2267,2267,0,0,0,0,0
54,c1503,20150312,2267,2267,0,0,0,2267,2267,0,0,0,0,0
55,c1503,20150313,2267,2267,0,0,0,2267,2267,0,0,0,0,0
56,c1505,20150105,2380,2386,2377,2381,2369,2377,2375,-9,-11,46870,1113298880,154530
57,c1505,20150106,2377,2375,2387,2394,2386,2389,2390,14,15,47668,1139710060,147544
58,c1505,20150107,2389,2390,2389,2397,2386,2397,2393,7,3,35484,849146280,153148
59,c1505,20150108,2397,2393,2398,2409,2393,2406,2400,13,7,48352,1160582340,149164
60,c1505,20150109,2406,2400,2404,2408,2398,2406,2402,6,2,39762,955256120,140402
61,c1505,20150112,2406,2402,2406,2417,2398,2408,2407,6,5,43488,1046962200,137522
62,c1505,20150113,2408,2407,2405,2413,2399,2412,2405,5,-2,44374,1067387200,145266
63,c1505,20150114,2412,2405,2408,2410,2405,2407,2407,2,2,27144,653361020,144860
64,c1505,20150115,2407,2407,2407,2411,2406,2408,2408,1,1,15590,375432560,144946
65,c1505,20150116,2408,2408,2408,2411,2402,2409,2407,1,-1,15020,361610160,147622
66,c1505,20150119,2409,2407,2409,2415,2408,2415,2412,8,5,20990,506396320,147708
67,c1505,20150120,2415,2412,2415,2417,2411,2412,2413,0,1,10794,260480720,151080
68,c1505,20150121,2412,2413,2413,2423,2411,2415,2417,2,4,26570,642231280,151144
69,c1505,20150122,2415,2417,2414,2419,2414,2419,2416,2,-1,9518,229955640,151488
70,c1505,20150123,2419,2416,2417,2421,2414,2415,2416,-1,0,12286,296893420,149624
71,c1505,20150126,2415,2416,2415,2426,2413,2425,2421,9,5,19836,480338160,152972
72,c1505,20150127,2425,2421,2426,2433,2422,2423,2425,2,4,26904,652681440,147984
73,c1505,20150128,2423,2425,2421,2424,2415,2423,2420,-2,-5,15834,383238860,145762
74,c1505,20150129,2423,2420,2428,2428,2418,2423,2423,3,3,9390,227545920,145642
75,c1505,20150130,2423,2423,2424,2429,2420,2424,2424,1,1,10766,261038660,146482
76,c1505,20150202,2424,2424,2424,2426,2412,2419,2417,-5,-7,19488,471108580,146542
77,c1505,20150203,2419,2417,2418,2431,2416,2430,2425,13,8,18478,448128580,144388
78,c1505,20150204,2430,2425,2433,2446,2432,2445,2441,20,16,50486,1232518340,139748
79,c1505,20150205,2445,2441,2442,2467,2437,2439,2455,-2,14,77760,1909374560,131222
80,c1505,20150206,2439,2455,2442,2452,2438,2450,2444,-5,-11,12060,294772560,129792
81,c1505,20150209,2450,2444,2450,2460,2445,2456,2455,12,11,14254,349977980,129504
82,c1505,20150210,2456,2455,2500,2500,2442,2467,2463,12,8,14076,346823700,129928
83,c1505,20150211,2467,2463,2465,2468,2458,2467,2463,4,0,8808,216964840,131422
84,c1505,20150212,2467,2463,2465,2470,2459,2459,2463,-4,0,16604,409030840,120090
85,c1505,20150213,2459,2463,2458,2470,2455,2468,2465,5,2,12770,314790500,115508
86,c1505,20150216,2468,2465,2465,2469,2460,2468,2466,3,1,13386,330214620,112600
87,c1505,20150217,2468,2466,2469,2470,2465,2465,2466,-1,0,11758,290068840,108716
88,c1505,20150225,2465,2466,2465,2485,2465,2472,2471,6,5,12448,307663560,104386
89,c1505,20150226,2472,2471,2471,2471,2460,2468,2464,-3,-7,10014,246808320,105612
90,c1505,20150227,2468,2464,2468,2481,2466,2480,2475,16,11,17756,439610900,106502
91,c1505,20150302,2480,2475,2484,2492,2477,2481,2481,6,6,12434,308573280,105286
92,c1505,20150303,2481,2481,2480,2482,2474,2480,2480,-1,-1,11922,295736920,101078
93,c1505,20150304,2480,2480,2482,2496,2481,2496,2490,16,10,17152,427091160,97494
94,c1505,20150305,2496,2490,2490,2493,2482,2483,2485,-7,-5,13616,338370100,94756
95,c1505,20150306,2483,2485,2483,2491,2479,2479,2483,-6,-2,7218,179267800,93040
96,c1505,20150309,2479,2483,2478,2490,2477,2481,2481,-2,-2,10932,271287220,91818
97,c1505,20150310,2481,2481,2481,2499,2480,2493,2491,12,10,23696,590294320,87294
98,c1505,20150311,2493,2491,2492,2497,2484,2488,2491,-3,0,11952,297822980,83762
99,c1505,20150312,2488,2491,2488,2490,2481,2485,2485,-6,-6,8394,208652160,80408
100,c1505,20150313,2485,2485,2484,2489,2482,2483,2485,-2,0,7330,182165700,80876
101,c1505,20150316,2483,2485,2483,2489,2481,2486,2484,1,-1,8672,215476940,76866
102,c1505,20150317,2486,2484,2483,2489,2483,2487,2486,3,2,3254,80925420,75698
103,c1505,20150318,2487,2486,2486,2486,2475,2476,2480,-10,-6,7530,186786060,72380
104,c1505,20150319,2476,2480,2477,2483,2469,2469,2476,-11,-4,4730,117156700,70780
105,c1505,20150320,2469,2476,2469,2473,2461,2464,2466,-12,-10,6446,159014000,69424
106,c1505,20150323,2464,2466,2472,2486,2468,2481,2480,15,14,6182,153316220,68992
107,c1505,20150324,2481,2480,2485,2489,2481,2487,2485,7,5,6162,153159600,67748
108,c1505,20150325,2487,2485,2490,2490,2464,2464,2475,-21,-10,7700,190626480,65212
109,c1505,20150326,2464,2475,2466,2466,2451,2462,2458,-13,-17,17694,434953800,54660
110,c1505,20150327,2462,2458,2463,2469,2460,2463,2463,5,5,6830,168261860,53468
111,c1505,20150330,2463,2463,2462,2468,2460,2463,2462,0,-1,2662,65554740,53430
112,c1505,20150331,2463,2462,2462,2466,2457,2461,2460,-1,-2,3666,90191800,52270
113,c1505,20150401,2461,2460,2460,2468,2455,2459,2460,-1,0,5234,128771720,50254
114,c1505,20150402,2459,2460,2461,2466,2459,2460,2461,0,1,1638,40314860,49978
115,c1505,20150403,2460,2461,2464,2464,2455,2457,2457,-4,-4,2772,68118180,48540
116,c1505,20150407,2457,2457,2457,2462,2455,2457,2457,0,0,2828,69505260,46540
117,c1505,20150408,2457,2457,2459,2461,2453,2457,2455,0,-2,2790,68515520,44712
118,c1505,20150409,2457,2455,2459,2463,2453,2463,2456,8,1,3512,86284960,42156
119,c1505,20150410,2463,2456,2461,2475,2458,2474,2466,18,10,4106,101289020,39254
120,c1505,20150413,2474,2466,2476,2488,2466,2469,2476,3,10,5890,145877620,35784
121,c1505,20150414,2469,2476,2471,2471,2431,2435,2449,-41,-27,10866,266173420,28570
122,c1505,20150415,2435,2449,2439,2439,2410,2418,2422,-31,-27,7596,183985780,25402
123,c1505,20150416,2418,2422,2422,2425,2414,2418,2417,-4,-5,3206,77497560,23572
124,c1505,20150417,2418,2417,2422,2446,2416,2445,2434,28,17,2936,71482940,23394
125,c1505,20150420,2445,2434,2450,2450,2420,2422,2427,-12,-7,1988,48258980,22538
126,c1505,20150421,2422,2427,2422,2442,2420,2436,2434,9,7,4584,111598680,23096
127,c1505,20150422,2436,2434,2440,2441,2430,2434,2438,0,4,4114,100313780,21238
128,c1505,20150423,2434,2438,2434,2448,2434,2438,2437,0,-1,1478,36031280,20230
129,c1505,20150424,2438,2437,2440,2440,2422,2426,2429,-11,-8,1606,39016280,19008
130,c1505,20150427,2426,2429,2422,2425,2417,2423,2422,-6,-7,1372,33230580,17894
131,c1505,20150428,2423,2422,2423,2426,2409,2412,2416,-10,-6,4244,102556440,14918
132,c1505,20150429,2412,2416,2411,2411,2394,2394,2400,-22,-16,2684,64421220,13460
133,c1505,20150430,2394,2400,2408,2418,2385,2417,2399,17,-1,1294,31055080,12402
134,c1505,20150504,2417,2399,2416,2416,2390,2395,2397,-4,-2,246,5897980,7104
135,c1505,20150505,2395,2397,2395,2409,2395,2409,2395,12,-2,556,13317320,6748
136,c1505,20150506,2409,2395,2396,2396,2396,2396,2396,1,1,452,10829920,2628
137,c1505,20150507,2396,2396,2412,2412,2395,2395,2403,-1,7,4,96140,2628
138,c1505,20150508,2395,2403,2410,2412,2410,2412,2410,9,7,60,1446400,1208
139,c1505,20150511,2412,2410,0,0,0,2410,2410,0,0,0,0,22
140,c1505,20150512,2410,2410,2500,2500,2490,2490,2494,80,84,22,548800,0
141,c1505,20150513,2490,2494,0,0,0,2494,2494,0,0,0,0,0
142,c1505,20150514,2494,2494,0,0,0,2494,2494,0,0,0,0,0
143,c1505,20150515,2494,2494,0,0,0,2398,2398,-96,-96,0,0,0
144,c1507,20150105,2350,2354,2290,2360,2290,2336,2337,-18,-17,28,654560,72
145,c1507,20150106,2336,2337,2345,2357,2323,2357,2346,20,9,54,1267300,80
146,c1507,20150107,2357,2346,2354,2363,2354,2354,2356,8,10,16,376980,80
147,c1507,20150108,2354,2356,2369,2369,2357,2366,2362,10,6,38,897920,80
148,c1507,20150109,2366,2362,2365,2370,2365,2369,2368,7,6,14,331520,82
149,c1507,20150112,2369,2368,2387,2387,2371,2371,2379,3,11,28,666120,82
150,c1507,20150113,2371,2379,2375,2382,2375,2380,2378,1,-1,18,428100,86
151,c1507,20150114,2380,2378,2380,2385,2380,2384,2383,6,5,32,762640,100
152,c1507,20150115,2384,2383,2383,2387,2374,2387,2383,4,0,84,2002520,176
153,c1507,20150116,2387,2383,2385,2385,2385,2385,2385,2,2,2,47700,176
154,c1507,20150119,2385,2385,2390,2397,2389,2395,2393,10,8,36,861740,186
155,c1507,20150120,2395,2393,0,0,0,2393,2393,0,0,0,0,186
156,c1507,20150121,2393,2393,2399,2403,2399,2401,2401,8,8,12,288180,188
157,c1507,20150122,2401,2401,2404,2404,2389,2389,2398,-12,-3,8,191880,188
158,c1507,20150123,2389,2398,2395,2402,2395,2395,2398,-3,0,12,287800,186
159,c1507,20150126,2395,2398,2397,2401,2397,2401,2399,3,1,4,95960,184
160,c1507,20150127,2401,2399,2418,2425,2418,2425,2420,26,21,12,290480,188
161,c1507,20150128,2425,2420,2418,2425,2418,2425,2423,5,3,52,1260060,214
162,c1507,20150129,2425,2423,2424,2425,2424,2425,2424,2,1,50,1212020,264
163,c1507,20150130,2425,2424,2430,2432,2421,2430,2426,6,2,14,339700,266
164,c1507,20150202,2430,2426,2422,2422,2421,2421,2421,-5,-5,8,193720,264
165,c1507,20150203,2421,2421,2434,2434,2430,2430,2433,9,12,18,438040,274
166,c1507,20150204,2430,2433,2435,2461,2435,2453,2449,20,16,42,1028620,264
167,c1507,20150205,2453,2449,2465,2485,2465,2466,2476,17,27,12,297120,258
168,c1507,20150206,2466,2476,0,0,0,2476,2476,0,0,0,0,258
169,c1507,20150209,2476,2476,0,0,0,2478,2478,2,2,0,0,258
170,c1507,20150210,2478,2478,2482,2489,2479,2482,2482,4,4,12,297920,252
171,c1507,20150211,2482,2482,0,0,0,2482,2482,0,0,0,0,252
172,c1507,20150212,2482,2482,2483,2483,2483,2483,2483,1,1,2,49660,252
173,c1507,20150213,2483,2483,2485,2485,2485,2485,2485,2,2,2,49700,252
174,c1507,20150216,2485,2485,2487,2487,2487,2487,2487,2,2,2,49740,252
175,c1507,20150217,2487,2487,0,0,0,2486,2486,-1,-1,0,0,252
176,c1507,20150225,2486,2486,0,0,0,2486,2486,0,0,0,0,252
177,c1507,20150226,2486,2486,0,0,0,2486,2486,0,0,0,0,252
178,c1507,20150227,2486,2486,0,0,0,2492,2492,6,6,0,0,252
179,c1507,20150302,2492,2492,0,0,0,2495,2495,3,3,0,0,252
180,c1507,20150303,2495,2495,0,0,0,2496,2496,1,1,0,0,252
181,c1507,20150304,2496,2496,2521,2521,2521,2521,2521,25,25,2,50420,250
182,c1507,20150305,2521,2521,2517,2517,2490,2502,2504,-19,-17,14,350680,252
183,c1507,20150306,2502,2504,2503,2503,2503,2503,2503,-1,-1,2,50060,254
184,c1507,20150309,2503,2503,0,0,0,2503,2503,0,0,0,0,254
185,c1507,20150310,2503,2503,0,0,0,2503,2503,0,0,0,0,254
186,c1507,20150311,2503,2503,2536,2536,2519,2519,2529,16,26,6,151740,254
187,c1507,20150312,2519,2529,2526,2526,2526,2526,2526,-3,-3,2,50520,254
188,c1507,20150313,2526,2526,0,0,0,2524,2524,-2,-2,0,0,254
189,c1507,20150316,2524,2524,0,0,0,2514,2514,-10,-10,0,0,254
190,c1507,20150317,2514,2514,0,0,0,2514,2514,0,0,0,0,254
191,c1507,20150318,2514,2514,2501,2502,2501,2502,2501,-12,-13,10,250120,256
192,c1507,20150319,2502,2501,2500,2500,2464,2464,2487,-37,-14,14,348280,252
193,c1507,20150320,2464,2487,2494,2494,2482,2485,2488,-2,1,50,1244200,250
194,c1507,20150323,2485,2488,2501,2501,2501,2501,2501,13,13,4,100040,252
195,c1507,20150324,2501,2501,0,0,0,2503,2503,2,2,0,0,252
196,c1507,20150325,2503,2503,2501,2501,2475,2483,2496,-20,-7,56,1397980,296
197,c1507,20150326,2483,2496,2487,2487,2482,2484,2483,-12,-13,16,397420,292
198,c1507,20150327,2484,2483,2492,2492,2481,2488,2487,5,4,14,348220,288
199,c1507,20150330,2488,2487,0,0,0,2487,2487,0,0,0,0,288
200,c1507,20150331,2487,2487,2486,2498,2486,2488,2491,1,4,16,398580,288
201,c1507,20150401,2488,2491,2498,2498,2488,2491,2491,0,0,14,348860,280
202,c1507,20150402,2491,2491,0,0,0,2491,2491,0,0,0,0,280
203,c1507,20150403,2491,2491,2499,2499,2486,2486,2492,-5,1,24,598200,290
204,c1507,20150407,2486,2492,2494,2494,2494,2494,2494,2,2,2,49880,288
205,c1507,20150408,2494,2494,2481,2494,2481,2494,2487,0,-7,8,198980,284
206,c1507,20150409,2494,2487,0,0,0,2487,2487,0,0,0,0,284
207,c1507,20150410,2487,2487,2511,2511,2490,2503,2499,16,12,26,649820,290
208,c1507,20150413,2503,2499,0,0,0,2499,2499,0,0,0,0,290
209,c1507,20150414,2499,2499,2517,2517,2489,2492,2499,-7,0,72,1799600,270
210,c1507,20150415,2492,2499,2486,2492,2475,2484,2481,-15,-18,64,1587920,250
211,c1507,20150416,2484,2481,2482,2487,2470,2470,2476,-11,-5,62,1535660,214
212,c1507,20150417,2470,2476,2482,2482,2472,2472,2477,-4,1,4,99080,214
213,c1507,20150420,2472,2477,2473,2490,2473,2478,2481,1,4,160,3970920,210
214,c1507,20150421,2478,2481,2483,2488,2480,2482,2483,1,2,20,496700,208
215,c1507,20150422,2482,2483,2475,2490,2475,2485,2484,2,1,36,894580,200
216,c1507,20150423,2485,2484,2485,2490,2484,2489,2487,5,3,18,447760,200
217,c1507,20150424,2489,2487,2488,2488,2475,2475,2482,-12,-5,8,198560,198
218,c1507,20150427,2475,2482,0,0,0,2482,2482,0,0,0,0,198
219,c1507,20150428,2482,2482,2463,2473,2463,2465,2468,-17,-14,10,246800,196
220,c1507,20150429,2465,2468,2462,2470,2462,2466,2466,-2,-2,14,345360,196
221,c1507,20150430,2466,2466,2467,2472,2463,2466,2465,0,-1,56,1380860,210
222,c1507,20150504,2466,2465,2467,2481,2467,2481,2476,16,11,30,742980,210
223,c1507,20150505,2481,2476,2468,2482,2468,2482,2476,6,0,90,2229120,210
224,c1507,20150506,2482,2476,2479,2493,2479,2484,2485,8,9,198,4920680,192
225,c1507,20150507,2484,2485,2475,2488,2475,2482,2485,-3,0,74,1838980,190
226,c1507,20150508,2482,2485,2485,2492,2480,2486,2484,1,-1,120,2981200,178
227,c1507,20150511,2486,2484,2486,2486,2475,2480,2481,-4,-3,210,5212180,200
228,c1507,20150512,2480,2481,2465,2478,2465,2471,2473,-10,-8,94,2324940,196
229,c1507,20150513,2471,2473,2471,2477,2469,2471,2472,-2,-1,32,791240,204
230,c1507,20150514,2471,2472,2468,2471,2457,2464,2461,-8,-11,190,4676740,202
231,c1507,20150515,2464,2461,2463,2475,2461,2473,2469,12,8,76,1876520,202
232,c1507,20150518,2473,2469,2463,2473,2459,2461,2463,-8,-6,44,1084020,200
233,c1507,20150519,2461,2463,2461,2463,2457,2458,2461,-5,-2,60,1476740,222
234,c1507,20150520,2458,2461,2455,2460,2451,2457,2454,-4,-7,34,834640,222
235,c1507,20150521,2457,2454,2460,2460,2453,2453,2456,-1,2,20,491280,218
236,c1507,20150522,2453,2456,2453,2453,2427,2445,2444,-11,-12,46,1124320,220
237,c1507,20150525,2445,2444,2446,2446,2425,2425,2438,-19,-6,44,1072880,216
238,c1507,20150526,2425,2438,2408,2417,2362,2412,2403,-26,-35,170,4085740,240
239,c1507,20150527,2412,2403,2409,2428,2392,2392,2415,-11,12,92,2222000,242
240,c1507,20150528,2392,2415,2419,2420,2405,2412,2411,-3,-4,126,3038900,240
241,c1507,20150529,2412,2411,2403,2424,2403,2424,2417,13,6,94,2272240,246
242,c1507,20150601,2424,2417,2402,2423,2402,2418,2418,1,1,58,1402740,242
243,c1507,20150602,2418,2418,2416,2421,2412,2417,2417,-1,-1,128,3093960,250
244,c1507,20150603,2417,2417,2422,2422,2405,2407,2410,-10,-7,26,626720,250
245,c1507,20150604,2407,2410,2401,2401,2348,2351,2369,-59,-41,164,3886460,254
246,c1507,20150605,2351,2369,2329,2329,2308,2325,2322,-44,-47,40,929120,250
247,c1507,20150608,2325,2322,2319,2353,2242,2341,2314,19,-8,64,1481520,260
248,c1507,20150609,2341,2314,2331,2354,2321,2337,2338,23,24,86,2011340,262
249,c1507,20150610,2337,2338,2342,2343,2323,2338,2336,0,-2,76,1775440,262
250,c1507,20150611,2338,2336,2343,2343,2325,2340,2333,4,-3,68,1586700,258
251,c1507,20150612,2340,2333,2325,2349,2323,2331,2330,-2,-3,32,745780,264
252,c1507,20150615,2331,2330,2339,2398,2326,2334,2342,4,12,106,2483560,258
253,c1507,20150616,2334,2342,2339,2354,2323,2338,2340,-4,-2,112,2621000,252
254,c1507,20150617,2338,2340,2350,2365,2334,2334,2354,-6,14,48,1130040,242
255,c1507,20150618,2334,2354,2318,2350,2318,2322,2331,-32,-23,32,745960,240
256,c1507,20150619,2322,2331,2308,2341,2307,2313,2319,-18,-12,118,2736820,242
257,c1507,20150623,2313,2319,2362,2362,2320,2328,2335,9,16,98,2288480,242
258,c1507,20150624,2328,2335,2336,2336,2315,2329,2324,-6,-11,108,2510460,244
259,c1507,20150625,2329,2324,2334,2334,2303,2318,2317,-6,-7,66,1529740,242
260,c1507,20150626,2318,2317,2305,2338,2236,2338,2302,21,-15,144,3315900,242
261,c1507,20150629,2338,2302,2289,2345,2270,2296,2311,-6,9,350,8089060,234
262,c1507,20150630,2296,2311,2333,2365,2219,2242,2286,-69,-25,246,5625280,172
263,c1507,20150701,2242,2286,0,0,0,2286,2286,0,0,0,0,0
264,c1507,20150702,2286,2286,0,0,0,2286,2286,0,0,0,0,0
265,c1507,20150703,2286,2286,0,0,0,2286,2286,0,0,0,0,0
266,c1507,20150706,2286,2286,0,0,0,2286,2286,0,0,0,0,0
267,c1507,20150707,2286,2286,0,0,0,2286,2286,0,0,0,0,0
268,c1507,20150708,2286,2286,0,0,0,2286,2286,0,0,0,0,0
269,c1507,20150709,2286,2286,0,0,0,2286,2286,0,0,0,0,0
270,c1507,20150710,2286,2286,0,0,0,2286,2286,0,0,0,0,0
271,c1507,20150713,2286,2286,0,0,0,2286,2286,0,0,0,0,0
272,c1507,20150714,2286,2286,0,0,0,2286,2286,0,0,0,0,0
273,c1509,20150105,2409,2414,2404,2407,2394,2399,2400,-15,-14,18060,433545440,133760
274,c1509,20150106,2399,2400,2410,2424,2410,2420,2420,20,20,39166,948120600,120658
275,c1509,20150107,2420,2420,2420,2427,2416,2427,2423,7,3,21862,529906280,118322
276,c1509,20150108,2427,2423,2423,2438,2423,2436,2430,13,7,25944,630460100,116010
277,c1509,20150109,2436,2430,2437,2437,2423,2429,2426,-1,-4,28082,681485700,107540
278,c1509,20150112,2429,2426,2430,2435,2423,2432,2430,6,4,14008,340433780,110564
279,c1509,20150113,2432,2430,2427,2436,2418,2434,2426,4,-4,42494,1030994700,113548
280,c1509,20150114,2434,2426,2430,2435,2429,2434,2430,8,4,21318,518237240,117160
281,c1509,20150115,2434,2430,2434,2436,2430,2435,2433,5,3,9914,241263540,115080
282,c1509,20150116,2435,2433,2433,2435,2429,2434,2431,1,-2,15550,378164820,116996
283,c1509,20150119,2434,2431,2437,2444,2432,2442,2439,11,8,26078,636144020,121520
284,c1509,20150120,2442,2439,2442,2444,2440,2442,2442,3,3,13470,328964240,125626
285,c1509,20150121,2442,2442,2444,2452,2440,2443,2446,1,4,29482,721193800,129722
286,c1509,20150122,2443,2446,2445,2448,2443,2447,2445,1,-1,13542,331140480,136128
287,c1509,20150123,2447,2445,2448,2451,2440,2443,2444,-2,-1,20798,508381500,141002
288,c1509,20150126,2443,2444,2443,2460,2440,2459,2452,15,8,31086,762339780,155086
289,c1509,20150127,2459,2452,2461,2475,2460,2474,2469,22,17,43048,1063071560,165046
290,c1509,20150128,2474,2469,2475,2475,2464,2470,2468,1,-1,22370,552119840,169452
291,c1509,20150129,2470,2468,2469,2475,2466,2474,2471,6,3,27088,669566200,164030
292,c1509,20150130,2474,2471,2473,2485,2470,2474,2476,3,5,24854,615407320,168562
293,c1509,20150202,2474,2476,2471,2474,2460,2468,2467,-8,-9,43942,1084104160,174216
294,c1509,20150203,2468,2467,2468,2482,2468,2481,2475,14,8,25738,637132420,178206
295,c1509,20150204,2481,2475,2486,2499,2482,2498,2492,23,17,41672,1038632520,177476
296,c1509,20150205,2498,2492,2493,2525,2491,2492,2509,0,17,121892,3058668840,177612
297,c1509,20150206,2492,2509,2494,2505,2487,2504,2496,-5,-13,30728,767072860,177338
298,c1509,20150209,2504,2496,2504,2517,2501,2513,2510,17,14,42034,1055318840,178738
299,c1509,20150210,2513,2510,2511,2521,2511,2520,2517,10,7,33172,835143460,181710
300,c1509,20150211,2520,2517,2517,2520,2509,2514,2514,-3,-3,37974,954878120,182824
301,c1509,20150212,2514,2514,2513,2517,2508,2508,2512,-6,-2,29652,744977320,179486
302,c1509,20150213,2508,2512,2508,2517,2505,2514,2512,2,0,31052,780048160,175860
303,c1509,20150216,2514,2512,2513,2516,2507,2511,2510,-1,-2,19636,492882340,176040
304,c1509,20150217,2511,2510,2510,2515,2508,2511,2510,1,0,16926,424861860,176754
305,c1509,20150225,2511,2510,2510,2546,2510,2517,2524,7,14,29666,748975140,181366
306,c1509,20150226,2517,2524,2517,2523,2508,2518,2514,-6,-10,25286,635759680,188552
307,c1509,20150227,2518,2514,2516,2537,2516,2536,2528,22,14,45168,1142203980,201628
308,c1509,20150302,2536,2528,2536,2541,2526,2532,2532,4,4,32348,819288580,203734
309,c1509,20150303,2532,2532,2520,2534,2520,2533,2531,1,-1,22852,578455240,207010
310,c1509,20150304,2533,2531,2532,2554,2532,2553,2545,22,14,73514,1871666180,224710
311,c1509,20150305,2553,2545,2545,2549,2535,2541,2541,-4,-4,58014,1474220520,219598
312,c1509,20150306,2541,2541,2542,2546,2538,2539,2540,-2,-1,35748,908308320,220750
313,c1509,20150309,2539,2540,2536,2544,2530,2537,2534,-3,-6,95288,2415471540,242168
314,c1509,20150310,2537,2534,2540,2568,2537,2557,2554,23,20,113638,2902549740,254744
315,c1509,20150311,2557,2554,2558,2572,2555,2559,2564,5,10,75734,1941967980,251916
316,c1509,20150312,2559,2564,2560,2565,2552,2560,2558,-4,-6,39886,1020627560,254020
317,c1509,20150313,2560,2558,2554,2565,2549,2556,2557,-2,-1,50576,1293263560,260970
318,c1509,20150316,2556,2557,2550,2559,2545,2547,2549,-10,-8,76694,1954997160,270360
319,c1509,20150317,2547,2549,2546,2559,2546,2549,2551,0,2,38480,981967220,269842
320,c1509,20150318,2549,2551,2545,2547,2535,2536,2540,-15,-11,77206,1961575040,276182
321,c1509,20150319,2536,2540,2538,2548,2531,2534,2538,-6,-2,67572,1715292140,275988
322,c1509,20150320,2534,2538,2536,2539,2530,2533,2534,-5,-4,36004,912458660,277470
323,c1509,20150323,2533,2534,2538,2562,2537,2554,2551,20,17,48438,1235991720,268446
324,c1509,20150324,2554,2551,2555,2562,2554,2558,2557,7,6,47244,1208282320,269898
325,c1509,20150325,2558,2557,2556,2560,2537,2541,2547,-16,-10,53834,1371177540,272010
326,c1509,20150326,2541,2547,2540,2541,2522,2535,2530,-12,-17,94068,2380091340,286202
327,c1509,20150327,2535,2530,2536,2545,2529,2534,2535,4,5,67944,1722408420,292098
328,c1509,20150330,2534,2535,2533,2538,2526,2529,2529,-6,-6,46606,1179063020,283870
329,c1509,20150331,2529,2529,2528,2531,2512,2524,2524,-5,-5,41674,1052005180,281882
330,c1509,20150401,2524,2524,2520,2529,2510,2520,2521,-4,-3,81512,2055204060,279744
331,c1509,20150402,2520,2521,2520,2531,2520,2522,2525,1,4,43554,1099864860,281290
332,c1509,20150403,2522,2525,2524,2527,2513,2515,2516,-10,-9,87330,2197596760,305908
333,c1509,20150407,2515,2516,2514,2519,2511,2512,2514,-4,-2,67238,1690430900,308096
334,c1509,20150408,2512,2514,2514,2518,2507,2512,2510,-2,-4,56736,1424436180,304404
335,c1509,20150409,2512,2510,2515,2519,2508,2510,2510,0,0,66676,1673892440,301540
336,c1509,20150410,2510,2510,2509,2530,2508,2528,2517,18,7,70566,1776692040,282506
337,c1509,20150413,2528,2517,2527,2535,2522,2531,2529,14,12,52872,1337472740,286156
338,c1509,20150414,2531,2529,2527,2531,2497,2505,2509,-24,-20,100742,2528236840,301074
339,c1509,20150415,2505,2509,2508,2509,2487,2492,2496,-17,-13,119258,2977287900,312216
340,c1509,20150416,2492,2496,2495,2498,2479,2487,2486,-9,-10,88892,2210344660,319946
341,c1509,20150417,2487,2486,2489,2521,2485,2517,2507,31,21,124688,3126189780,290212
342,c1509,20150420,2517,2507,2525,2526,2492,2495,2506,-12,-1,64768,1623239380,290642
343,c1509,20150421,2495,2506,2495,2503,2489,2492,2495,-14,-11,63674,1588725940,288136
344,c1509,20150422,2492,2495,2492,2505,2488,2500,2496,5,1,36390,908618020,284102
345,c1509,20150423,2500,2496,2501,2513,2500,2509,2506,13,10,32862,823741360,280384
346,c1509,20150424,2509,2506,2509,2513,2495,2503,2501,-3,-5,38770,969980240,281930
347,c1509,20150427,2503,2501,2501,2508,2497,2504,2503,3,2,25844,646941440,279066
348,c1509,20150428,2504,2503,2505,2509,2482,2482,2494,-21,-9,83786,2090153520,281172
349,c1509,20150429,2482,2494,2482,2489,2470,2485,2481,-9,-13,76788,1905314900,287032
350,c1509,20150430,2485,2481,2490,2501,2477,2500,2490,19,9,61412,1529601060,286604
351,c1509,20150504,2500,2490,2491,2505,2491,2496,2498,6,8,35374,883817660,285624
352,c1509,20150505,2496,2498,2496,2503,2485,2497,2492,-1,-6,40920,1020104240,285482
353,c1509,20150506,2497,2492,2497,2503,2493,2497,2497,5,5,36158,902912500,283770
354,c1509,20150507,2497,2497,2495,2505,2488,2498,2498,1,1,43778,1093709620,282232
355,c1509,20150508,2498,2498,2496,2501,2491,2496,2496,-2,-2,39546,987314660,277814
356,c1509,20150511,2496,2496,2499,2503,2496,2499,2499,3,3,40722,1017946740,267364
357,c1509,20150512,2499,2499,2496,2500,2494,2497,2496,-2,-3,28056,700382160,263858
358,c1509,20150513,2497,2496,2501,2527,2498,2514,2513,18,17,75796,1905237960,240434
359,c1509,20150514,2514,2513,2515,2518,2505,2512,2509,-1,-4,56628,1421017320,239788
360,c1509,20150515,2512,2509,2524,2524,2509,2514,2513,5,4,45706,1148597100,238478
361,c1509,20150518,2514,2513,2513,2519,2506,2508,2510,-5,-3,34354,862389880,239860
362,c1509,20150519,2508,2510,2508,2516,2507,2516,2510,6,0,50380,1264818940,233090
363,c1509,20150520,2516,2510,2513,2517,2503,2505,2506,-5,-4,75026,1880612100,232686
364,c1509,20150521,2505,2506,2510,2510,2504,2506,2506,0,0,28680,718987240,233984
365,c1509,20150522,2506,2506,2504,2507,2489,2500,2497,-6,-9,80190,2002686400,225264
366,c1509,20150525,2500,2497,2500,2501,2475,2477,2487,-20,-10,64914,1614505700,221870
367,c1509,20150526,2477,2487,2480,2485,2452,2468,2473,-19,-14,54576,1350025400,216440
368,c1509,20150527,2468,2473,2468,2475,2439,2445,2456,-28,-17,78990,1940086540,236730
369,c1509,20150528,2445,2456,2448,2465,2445,2461,2457,5,1,60252,1480800100,245716
370,c1509,20150529,2461,2457,2457,2479,2451,2470,2465,13,8,38876,958572140,243752
371,c1509,20150601,2470,2465,2473,2477,2457,2460,2463,-5,-2,41946,1033321140,245188
372,c1509,20150602,2460,2463,2460,2468,2458,2468,2463,5,0,22496,554154940,238678
373,c1509,20150603,2468,2463,2466,2470,2446,2447,2456,-16,-7,32410,796145160,242234
374,c1509,20150604,2447,2456,2445,2451,2380,2383,2410,-73,-46,211608,5101357320,251978
375,c1509,20150605,2383,2410,2392,2393,2369,2373,2381,-37,-29,122554,2918170240,255450
376,c1509,20150608,2373,2381,2370,2387,2349,2381,2367,0,-14,154820,3665740440,265436
377,c1509,20150609,2381,2367,2385,2390,2372,2383,2379,16,12,66038,1571477940,266456
378,c1509,20150610,2383,2379,2380,2384,2364,2377,2374,-2,-5,69770,1656845780,268954
379,c1509,20150611,2377,2374,2372,2380,2368,2378,2374,4,0,47004,1116262220,264238
380,c1509,20150612,2378,2374,2376,2376,2356,2368,2366,-6,-8,62188,1471786200,267084
381,c1509,20150615,2368,2366,2354,2363,2350,2363,2357,-3,-9,46334,1092212880,266422
382,c1509,20150616,2363,2357,2361,2376,2359,2376,2369,19,12,36694,869544800,265002
383,c1509,20150617,2376,2369,2377,2390,2377,2389,2383,20,14,48530,1156916580,265394
384,c1509,20150618,2389,2383,2388,2392,2382,2388,2387,5,4,48250,1152009080,265044
385,c1509,20150619,2388,2387,2384,2387,2379,2384,2383,-3,-4,31190,743411260,266840
386,c1509,20150623,2384,2383,2393,2413,2387,2394,2395,11,12,43982,1053528640,257432
387,c1509,20150624,2394,2395,2393,2395,2378,2380,2383,-15,-12,38612,920493600,266570
388,c1509,20150625,2380,2383,2380,2387,2373,2375,2378,-8,-5,37314,887386900,279694
389,c1509,20150626,2375,2378,2385,2385,2360,2363,2369,-15,-9,52348,1240385220,283400
390,c1509,20150629,2363,2369,2364,2369,2336,2340,2346,-29,-23,117142,2749313860,285642
391,c1509,20150630,2340,2346,2335,2339,2303,2317,2316,-29,-30,108178,2506087900,293038
392,c1509,20150701,2317,2316,2341,2380,2322,2345,2338,29,22,79210,1852267740,280594
393,c1509,20150702,2345,2338,2340,2345,2327,2343,2336,5,-2,25620,598577420,275016
394,c1509,20150703,2343,2336,2343,2349,2337,2347,2344,11,8,31852,746851800,273218
395,c1509,20150706,2347,2344,2344,2346,2335,2345,2342,1,-2,34270,802638160,271324
396,c1509,20150707,2345,2342,2345,2347,2309,2329,2334,-13,-8,54686,1276697660,271928
397,c1509,20150708,2329,2334,2300,2323,2243,2291,2280,-43,-54,302920,6906972380,255598
398,c1509,20150709,2291,2280,2290,2337,2275,2279,2289,-1,9,171562,3928547960,276264
399,c1509,20150710,2279,2289,2283,2300,2279,2282,2286,-7,-3,133112,3043666980,305606
400,c1509,20150713,2282,2286,2283,2310,2280,2289,2286,3,0,74052,1693057980,312142
401,c1509,20150714,2289,2286,2288,2295,2277,2284,2284,-2,-2,110614,2527036340,333758
402,c1509,20150715,2284,2284,2281,2293,2281,2288,2286,4,2,65978,1508888360,341726
403,c1509,20150716,2288,2286,2300,2344,2281,2332,2320,46,34,166900,3873634640,373566
404,c1509,20150717,2332,2320,2334,2384,2331,2381,2360,61,40,202600,4782584760,399910
405,c1509,20150720,2381,2360,2379,2383,2360,2364,2366,4,6,121922,2885786660,413842
406,c1509,20150721,2364,2366,2365,2379,2356,2368,2367,2,1,117622,2784921720,423628
407,c1509,20150722,2368,2367,2370,2385,2365,2378,2375,11,8,89122,2117431500,433768
408,c1509,20150723,2378,2375,2378,2397,2369,2394,2385,19,10,89130,2126482320,438538
409,c1509,20150724,2394,2385,2395,2396,2363,2373,2382,-12,-3,132838,3165435120,435548
410,c1509,20150727,2373,2382,2369,2370,2320,2350,2342,-32,-40,190514,4463541320,451012
411,c1509,20150728,2350,2342,2344,2388,2344,2387,2370,45,28,140262,3324938160,435076
412,c1509,20150729,2387,2370,2393,2393,2376,2389,2386,19,16,70274,1677141780,436072
413,c1509,20150730,2389,2386,2390,2395,2373,2385,2385,-1,-1,74116,1768074060,434040
414,c1509,20150731,2385,2385,2387,2391,2379,2388,2384,3,-1,41722,995027860,434580
415,c1509,20150803,2388,2384,2381,2391,2380,2390,2387,6,3,53508,1277439700,425776
416,c1509,20150804,2390,2387,2390,2411,2386,2406,2401,19,14,121948,2928599520,422106
417,c1509,20150805,2406,2401,2408,2415,2357,2385,2382,-16,-19,286796,6833577840,426548
418,c1509,20150806,2385,2382,2380,2385,2367,2380,2375,-2,-7,56492,1341861180,429512
419,c1509,20150807,2380,2375,2375,2387,2365,2382,2375,7,0,80338,1908298920,429454
420,c1509,20150810,2382,2375,2385,2402,2375,2401,2388,26,13,101776,2430975240,422814
421,c1509,20150811,2401,2388,2409,2420,2387,2390,2398,2,10,84218,2020031720,424586
422,c1509,20150812,2390,2398,2394,2402,2383,2395,2396,-3,-2,68304,1636789100,417108
423,c1509,20150813,2395,2396,2381,2418,2381,2412,2407,16,11,99080,2385061460,401164
424,c1509,20150814,2412,2407,2412,2415,2406,2409,2410,2,3,51384,1238546000,398882
425,c1509,20150817,2409,2410,2409,2418,2401,2407,2410,-3,0,52218,1258696100,398410
426,c1509,20150818,2407,2410,2402,2416,2402,2409,2409,-1,-1,42660,1028100020,396962
427,c1509,20150819,2409,2409,2405,2425,2405,2422,2417,13,8,127806,3089691560,366216
428,c1509,20150820,2422,2417,2423,2437,2411,2422,2426,5,9,173014,4198033540,309888
429,c1509,20150821,2422,2426,2425,2426,2339,2353,2382,-73,-44,244330,5821831620,237732
430,c1509,20150824,2353,2382,2350,2359,2316,2340,2337,-42,-45,91252,2133339760,214442
431,c1509,20150825,2340,2337,2345,2371,2337,2368,2350,31,13,73040,1716456440,193954
432,c1509,20150826,2368,2350,2368,2374,2354,2358,2362,8,12,33890,800765700,180434
433,c1509,20150827,2358,2362,2359,2365,2318,2345,2340,-17,-22,56954,1333199060,164876
434,c1509,20150828,2345,2340,2346,2355,2335,2342,2347,2,7,64854,1522156180,150526
435,c1509,20150831,2342,2347,2335,2335,2263,2268,2315,-79,-32,80186,1856974960,114126
436,c1509,20150901,2268,2315,2278,2320,2270,2295,2290,-20,-25,10488,240278700,94630
437,c1509,20150902,2295,2290,2320,2320,2290,2300,2313,10,23,8800,203623880,89782
438,c1509,20150907,2300,2313,2312,2312,2266,2279,2280,-34,-33,14216,324177380,78296
439,c1509,20150908,2279,2280,2270,2350,2270,2310,2320,30,40,9048,209928880,70454
440,c1509,20150909,2310,2320,2300,2318,2246,2246,2297,-74,-23,18586,426954180,57242
441,c1509,20150910,2246,2297,2240,2258,2210,2220,2237,-77,-60,15968,357224500,54848
442,c1509,20150911,2220,2237,2205,2206,2195,2195,2201,-42,-36,4380,96409300,45640
443,c1509,20150914,2195,2201,2150,2170,2120,2170,2140,-31,-61,3760,80487600,41764
444,c1509,20150915,2170,2140,2150,2200,2100,2118,2153,-22,13,5576,120087780,36032
445,c1509,20150916,2118,2153,2118,2189,2080,2150,2261,-3,108,4878,104924620,0
446,c1511,20150105,2235,2234,2223,2229,2220,2229,2224,-5,-10,106,2358080,756
447,c1511,20150106,2229,2224,2240,2240,2233,2234,2237,10,13,70,1566120,770
448,c1511,20150107,2234,2237,2238,2246,2212,2241,2238,4,1,108,2417180,784
449,c1511,20150108,2241,2238,2240,2255,2237,2253,2246,15,8,92,2066940,750
450,c1511,20150109,2253,2246,2250,2250,2234,2243,2240,-3,-6,78,1747380,738
451,c1511,20150112,2243,2240,2245,2248,2244,2248,2245,8,5,32,718680,738
452,c1511,20150113,2248,2245,2240,2249,2240,2247,2243,2,-2,52,1166840,736
453,c1511,20150114,2247,2243,2239,2244,2223,2235,2232,-8,-11,138,3080420,694
454,c1511,20150115,2235,2232,2238,2243,2235,2243,2237,11,5,66,1476840,694
455,c1511,20150116,2243,2237,2238,2243,2238,2239,2239,2,2,12,268720,690
456,c1511,20150119,2239,2239,2247,2268,2246,2257,2258,18,19,132,2980600,688
457,c1511,20150120,2257,2258,2257,2270,2256,2260,2262,2,4,86,1945660,634
458,c1511,20150121,2260,2262,2260,2277,2260,2275,2272,13,10,138,3136260,518
459,c1511,20150122,2275,2272,2275,2281,2270,2281,2276,9,4,56,1274940,508
460,c1511,20150123,2281,2276,2275,2275,2270,2274,2271,-2,-5,46,1045080,490
461,c1511,20150126,2274,2271,2278,2284,2278,2284,2278,13,7,18,410160,474
462,c1511,20150127,2284,2278,2295,2305,2290,2302,2298,24,20,120,2758140,458
463,c1511,20150128,2302,2298,2299,2299,2288,2299,2293,1,-5,86,1972780,416
464,c1511,20150129,2299,2293,2299,2304,2299,2304,2299,11,6,14,321960,414
465,c1511,20150130,2304,2299,2312,2312,2302,2302,2310,3,11,52,1201600,410
466,c1511,20150202,2302,2310,2295,2302,2295,2302,2297,-8,-13,40,918880,388
467,c1511,20150203,2302,2297,2304,2309,2303,2309,2306,12,9,14,322960,376
468,c1511,20150204,2309,2306,2315,2330,2315,2326,2325,20,19,52,1209380,352
469,c1511,20150205,2326,2325,2332,2349,2328,2328,2339,3,14,30,701820,342
470,c1511,20150206,2328,2339,2326,2329,2312,2329,2323,-10,-16,10,232360,342
471,c1511,20150209,2329,2323,2334,2339,2330,2336,2333,13,10,30,700080,334
472,c1511,20150210,2336,2333,2334,2343,2334,2335,2336,2,3,36,840960,326
473,c1511,20150211,2335,2336,2325,2325,2316,2316,2318,-20,-18,30,695600,314
474,c1511,20150212,2316,2318,2313,2313,2312,2312,2312,-6,-6,6,138740,308
475,c1511,20150213,2312,2312,2310,2311,2310,2311,2310,-1,-2,6,138640,304
476,c1511,20150216,2311,2310,2300,2306,2300,2306,2301,-4,-9,10,230120,300
477,c1511,20150217,2306,2301,2302,2302,2271,2286,2284,-15,-17,44,1005180,294
478,c1511,20150225,2286,2284,2294,2300,2269,2269,2293,-15,9,14,321020,298
479,c1511,20150226,2269,2293,2272,2309,2272,2309,2295,16,2,50,1147740,328
480,c1511,20150227,2309,2295,2300,2321,2300,2318,2314,23,19,50,1157140,306
481,c1511,20150302,2318,2314,2324,2330,2317,2321,2320,7,6,50,1160420,276
482,c1511,20150303,2321,2320,2328,2328,2320,2325,2322,5,2,14,325200,272
483,c1511,20150304,2325,2322,2328,2340,2328,2340,2334,18,12,48,1120720,270
484,c1511,20150305,2340,2334,2328,2345,2328,2336,2335,2,1,36,840720,266
485,c1511,20150306,2336,2335,2316,2332,2292,2330,2320,-5,-15,58,1345980,238
486,c1511,20150309,2330,2320,2334,2335,2317,2319,2325,-1,5,24,558140,240
487,c1511,20150310,2319,2325,2329,2338,2329,2338,2331,13,6,12,279820,240
488,c1511,20150311,2338,2331,2332,2332,2332,2332,2332,1,1,2,46640,240
489,c1511,20150312,2332,2332,0,0,0,2332,2332,0,0,0,0,240
490,c1511,20150313,2332,2332,2324,2324,2324,2324,2324,-8,-8,2,46480,238
491,c1511,20150316,2324,2324,2328,2328,2328,2328,2328,4,4,6,139680,242
492,c1511,20150317,2328,2328,2333,2338,2333,2335,2335,7,7,20,467160,254
493,c1511,20150318,2335,2335,2332,2332,2322,2325,2326,-10,-9,12,279140,246
494,c1511,20150319,2325,2326,2341,2341,2333,2333,2334,7,8,20,466940,240
495,c1511,20150320,2333,2334,2336,2339,2335,2339,2336,5,2,62,1448720,258
496,c1511,20150323,2339,2336,2347,2359,2342,2353,2355,17,19,96,2261540,234
497,c1511,20150324,2353,2355,2354,2355,2350,2350,2353,-5,-2,46,1082720,198
498,c1511,20150325,2350,2353,2337,2345,2337,2340,2343,-13,-10,26,609280,188
499,c1511,20150326,2340,2343,2335,2340,2334,2339,2337,-4,-6,10,233760,186
500,c1511,20150327,2339,2337,2351,2418,2310,2340,2349,3,12,54,1268540,190
501,c1511,20150330,2340,2349,0,0,0,2348,2348,-1,-1,0,0,190
502,c1511,20150331,2348,2348,0,0,0,2348,2348,0,0,0,0,190
503,c1511,20150401,2348,2348,2340,2340,2338,2338,2338,-10,-10,10,233840,180
504,c1511,20150402,2338,2338,2336,2336,2336,2336,2336,-2,-2,2,46720,180
505,c1511,20150403,2336,2336,2327,2327,2327,2327,2327,-9,-9,10,232700,174
506,c1511,20150407,2327,2327,2328,2352,2322,2325,2331,-2,4,12,279740,174
507,c1511,20150408,2325,2331,2335,2337,2327,2327,2331,-4,0,16,373100,170
508,c1511,20150409,2327,2331,2326,2326,2321,2321,2324,-10,-7,24,557820,148
509,c1511,20150410,2321,2324,2332,2339,2324,2339,2328,15,4,30,698500,146
510,c1511,20150413,2339,2328,2342,2342,2337,2337,2339,9,11,4,93580,146
511,c1511,20150414,2337,2339,2337,2338,2317,2320,2329,-19,-10,80,1863420,146
512,c1511,20150415,2320,2329,2315,2335,2315,2335,2326,6,-3,16,372240,146
513,c1511,20150416,2335,2326,2337,2349,2315,2331,2332,5,6,44,1026200,146
514,c1511,20150417,2331,2332,2347,2350,2335,2349,2344,17,12,42,984640,132
515,c1511,20150420,2349,2344,2343,2349,2336,2341,2342,-3,-2,42,984020,138
516,c1511,20150421,2341,2342,2335,2347,2332,2335,2337,-7,-5,80,1869900,112
517,c1511,20150422,2335,2337,2340,2345,2340,2340,2341,3,4,6,140500,114
518,c1511,20150423,2340,2341,2346,2346,2346,2346,2346,5,5,2,46920,112
519,c1511,20150424,2346,2346,2342,2348,2342,2348,2345,2,-1,4,93800,110
520,c1511,20150427,2348,2345,2343,2350,2342,2350,2347,5,2,34,798040,114
521,c1511,20150428,2350,2347,2344,2344,2325,2330,2335,-17,-12,58,1354460,132
522,c1511,20150429,2330,2335,2329,2330,2321,2328,2325,-7,-10,102,2372340,180
523,c1511,20150430,2328,2325,2312,2340,2305,2338,2328,13,3,92,2142020,194
524,c1511,20150504,2338,2328,2331,2344,2331,2340,2339,12,11,12,280680,196
525,c1511,20150505,2340,2339,2334,2337,2334,2337,2335,-2,-4,14,327000,200
526,c1511,20150506,2337,2335,0,0,0,2336,2336,1,1,0,0,200
527,c1511,20150507,2336,2336,2328,2344,2323,2331,2332,-5,-4,42,979840,204
528,c1511,20150508,2331,2332,2327,2337,2273,2322,2298,-10,-34,424,9746280,214
529,c1511,20150511,2322,2298,2326,2330,2314,2321,2323,23,25,60,1394320,222
530,c1511,20150512,2321,2323,2324,2328,2320,2328,2326,5,3,20,465200,220
531,c1511,20150513,2328,2326,2340,2355,2335,2335,2343,9,17,46,1077960,232
532,c1511,20150514,2335,2343,2337,2337,2334,2335,2336,-8,-7,14,327080,226
533,c1511,20150515,2335,2336,2339,2428,2249,2332,2343,-4,7,158,3702140,228
534,c1511,20150518,2332,2343,2334,2334,2322,2322,2325,-21,-18,14,325540,230
535,c1511,20150519,2322,2325,2323,2324,2318,2324,2321,-1,-4,26,603660,232
536,c1511,20150520,2324,2321,2324,2325,2312,2318,2321,-3,0,16,371360,228
537,c1511,20150521,2318,2321,2322,2322,2322,2322,2322,1,1,2,46440,228
538,c1511,20150522,2322,2322,2321,2323,2317,2323,2321,1,-1,20,464200,238
539,c1511,20150525,2323,2321,2319,2319,2315,2315,2317,-6,-4,4,92680,238
540,c1511,20150526,2315,2317,2316,2321,2311,2311,2316,-6,-1,8,185280,240
541,c1511,20150527,2311,2316,2325,2333,2310,2310,2320,-6,4,50,1160300,242
542,c1511,20150528,2310,2320,2318,2324,2318,2318,2319,-2,-1,16,371100,236
543,c1511,20150529,2318,2319,2331,2331,2316,2319,2321,0,2,42,974920,222
544,c1511,20150601,2319,2321,2325,2325,2319,2319,2320,-2,-1,50,1160380,196
545,c1511,20150602,2319,2320,2320,2323,2320,2323,2320,3,0,68,1578000,146
546,c1511,20150603,2323,2320,2320,2327,2320,2324,2321,4,1,30,696380,124
547,c1511,20150604,2324,2321,2310,2310,2297,2308,2307,-13,-14,50,1153620,116
548,c1511,20150605,2308,2307,2304,2305,2288,2288,2299,-19,-8,6,137940,114
549,c1511,20150608,2288,2299,2294,2319,2288,2312,2300,13,1,46,1058400,120
550,c1511,20150609,2312,2300,2311,2316,2287,2300,2306,0,6,22,507380,114
551,c1511,20150610,2300,2306,2303,2303,2299,2299,2302,-7,-4,16,368400,106
552,c1511,20150611,2299,2302,2304,2304,2304,2304,2304,2,2,2,46080,106
553,c1511,20150612,2304,2304,2303,2312,2295,2312,2302,8,-2,14,322360,98
554,c1511,20150615,2312,2302,2305,2305,2292,2292,2300,-10,-2,36,828260,102
555,c1511,20150616,2292,2300,2304,2318,2293,2312,2309,12,9,78,1801460,100
556,c1511,20150617,2312,2309,2312,2312,2301,2304,2305,-5,-4,6,138340,98
557,c1511,20150618,2304,2305,0,0,0,2305,2305,0,0,0,0,98
558,c1511,20150619,2305,2305,2300,2312,2300,2312,2306,7,1,4,92240,98
559,c1511,20150623,2312,2306,2324,2324,2319,2319,2321,13,15,4,92860,100
560,c1511,20150624,2319,2321,2312,2316,2294,2300,2302,-21,-19,84,1933760,102
561,c1511,20150625,2300,2302,2309,2314,2295,2301,2305,-1,3,96,2213100,100
562,c1511,20150626,2301,2305,2291,2305,2290,2305,2295,0,-10,20,459120,104
563,c1511,20150629,2305,2295,2298,2304,2291,2291,2296,-4,1,30,689060,104
564,c1511,20150630,2291,2296,2290,2297,2283,2291,2288,-5,-8,46,1052700,94
565,c1511,20150701,2291,2288,2295,2312,2294,2294,2303,6,15,24,552720,100
566,c1511,20150702,2294,2303,2295,2306,2290,2305,2296,2,-7,46,1056360,84
567,c1511,20150703,2305,2296,2315,2315,2303,2304,2306,8,10,14,322960,82
568,c1511,20150706,2304,2306,2295,2307,2284,2297,2294,-9,-12,70,1605980,90
569,c1511,20150707,2297,2294,2295,2295,2265,2265,2286,-29,-8,38,868780,88
570,c1511,20150708,2265,2286,2250,2263,2209,2239,2236,-47,-50,84,1878780,76
571,c1511,20150709,2239,2236,2283,2289,2252,2257,2271,21,35,22,499740,72
572,c1511,20150710,2257,2271,2262,2275,2259,2262,2265,-9,-6,30,679580,68
573,c1511,20150713,2262,2265,2249,2249,2235,2249,2244,-16,-21,72,1616100,56
574,c1511,20150714,2249,2244,2236,2261,2229,2239,2242,-5,-2,26,582960,56
575,c1511,20150715,2239,2242,2235,2246,2235,2246,2243,4,1,12,269240,58
576,c1511,20150716,2246,2243,2260,2260,2247,2247,2251,4,8,28,630340,64
577,c1511,20150717,2247,2251,2266,2266,2250,2250,2255,-1,4,6,135320,66
578,c1511,20150720,2250,2255,2238,2246,2198,2216,2232,-39,-23,68,1518200,68
579,c1511,20150721,2216,2232,2235,2235,2163,2224,2217,-8,-15,28,620780,68
580,c1511,20150722,2224,2217,2243,2243,2212,2225,2227,8,10,108,2406020,78
581,c1511,20150723,2225,2227,2233,2235,2191,2224,2215,-3,-12,50,1107700,76
582,c1511,20150724,2224,2215,2170,2243,2170,2208,2213,-7,-2,20,442600,74
583,c1511,20150727,2208,2213,2208,2235,2150,2162,2182,-51,-31,68,1483980,78
584,c1511,20150728,2162,2182,2181,2181,2128,2171,2162,-11,-20,28,605460,84
585,c1511,20150729,2171,2162,2170,2170,2148,2158,2159,-4,-3,50,1079840,86
586,c1511,20150730,2158,2159,2119,2160,2119,2150,2142,-9,-17,66,1414280,74
587,c1511,20150731,2150,2142,2153,2153,2140,2143,2144,1,2,14,300200,74
588,c1511,20150803,2143,2144,2137,2137,2137,2137,2137,-7,-7,6,128220,72
589,c1511,20150804,2137,2137,2159,2159,2140,2155,2150,18,13,22,473200,70
590,c1511,20150805,2155,2150,2175,2175,2100,2118,2116,-32,-34,136,2877800,158
591,c1511,20150806,2118,2116,2119,2119,2083,2108,2111,-8,-5,16,337780,148
592,c1511,20150807,2108,2111,2090,2090,2073,2073,2077,-38,-34,16,332340,144
593,c1511,20150810,2073,2077,2092,2095,2076,2090,2086,13,9,60,1252080,136
594,c1511,20150811,2090,2086,2093,2118,2078,2078,2093,-8,7,58,1214080,116
595,c1511,20150812,2078,2093,0,0,0,2093,2093,0,0,0,0,116
596,c1511,20150813,2093,2093,2059,2078,2059,2075,2065,-18,-28,28,578200,118
597,c1511,20150814,2075,2065,2075,2075,2062,2072,2067,7,2,26,537540,114
598,c1511,20150817,2072,2067,2108,2108,2035,2054,2057,-13,-10,62,1275580,122
599,c1511,20150818,2054,2057,2043,2063,2043,2060,2056,3,-1,42,863780,124
600,c1511,20150819,2060,2056,2064,2064,2064,2064,2064,8,8,2,41280,124
601,c1511,20150820,2064,2064,0,0,0,2054,2054,-10,-10,0,0,124
602,c1511,20150821,2054,2054,2054,2056,2037,2042,2046,-12,-8,20,409200,132
603,c1511,20150824,2042,2046,2029,2043,2029,2030,2031,-16,-15,32,649980,132
604,c1511,20150825,2030,2031,2048,2060,2022,2042,2043,11,12,42,858420,132
605,c1511,20150826,2042,2043,2043,2060,2035,2037,2045,-6,2,74,1513420,132
606,c1511,20150827,2037,2045,2037,2057,2031,2057,2045,12,0,42,859260,136
607,c1511,20150828,2057,2045,2054,2068,2046,2048,2052,3,7,32,656880,130
608,c1511,20150831,2048,2052,2049,2054,2033,2033,2042,-19,-10,38,776020,130
609,c1511,20150901,2033,2042,2045,2047,2015,2020,2029,-22,-13,20,405820,120
610,c1511,20150902,2020,2029,1994,2025,1991,2025,2005,-4,-24,10,200520,118
611,c1511,20150907,2025,2005,2012,2012,1976,1976,1995,-29,-10,18,359260,132
612,c1511,20150908,1976,1995,2009,2009,1965,1972,1980,-23,-15,86,1703640,140
613,c1511,20150909,1972,1980,1982,1982,1955,1964,1967,-16,-13,70,1377180,154
614,c1511,20150910,1964,1967,1936,1960,1935,1949,1948,-18,-19,62,1208060,182
615,c1511,20150911,1949,1948,1951,1952,1942,1943,1948,-5,0,18,350800,184
616,c1511,20150914,1943,1948,1935,1963,1934,1942,1943,-6,-5,76,1476960,182
617,c1511,20150915,1942,1943,1943,1950,1910,1949,1940,6,-3,36,698400,180
618,c1511,20150916,1949,1940,1956,1962,1950,1957,1955,17,15,64,1251540,150
619,c1511,20150917,1957,1955,1974,1974,1932,1951,1950,-4,-5,90,1755240,140
620,c1511,20150918,1951,1950,1942,1959,1931,1941,1943,-9,-7,142,2760100,110
621,c1511,20150921,1941,1943,1964,1984,1946,1949,1955,6,12,252,4928360,110
622,c1511,20150922,1949,1955,1950,1952,1944,1950,1949,-5,-6,24,467800,116
623,c1511,20150923,1950,1949,1921,1921,1921,1921,1921,-28,-28,6,115260,114
624,c1511,20150924,1921,1921,1944,1958,1941,1953,1949,32,28,30,584940,104
625,c1511,20150925,1953,1949,1934,1968,1934,1939,1952,-10,3,8,156180,98
626,c1511,20150928,1939,1952,1937,1959,1931,1936,1940,-16,-12,8,155260,100
627,c1511,20150929,1936,1940,1967,1967,1916,1919,1940,-21,0,14,271680,96
628,c1511,20150930,1919,1940,1858,1900,1858,1892,1887,-48,-53,18,339720,90
629,c1511,20151008,1892,1887,0,0,0,1887,1887,0,0,0,0,90
630,c1511,20151009,1887,1887,1899,1903,1899,1903,1900,16,13,10,190040,84
631,c1511,20151012,1903,1900,1841,1934,1831,1905,1890,5,-10,26,491560,84
632,c1511,20151013,1905,1890,0,0,0,1890,1890,0,0,0,0,84
633,c1511,20151014,1890,1890,0,0,0,1890,1890,0,0,0,0,84
634,c1511,20151015,1890,1890,0,0,0,1890,1890,0,0,0,0,84
635,c1511,20151016,1890,1890,0,0,0,1890,1890,0,0,0,0,84
636,c1511,20151019,1890,1890,1942,1942,1942,1942,1942,52,52,2,38840,82
637,c1511,20151020,1942,1942,1865,1866,1865,1866,1865,-76,-77,4,74620,80
638,c1511,20151021,1866,1865,1830,1830,1830,1830,1830,-35,-35,2,36600,80
639,c1511,20151022,1830,1830,1783,1898,1757,1831,1796,1,-34,88,1580740,84
640,c1511,20151023,1831,1796,1860,1860,1786,1810,1819,14,23,16,291120,82
641,c1511,20151026,1810,1819,1848,1848,1755,1755,1801,-64,-18,4,72060,80
642,c1511,20151027,1755,1801,1752,1856,1736,1855,1808,54,7,90,1627780,88
643,c1511,20151028,1855,1808,1846,1879,1801,1806,1829,-2,21,16,292700,84
644,c1511,20151029,1806,1829,1801,1830,1801,1830,1815,1,-14,4,72620,82
645,c1511,20151030,1830,1815,1791,1886,1790,1825,1820,10,5,36,655440,74
646,c1511,20151102,1825,1820,1801,1801,1801,1801,1801,-19,-19,2,36020,0
647,c1511,20151103,1801,1801,0,0,0,1850,1850,49,49,0,0,0
648,c1511,20151104,1850,1850,0,0,0,1850,1850,0,0,0,0,0
649,c1511,20151105,1850,1850,0,0,0,1850,1850,0,0,0,0,0
650,c1511,20151106,1850,1850,0,0,0,1850,1850,0,0,0,0,0
651,c1511,20151109,1850,1850,0,0,0,1850,1850,0,0,0,0,0
652,c1511,20151110,1850,1850,0,0,0,1850,1850,0,0,0,0,0
653,c1511,20151111,1850,1850,0,0,0,1850,1850,0,0,0,0,0
654,c1511,20151112,1850,1850,0,0,0,1850,1850,0,0,0,0,0
655,c1511,20151113,1850,1850,0,0,0,1801,1801,-49,-49,0,0,0
656,c1601,20150119,2431,2431,2318,2322,2280,2289,2291,-142,-140,6392,146473040,4652
657,c1601,20150120,2289,2291,2291,2293,2289,2291,2290,0,-1,760,17406880,5136
658,c1601,20150121,2291,2290,2291,2294,2282,2284,2288,-6,-2,1450,33179980,5970
659,c1601,20150122,2284,2288,2285,2286,2280,2283,2282,-5,-6,1382,31542440,7078
660,c1601,20150123,2283,2282,2280,2284,2278,2279,2281,-3,-1,4468,101929020,11050
661,c1601,20150126,2279,2281,2282,2286,2276,2285,2283,4,2,3028,69130940,12224
662,c1601,20150127,2285,2283,2287,2291,2286,2287,2289,4,6,2080,47611220,12728
663,c1601,20150128,2287,2289,2284,2293,2284,2291,2289,2,0,3080,70530880,14242
664,c1601,20150129,2291,2289,2289,2302,2288,2300,2292,11,3,1284,29437880,14816
665,c1601,20150130,2300,2292,2300,2300,2293,2295,2296,3,4,1068,24527000,15186
666,c1601,20150202,2295,2296,2295,2299,2284,2291,2291,-5,-5,5642,129277100,17688
667,c1601,20150203,2291,2291,2291,2299,2288,2297,2294,6,3,928,21294780,17840
668,c1601,20150204,2297,2294,2299,2304,2293,2295,2299,1,5,5812,133641240,18514
669,c1601,20150205,2295,2299,2293,2300,2286,2286,2296,-13,-3,2566,58919120,18340
670,c1601,20150206,2286,2296,2288,2293,2282,2293,2288,-3,-8,834,19088940,18496
671,c1601,20150209,2293,2288,2295,2302,2291,2300,2296,12,8,1304,29951700,18954
672,c1601,20150210,2300,2296,2301,2302,2293,2301,2299,5,3,4216,96930500,20804
673,c1601,20150211,2301,2299,2298,2302,2297,2300,2298,1,-1,1872,43036200,21822
674,c1601,20150212,2300,2298,2298,2310,2298,2300,2304,2,6,2322,53511520,22854
675,c1601,20150213,2300,2304,2347,2347,2301,2309,2310,5,6,2100,48511380,22800
676,c1601,20150216,2309,2310,2309,2309,2304,2307,2306,-3,-4,472,10884360,22670
677,c1601,20150217,2307,2306,2306,2311,2304,2307,2306,1,0,366,8441980,22602
678,c1601,20150225,2307,2306,2304,2312,2300,2303,2304,-3,-2,776,17885320,22682
679,c1601,20150226,2303,2304,2304,2306,2297,2305,2300,1,-4,1610,37038700,23184
680,c1601,20150227,2305,2300,2304,2312,2303,2311,2308,11,8,2762,63769760,24354
681,c1601,20150302,2311,2308,2312,2317,2310,2316,2313,8,5,2322,53728080,25364
682,c1601,20150303,2316,2313,2315,2315,2310,2314,2314,1,1,1346,31149360,25854
683,c1601,20150304,2314,2314,2315,2327,2315,2321,2322,7,8,5048,117226420,28752
684,c1601,20150305,2321,2322,2318,2319,2313,2316,2315,-6,-7,1886,43668860,28938
685,c1601,20150306,2316,2315,2316,2316,2301,2304,2305,-11,-10,1866,43022120,28774
686,c1601,20150309,2304,2305,2303,2308,2289,2298,2293,-7,-12,6680,153204460,25258
687,c1601,20150310,2298,2293,2300,2306,2296,2304,2303,11,10,1954,45007080,25236
688,c1601,20150311,2304,2303,2303,2313,2303,2304,2308,1,5,5180,119571260,26296
689,c1601,20150312,2304,2308,2304,2310,2303,2305,2305,-3,-3,2986,68840460,26236
690,c1601,20150313,2305,2305,2305,2308,2299,2300,2303,-5,-2,1930,44453320,26624
691,c1601,20150316,2300,2303,2300,2301,2296,2300,2298,-3,-5,2124,48813220,26724
692,c1601,20150317,2300,2298,2300,2306,2300,2304,2304,6,6,1362,31381660,26442
693,c1601,20150318,2304,2304,2302,2303,2295,2297,2297,-7,-7,3508,80611960,27100
694,c1601,20150319,2297,2297,2301,2305,2297,2298,2299,1,2,2240,51516660,27970
695,c1601,20150320,2298,2299,2298,2301,2296,2300,2299,1,0,1300,29887100,28000
696,c1601,20150323,2300,2299,2300,2320,2300,2306,2306,7,7,2408,55545420,28198
697,c1601,20150324,2306,2306,2307,2310,2306,2310,2308,4,2,3136,72388980,28620
698,c1601,20150325,2310,2308,2310,2312,2300,2304,2306,-4,-2,3388,78142940,29244
699,c1601,20150326,2304,2306,2304,2311,2300,2308,2304,2,-2,3084,71080020,29556
700,c1601,20150327,2308,2304,2307,2312,2303,2304,2308,0,4,2848,65748560,29798
701,c1601,20150330,2304,2308,2303,2310,2303,2307,2305,-1,-3,1010,23287440,29866
702,c1601,20150331,2307,2305,2307,2309,2301,2306,2305,1,0,1636,37718340,29904
703,c1601,20150401,2306,2305,2303,2308,2302,2305,2304,0,-1,1624,37433140,29706
704,c1601,20150402,2305,2304,2306,2313,2299,2301,2303,-3,-1,1788,41179440,30656
705,c1601,20150403,2301,2303,2303,2305,2298,2300,2299,-3,-4,4346,99953780,31392
706,c1601,20150407,2300,2299,2300,2305,2299,2304,2302,5,3,2338,53842360,31454
707,c1601,20150408,2304,2302,2303,2308,2299,2300,2302,-2,0,2844,65479760,32628
708,c1601,20150409,2300,2302,2300,2304,2300,2303,2301,1,-1,1272,29278800,32644
709,c1601,20150410,2303,2301,2302,2304,2299,2304,2301,3,0,4650,107006640,34220
710,c1601,20150413,2304,2301,2304,2309,2300,2305,2304,4,3,3586,82638800,34004
711,c1601,20150414,2305,2304,2305,2308,2298,2300,2300,-4,-4,3006,69157020,34336
712,c1601,20150415,2300,2300,2305,2305,2292,2295,2295,-5,-5,8090,185741780,35108
713,c1601,20150416,2295,2295,2296,2304,2293,2294,2297,-1,2,5096,117081960,35204
714,c1601,20150417,2294,2297,2296,2308,2294,2306,2302,9,5,6002,138220360,36178
715,c1601,20150420,2306,2302,2309,2315,2297,2297,2302,-5,0,3774,86892940,36930
716,c1601,20150421,2297,2302,2299,2304,2297,2297,2299,-5,-3,2554,58722140,37296
717,c1601,20150422,2297,2299,2297,2302,2296,2299,2299,0,0,2482,57082940,38144
718,c1601,20150423,2299,2299,2302,2307,2299,2300,2300,1,1,3396,78132340,39974
719,c1601,20150424,2300,2300,2299,2303,2289,2292,2294,-8,-6,7666,175863700,42122
720,c1601,20150427,2292,2294,2292,2293,2284,2286,2287,-8,-7,5294,121100200,44442
721,c1601,20150428,2286,2287,2287,2287,2268,2269,2275,-18,-12,12138,276147980,50940
722,c1601,20150429,2269,2275,2265,2269,2252,2258,2258,-17,-17,15064,340289800,58654
723,c1601,20150430,2258,2258,2260,2275,2257,2273,2266,15,8,10000,226677620,58874
724,c1601,20150504,2273,2266,2270,2277,2266,2273,2271,7,5,3498,79456180,59450
725,c1601,20150505,2273,2271,2272,2277,2268,2272,2271,1,0,7630,173312320,63338
726,c1601,20150506,2272,2271,2274,2280,2272,2276,2275,5,4,7032,160001120,62948
727,c1601,20150507,2276,2275,2273,2279,2269,2275,2273,0,-2,5470,124386940,64178
728,c1601,20150508,2275,2273,2278,2278,2270,2274,2272,1,-1,4116,93541160,65276
729,c1601,20150511,2274,2272,2274,2276,2271,2275,2274,3,2,2574,58534040,65056
730,c1601,20150512,2275,2274,2274,2274,2266,2267,2268,-7,-6,6310,143147140,68182
731,c1601,20150513,2267,2268,2269,2295,2265,2265,2273,-3,5,13368,303877020,67892
732,c1601,20150514,2265,2273,2266,2272,2261,2265,2265,-8,-8,4422,100175860,68676
733,c1601,20150515,2265,2265,2268,2272,2265,2272,2267,7,2,2988,67766420,68778
734,c1601,20150518,2272,2267,2270,2272,2265,2268,2268,1,1,2400,54445360,68834
735,c1601,20150519,2268,2268,2268,2278,2266,2274,2273,6,5,5432,123500300,67488
736,c1601,20150520,2274,2273,2274,2274,2264,2265,2268,-8,-5,7296,165482600,68102
737,c1601,20150521,2265,2268,2265,2268,2247,2253,2258,-15,-10,16920,382142540,78326
738,c1601,20150522,2253,2258,2250,2254,2236,2250,2248,-8,-10,14356,322730500,83646
739,c1601,20150525,2250,2248,2250,2252,2228,2231,2238,-17,-10,18434,412690880,88282
740,c1601,20150526,2231,2238,2233,2235,2212,2228,2228,-10,-10,11576,257989880,88832
741,c1601,20150527,2228,2228,2229,2229,2194,2201,2212,-27,-16,23104,511189320,94242
742,c1601,20150528,2201,2212,2211,2215,2202,2213,2207,1,-5,16400,362096100,93644
743,c1601,20150529,2213,2207,2210,2225,2205,2220,2215,13,8,14016,310581820,98372
744,c1601,20150601,2220,2215,2220,2227,2210,2210,2214,-5,-1,15602,345526600,104342
745,c1601,20150602,2210,2214,2211,2216,2208,2215,2211,1,-3,8120,179580720,104980
746,c1601,20150603,2215,2211,2215,2218,2205,2206,2209,-5,-2,14090,311375320,107330
747,c1601,20150604,2206,2209,2206,2209,2137,2153,2168,-56,-41,91280,1979637800,143774
748,c1601,20150605,2153,2168,2159,2162,2141,2143,2152,-25,-16,30980,666906200,152570
749,c1601,20150608,2143,2152,2150,2158,2128,2154,2144,2,-8,45810,982240720,167236
750,c1601,20150609,2154,2144,2156,2170,2133,2137,2146,-7,2,53204,1141829140,188496
751,c1601,20150610,2137,2146,2132,2140,2122,2131,2128,-15,-18,55188,1174580660,209190
752,c1601,20150611,2131,2128,2130,2159,2126,2155,2144,27,16,82536,1769593500,219550
753,c1601,20150612,2155,2144,2150,2154,2131,2147,2144,3,0,70372,1509354600,236360
754,c1601,20150615,2147,2144,2132,2142,2126,2140,2135,-4,-9,60644,1295009520,247362
755,c1601,20150616,2140,2135,2139,2151,2139,2147,2147,12,12,32076,688766100,255466
756,c1601,20150617,2147,2147,2150,2157,2136,2142,2146,-5,-1,31354,673155820,259618
757,c1601,20150618,2142,2146,2145,2146,2123,2141,2137,-5,-9,27584,589615940,262404
758,c1601,20150619,2141,2137,2140,2145,2129,2134,2138,-3,1,18254,390288400,266130
759,c1601,20150623,2134,2138,2140,2153,2135,2148,2147,10,9,28050,602387100,264858
760,c1601,20150624,2148,2147,2148,2150,2133,2137,2139,-10,-8,24634,526972860,273724
761,c1601,20150625,2137,2139,2137,2142,2133,2137,2137,-2,-2,17562,375396520,276732
762,c1601,20150626,2137,2137,2141,2145,2123,2131,2131,-6,-6,69270,1476409120,278460
763,c1601,20150629,2131,2131,2138,2140,2111,2121,2126,-10,-5,74728,1588888460,273656
764,c1601,20150630,2121,2126,2115,2120,2106,2117,2111,-9,-15,64010,1351588760,278686
765,c1601,20150701,2117,2111,2130,2158,2124,2129,2131,18,20,54558,1163013040,266624
766,c1601,20150702,2129,2131,2128,2142,2124,2135,2131,4,0,34944,744841760,261496
767,c1601,20150703,2135,2131,2139,2148,2136,2143,2143,12,12,37884,812037640,260278
768,c1601,20150706,2143,2143,2141,2142,2122,2127,2129,-16,-14,43892,934644140,252882
769,c1601,20150707,2127,2129,2127,2137,2059,2088,2097,-41,-32,175176,3674498940,276616
770,c1601,20150708,2088,2097,2067,2078,2017,2061,2045,-36,-52,316996,6485331020,268578
771,c1601,20150709,2061,2045,2081,2109,2061,2078,2081,33,36,214242,4459086720,250708
772,c1601,20150710,2078,2081,2086,2124,2081,2098,2103,17,22,205904,4330914780,280326
773,c1601,20150713,2098,2103,2102,2103,2072,2076,2084,-27,-19,102208,2130300540,291416
774,c1601,20150714,2076,2084,2075,2085,2033,2047,2057,-37,-27,262196,5395618280,358212
775,c1601,20150715,2047,2057,2043,2064,2040,2059,2055,2,-2,98712,2029384700,358594
776,c1601,20150716,2059,2055,2060,2102,2057,2091,2089,36,34,269964,5640391860,361082
777,c1601,20150717,2091,2089,2085,2098,2074,2091,2088,2,-1,178224,3721634720,367776
778,c1601,20150720,2091,2088,2088,2094,2077,2080,2082,-8,-6,109792,2285947860,375716
779,c1601,20150721,2080,2082,2080,2085,2065,2071,2074,-11,-8,110324,2288186580,396610
780,c1601,20150722,2071,2074,2070,2085,2066,2077,2078,3,4,114784,2385396980,408552
781,c1601,20150723,2077,2078,2075,2081,2070,2079,2075,1,-3,72136,1496867320,417864
782,c1601,20150724,2079,2075,2077,2079,2033,2036,2052,-39,-23,205522,4218234860,466938
783,c1601,20150727,2036,2052,2029,2029,1982,1996,1994,-56,-58,424490,8467723580,540350
784,c1601,20150728,1996,1994,1988,2014,1980,2009,1998,15,4,342438,6844213880,557812
785,c1601,20150729,2009,1998,2008,2024,2008,2015,2015,17,17,157654,3177919760,550412
786,c1601,20150730,2015,2015,2012,2020,1996,2000,2005,-15,-10,201534,4042063680,571712
787,c1601,20150731,2000,2005,2001,2026,2001,2015,2017,10,12,211110,4259660980,583566
788,c1601,20150803,2015,2017,2011,2019,2005,2015,2011,-2,-6,140816,2832699660,588484
789,c1601,20150804,2015,2011,2017,2031,2014,2019,2023,8,12,167528,3389487280,593384
790,c1601,20150805,2019,2023,2021,2023,1991,2015,2005,-8,-18,294560,5908248760,609832
791,c1601,20150806,2015,2005,2015,2015,2004,2010,2008,5,3,75338,1513276680,617810
792,c1601,20150807,2010,2008,2008,2008,1988,1996,1994,-12,-14,205582,4100907420,643044
793,c1601,20150810,1996,1994,2004,2015,1996,2009,2004,15,10,163942,3285946820,666400
794,c1601,20150811,2009,2004,2018,2028,2006,2007,2015,3,11,212024,4273897200,673362
795,c1601,20150812,2007,2015,2000,2015,1998,2014,2006,-1,-9,159394,3199026540,662074
796,c1601,20150813,2014,2006,2000,2035,1996,2018,2017,12,11,222126,4482252180,671444
797,c1601,20150814,2018,2017,2018,2039,2010,2016,2027,-1,10,205320,4163702160,697780
798,c1601,20150817,2016,2027,2018,2042,2007,2038,2030,11,3,265102,5381824060,687004
799,c1601,20150818,2038,2030,2043,2049,2032,2038,2039,8,9,217338,4432987060,682806
800,c1601,20150819,2038,2039,2039,2044,2026,2034,2033,-5,-6,175182,3562989180,688272
801,c1601,20150820,2034,2033,2030,2033,2010,2012,2019,-21,-14,176676,3568695660,711272
802,c1601,20150821,2012,2019,2016,2022,1997,2002,2007,-17,-12,312026,6264468480,678556
803,c1601,20150824,2002,2007,1996,2002,1973,1990,1989,-17,-18,233788,4650075020,661510
804,c1601,20150825,1990,1989,1999,2027,1985,2021,2010,32,21,340058,6836753140,658712
805,c1601,20150826,2021,2010,2024,2028,2011,2020,2018,10,8,104304,2105354980,657086
806,c1601,20150827,2020,2018,2018,2026,2004,2013,2013,-5,-5,176946,3562953320,636136
807,c1601,20150828,2013,2013,2025,2033,2006,2007,2018,-6,5,161244,3254820520,638650
808,c1601,20150831,2007,2018,2005,2014,1938,1938,1981,-80,-37,386632,7660650760,667968
809,c1601,20150901,1938,1981,1946,1960,1920,1942,1941,-39,-40,584718,11353469340,672382
810,c1601,20150902,1942,1941,1938,1950,1933,1949,1942,8,1,168726,3277597860,653292
811,c1601,20150907,1949,1942,1949,1958,1935,1945,1947,3,5,356932,6949787160,636132
812,c1601,20150908,1945,1947,1946,1966,1938,1963,1950,16,3,333452,6502380600,608478
813,c1601,20150909,1963,1950,1968,1978,1957,1962,1963,12,13,286034,5616829020,591310
814,c1601,20150910,1962,1963,1964,1978,1953,1974,1964,11,1,392406,7707896240,561908
815,c1601,20150911,1974,1964,1970,1982,1970,1972,1975,8,11,144556,2855823160,538720
816,c1601,20150914,1972,1975,1975,1980,1955,1957,1960,-18,-15,190876,3742463120,542784
817,c1601,20150915,1957,1960,1955,1964,1947,1954,1954,-6,-6,174388,3408447580,532714
818,c1601,20150916,1954,1954,1958,1974,1951,1970,1963,16,9,192454,3779477140,495588
819,c1601,20150917,1970,1963,1970,1974,1941,1955,1955,-8,-8,265542,5193685600,512540
820,c1601,20150918,1955,1955,1953,1953,1891,1895,1913,-60,-42,669200,12801882140,574850
821,c1601,20150921,1895,1913,1936,1940,1914,1919,1925,6,12,659432,12696056460,607396
822,c1601,20150922,1919,1925,1925,1926,1908,1914,1914,-11,-11,245748,4704999640,606704
823,c1601,20150923,1914,1914,1911,1929,1907,1925,1917,11,3,289126,5544675000,633402
824,c1601,20150924,1925,1917,1926,1935,1925,1932,1929,15,12,191056,3687303760,639834
825,c1601,20150925,1932,1929,1934,1939,1929,1931,1934,2,5,178308,3449301960,611278
826,c1601,20150928,1931,1934,1930,1938,1927,1929,1931,-5,-3,119034,2298840400,592544
827,c1601,20150929,1929,1931,1926,1931,1914,1924,1922,-7,-9,258770,4974833640,631906
828,c1601,20150930,1924,1922,1925,1930,1908,1911,1915,-11,-7,201464,3858894960,665938
829,c1601,20151008,1911,1915,1906,1909,1885,1892,1897,-23,-18,336718,6388615180,735914
830,c1601,20151009,1892,1897,1896,1909,1888,1898,1900,1,3,202878,3856449000,746240
831,c1601,20151012,1898,1900,1905,1927,1888,1894,1896,-6,-4,236892,4492481240,737398
832,c1601,20151013,1894,1896,1888,1893,1863,1872,1873,-24,-23,343078,6426582780,778934
833,c1601,20151014,1872,1873,1874,1899,1872,1894,1887,21,14,265962,5020189320,760788
834,c1601,20151015,1894,1887,1891,1908,1888,1902,1900,15,13,150020,2851191300,745552
835,c1601,20151016,1902,1900,1905,1907,1887,1903,1896,3,-4,182586,3463248360,745036
836,c1601,20151019,1903,1896,1899,1899,1884,1888,1890,-8,-6,205878,3892352500,757020
837,c1601,20151020,1888,1890,1888,1892,1881,1890,1886,0,-4,162612,3068183740,749678
838,c1601,20151021,1890,1886,1898,1898,1885,1891,1890,5,4,149592,2827768720,746222
839,c1601,20151022,1891,1890,1893,1896,1884,1890,1888,0,-2,132552,2503220100,730964
840,c1601,20151023,1890,1888,1888,1891,1877,1891,1884,3,-4,152572,2874995800,715340
841,c1601,20151026,1891,1884,1888,1907,1885,1905,1899,21,15,159412,3027466460,704800
842,c1601,20151027,1905,1899,1903,1924,1901,1922,1912,23,13,206770,3953623060,663120
843,c1601,20151028,1922,1912,1919,1920,1906,1907,1910,-5,-2,105310,2011903260,671462
844,c1601,20151029,1907,1910,1906,1921,1898,1915,1911,5,1,103594,1979791620,675492
845,c1601,20151030,1915,1911,1915,1923,1908,1912,1914,1,3,89392,1711165580,680818
846,c1601,20151102,1912,1914,1917,1921,1912,1916,1916,2,2,92592,1774939140,672332
847,c1601,20151103,1916,1916,1916,1935,1912,1932,1927,16,11,137094,2642053760,665532
848,c1601,20151104,1932,1927,1931,1943,1928,1933,1936,6,9,109162,2113832820,641786
849,c1601,20151105,1933,1936,1932,1940,1929,1934,1936,-2,0,83012,1607200480,620250
850,c1601,20151106,1934,1936,1931,1942,1923,1940,1935,4,-1,99020,1916080480,592678
851,c1601,20151109,1940,1935,1945,1985,1942,1961,1965,26,30,537358,10563771360,380546
852,c1601,20151110,1961,1965,1955,1962,1931,1941,1942,-24,-23,146682,2849074180,367144
853,c1601,20151111,1941,1942,1941,1946,1935,1936,1939,-6,-3,66944,1298559700,355788
854,c1601,20151112,1936,1939,1942,1976,1937,1966,1958,27,19,160220,3138618520,325016
855,c1601,20151113,1966,1958,1965,1970,1952,1955,1958,-3,0,86056,1685413940,303644
856,c1601,20151116,1955,1958,1951,1967,1950,1953,1958,-5,0,59468,1164636960,293022
857,c1601,20151117,1953,1958,1953,1964,1948,1963,1955,5,-3,53910,1054287580,280856
858,c1601,20151118,1963,1955,1964,1965,1955,1960,1959,5,4,29242,573010660,273876
859,c1601,20151119,1960,1959,1960,1964,1949,1956,1955,-3,-4,72010,1407932240,246038
860,c1601,20151120,1956,1955,1960,1965,1941,1945,1951,-10,-4,81852,1597665960,223964
861,c1601,20151123,1945,1951,1948,1960,1948,1955,1954,4,3,54768,1070395240,210272
862,c1601,20151124,1955,1954,1956,1969,1955,1968,1962,14,8,56540,1109433060,190472
863,c1601,20151125,1968,1962,1970,1998,1960,1995,1978,33,16,52126,1031573280,186740
864,c1601,20151126,1995,1978,1995,2011,1987,2006,2000,28,22,39660,793369780,177204
865,c1601,20151127,2006,2000,2010,2030,2002,2027,2022,27,22,65282,1320048580,165516
866,c1601,20151130,2027,2022,2030,2040,2024,2032,2032,10,10,46798,951297980,152872
867,c1601,20151201,2032,2032,2033,2034,2023,2024,2026,-8,-6,26798,543089400,149112
868,c1601,20151202,2024,2026,2024,2035,2023,2034,2030,8,4,23750,482299760,140490
869,c1601,20151203,2034,2030,2032,2036,2016,2035,2029,5,-1,23330,473500420,135656
870,c1601,20151204,2035,2029,2037,2037,2030,2035,2033,6,4,21844,444156280,128674
871,c1601,20151207,2035,2033,2025,2034,2023,2031,2027,-2,-6,37598,762361920,107266
872,c1601,20151208,2031,2027,2033,2036,2030,2036,2033,9,6,29494,599880020,102358
873,c1601,20151209,2036,2033,2036,2099,2032,2054,2046,21,13,25374,519341780,95972
874,c1601,20151210,2054,2046,2052,2056,2044,2053,2050,7,4,15664,321250300,89842
875,c1601,20151211,2053,2050,2053,2058,2045,2058,2054,8,4,13066,268418760,80756
876,c1601,20151214,2058,2054,2050,2071,2050,2065,2065,11,11,24738,510856200,64552
877,c1601,20151215,2065,2065,2065,2070,2061,2068,2067,3,2,11680,241490760,59408
878,c1601,20151216,2068,2067,2066,2070,2062,2064,2068,-3,1,7576,156690700,54762
879,c1601,20151217,2064,2068,2063,2070,2061,2069,2065,1,-3,8688,179439100,51250
880,c1601,20151218,2069,2065,2068,2071,2066,2070,2069,5,4,16114,333476020,42828
881,c1601,20151221,2070,2069,2070,2071,2065,2071,2069,2,0,13606,281600840,30598
882,c1601,20151222,2071,2069,2074,2074,2041,2065,2063,-4,-6,14058,290061000,26186
883,c1601,20151223,2065,2063,2058,2066,2055,2063,2061,0,-2,4568,94176000,24328
884,c1601,20151224,2063,2061,2063,2065,2059,2060,2061,-1,0,3050,62868140,22586
885,c1601,20151225,2060,2061,2060,2072,2059,2070,2067,9,6,1944,40195660,21658
886,c1601,20151228,2070,2067,2067,2069,2061,2065,2064,-2,-3,6120,126364500,17688
887,c1601,20151229,2065,2064,2066,2083,2059,2075,2070,11,6,4986,103253460,14300
888,c1601,20151230,2075,2070,2085,2096,2076,2093,2090,23,20,5404,112972540,11624
889,c1601,20151231,2093,2090,2093,2100,2086,2099,2093,9,3,8850,185293800,5130
890,c1603,20150316,2305,2305,0,0,0,2305,2305,0,0,0,0,0
891,c1603,20150317,2305,2305,2327,2327,2327,2327,2327,22,22,2,46540,2
892,c1603,20150318,2327,2327,0,0,0,2327,2327,0,0,0,0,2
893,c1603,20150319,2327,2327,0,0,0,2327,2327,0,0,0,0,2
894,c1603,20150320,2327,2327,0,0,0,2326,2326,-1,-1,0,0,2
895,c1603,20150323,2326,2326,0,0,0,2326,2326,0,0,0,0,2
896,c1603,20150324,2326,2326,0,0,0,2326,2326,0,0,0,0,2
897,c1603,20150325,2326,2326,0,0,0,2326,2326,0,0,0,0,2
898,c1603,20150326,2326,2326,0,0,0,2326,2326,0,0,0,0,2
899,c1603,20150327,2326,2326,0,0,0,2326,2326,0,0,0,0,2
900,c1603,20150330,2326,2326,0,0,0,2325,2325,-1,-1,0,0,2
901,c1603,20150331,2325,2325,2319,2319,2302,2302,2310,-23,-15,4,92420,2
902,c1603,20150401,2302,2310,0,0,0,2310,2310,0,0,0,0,2
903,c1603,20150402,2310,2310,0,0,0,2310,2310,0,0,0,0,2
904,c1603,20150403,2310,2310,0,0,0,2310,2310,0,0,0,0,2
905,c1603,20150407,2310,2310,0,0,0,2310,2310,0,0,0,0,2
906,c1603,20150408,2310,2310,0,0,0,2307,2307,-3,-3,0,0,2
907,c1603,20150409,2307,2307,0,0,0,2304,2304,-3,-3,0,0,2
908,c1603,20150410,2304,2304,2307,2307,2295,2305,2300,1,-4,8,184040,4
909,c1603,20150413,2305,2300,2325,2326,2325,2326,2325,26,25,4,93020,8
910,c1603,20150414,2326,2325,2335,2335,2308,2308,2321,-17,-4,4,92860,8
911,c1603,20150415,2308,2321,0,0,0,2314,2314,-7,-7,0,0,8
912,c1603,20150416,2314,2314,2301,2309,2301,2309,2305,-5,-9,4,92200,8
913,c1603,20150417,2309,2305,2332,2332,2309,2309,2325,4,20,8,186060,6
914,c1603,20150420,2309,2325,2309,2321,2303,2303,2310,-22,-15,28,646820,12
915,c1603,20150421,2303,2310,2300,2310,2299,2310,2301,0,-9,10,230180,14
916,c1603,20150422,2310,2301,2305,2305,2285,2285,2295,-16,-6,4,91800,14
917,c1603,20150423,2285,2295,2295,2296,2287,2287,2294,-8,-1,14,321220,22
918,c1603,20150424,2287,2294,2297,2298,2288,2295,2293,1,-1,24,550480,22
919,c1603,20150427,2295,2293,0,0,0,2293,2293,0,0,0,0,22
920,c1603,20150428,2293,2293,2263,2276,2262,2263,2264,-30,-29,22,498260,32
921,c1603,20150429,2263,2264,2253,2275,2252,2254,2257,-10,-7,16,361220,32
922,c1603,20150430,2254,2257,2272,2290,2272,2286,2276,29,19,18,409800,38
923,c1603,20150504,2286,2276,2271,2288,2271,2287,2282,11,6,6,136920,40
924,c1603,20150505,2287,2282,0,0,0,2282,2282,0,0,0,0,40
925,c1603,20150506,2282,2282,0,0,0,2282,2282,0,0,0,0,40
926,c1603,20150507,2282,2282,2280,2293,2280,2293,2286,11,4,4,91460,40
927,c1603,20150508,2293,2286,2281,2291,2281,2291,2287,5,1,6,137240,40
928,c1603,20150511,2291,2287,2273,2278,2270,2271,2273,-16,-14,36,818440,52
929,c1603,20150512,2271,2273,0,0,0,2273,2273,0,0,0,0,52
930,c1603,20150513,2273,2273,2280,2291,2267,2273,2277,0,4,70,1594080,58
931,c1603,20150514,2273,2277,2287,2287,2270,2282,2279,5,2,10,227920,56
932,c1603,20150515,2282,2279,2279,2279,2279,2279,2279,0,0,2,45580,56
933,c1603,20150518,2279,2279,2280,2280,2270,2270,2275,-9,-4,8,182020,58
934,c1603,20150519,2270,2275,2280,2280,2271,2277,2275,2,0,12,273020,58
935,c1603,20150520,2277,2275,2277,2282,2270,2277,2276,2,1,26,591980,52
936,c1603,20150521,2277,2276,2269,2269,2269,2269,2269,-7,-7,2,45380,52
937,c1603,20150522,2269,2269,2275,2275,2261,2261,2272,-8,3,10,227220,52
938,c1603,20150525,2261,2272,2254,2262,2251,2255,2256,-17,-16,16,361000,50
939,c1603,20150526,2255,2256,2259,2268,2203,2265,2246,9,-10,14,314480,50
940,c1603,20150527,2265,2246,2241,2257,2233,2233,2242,-13,-4,10,224260,50
941,c1603,20150528,2233,2242,2242,2242,2240,2240,2241,-2,-1,4,89640,48
942,c1603,20150529,2240,2241,2235,2254,2235,2252,2251,11,10,46,1035500,56
943,c1603,20150601,2252,2251,2241,2252,2241,2251,2247,0,-4,10,224740,56
944,c1603,20150602,2251,2247,2253,2257,2250,2257,2252,10,5,16,360360,54
945,c1603,20150603,2257,2252,0,0,0,2251,2251,-1,-1,0,0,54
946,c1603,20150604,2251,2251,2219,2219,2202,2203,2204,-48,-47,18,396860,50
947,c1603,20150605,2203,2204,0,0,0,2191,2191,-13,-13,0,0,50
948,c1603,20150608,2191,2191,2183,2188,2177,2188,2181,-3,-10,32,698160,48
949,c1603,20150609,2188,2181,0,0,0,2177,2177,-4,-4,0,0,48
950,c1603,20150610,2177,2177,2164,2173,2164,2170,2167,-7,-10,8,173420,50
951,c1603,20150611,2170,2167,2168,2187,2152,2178,2173,11,6,10,217340,50
952,c1603,20150612,2178,2173,2182,2203,2172,2173,2180,0,7,22,479680,50
953,c1603,20150615,2173,2180,0,0,0,2172,2172,-8,-8,0,0,50
954,c1603,20150616,2172,2172,0,0,0,2172,2172,0,0,0,0,50
955,c1603,20150617,2172,2172,0,0,0,2172,2172,0,0,0,0,50
956,c1603,20150618,2172,2172,2174,2178,2165,2173,2172,1,0,26,564860,62
957,c1603,20150619,2173,2172,2173,2173,2153,2153,2166,-19,-6,8,173300,60
958,c1603,20150623,2153,2166,2177,2177,2170,2171,2172,5,6,8,173780,62
959,c1603,20150624,2171,2172,2188,2188,2161,2165,2168,-7,-4,78,1691340,70
960,c1603,20150625,2165,2168,0,0,0,2166,2166,-2,-2,0,0,70
961,c1603,20150626,2166,2166,2164,2172,2157,2165,2165,-1,-1,38,822760,70
962,c1603,20150629,2165,2165,2157,2163,2149,2149,2157,-16,-8,30,647180,72
963,c1603,20150630,2149,2157,2144,2152,2136,2152,2141,-5,-16,22,471040,68
964,c1603,20150701,2152,2141,2165,2165,2150,2154,2160,13,19,54,1166620,80
965,c1603,20150702,2154,2160,2158,2167,2151,2167,2159,7,-1,102,2202400,78
966,c1603,20150703,2167,2159,2171,2176,2165,2172,2172,13,13,56,1216600,58
967,c1603,20150706,2172,2172,2165,2166,2154,2159,2158,-13,-14,30,647640,58
968,c1603,20150707,2159,2158,2164,2164,2088,2101,2143,-57,-15,88,1886040,70
969,c1603,20150708,2101,2143,2081,2107,2058,2100,2087,-43,-56,88,1837060,26
970,c1603,20150709,2100,2087,2095,2166,2060,2108,2102,21,15,72,1514100,30
971,c1603,20150710,2108,2102,2118,2138,2112,2125,2126,23,24,50,1063320,28
972,c1603,20150713,2125,2126,2100,2111,2094,2094,2102,-32,-24,96,2018180,26
973,c1603,20150714,2094,2102,2072,2072,2070,2070,2071,-32,-31,6,124280,28
974,c1603,20150715,2070,2071,2087,2087,2072,2077,2080,6,9,20,416120,28
975,c1603,20150716,2077,2080,2082,2111,2073,2105,2101,25,21,26,546380,24
976,c1603,20150717,2105,2101,2111,2111,2095,2095,2106,-6,5,12,252800,22
977,c1603,20150720,2095,2106,2109,2109,2082,2082,2095,-24,-11,16,335240,22
978,c1603,20150721,2082,2095,2084,2084,2074,2084,2080,-11,-15,6,124840,24
979,c1603,20150722,2084,2080,2073,2089,2073,2089,2081,9,1,12,249720,22
980,c1603,20150723,2089,2081,0,0,0,2078,2078,-3,-3,0,0,22
981,c1603,20150724,2078,2078,2072,2072,2043,2043,2053,-35,-25,16,328540,32
982,c1603,20150727,2043,2053,2001,2001,1975,1979,1988,-74,-65,276,5487060,72
983,c1603,20150728,1979,1988,1984,1992,1979,1992,1983,4,-5,30,595080,56
984,c1603,20150729,1992,1983,1995,2008,1995,2006,2001,23,18,52,1040580,74
985,c1603,20150730,2006,2001,2011,2011,1980,1980,1989,-21,-12,56,1114380,50
986,c1603,20150731,1980,1989,2000,2000,1992,1998,1996,9,7,12,239560,42
987,c1603,20150803,1998,1996,1981,1981,1981,1981,1981,-15,-15,2,39620,40
988,c1603,20150804,1981,1981,1995,1995,1985,1985,1990,4,9,4,79600,40
989,c1603,20150805,1985,1990,1970,1993,1970,1993,1978,3,-12,10,197880,40
990,c1603,20150806,1993,1978,0,0,0,1978,1978,0,0,0,0,40
991,c1603,20150807,1978,1978,1982,1982,1982,1982,1982,4,4,4,79280,40
992,c1603,20150810,1982,1982,1991,1991,1991,1991,1991,9,9,2,39820,42
993,c1603,20150811,1991,1991,0,0,0,1991,1991,0,0,0,0,42
994,c1603,20150812,1991,1991,2005,2011,1990,1990,2003,-1,12,30,601000,44
995,c1603,20150813,1990,2003,2000,2021,2000,2013,2012,10,9,34,684080,60
996,c1603,20150814,2013,2012,2013,2013,2004,2007,2006,-5,-6,12,240720,56
997,c1603,20150817,2007,2006,2007,2018,2007,2018,2012,12,6,8,160980,54
998,c1603,20150818,2018,2012,2028,2028,2021,2021,2023,9,11,6,121400,50
999,c1603,20150819,2021,2023,2016,2019,2016,2016,2016,-7,-7,10,201660,48
1000,c1603,20150820,2016,2016,2014,2018,2002,2003,2010,-13,-6,20,402180,48
1001,c1603,20150821,2003,2010,1993,1993,1993,1993,1993,-17,-17,8,159440,46
1002,c1603,20150824,1993,1993,1977,1980,1971,1974,1975,-19,-18,28,553160,48
1003,c1603,20150825,1974,1975,1992,2006,1988,2006,1996,31,21,24,479140,38
1004,c1603,20150826,2006,1996,1989,1989,1989,1989,1989,-7,-7,2,39780,38
1005,c1603,20150827,1989,1989,1985,1985,1985,1985,1985,-4,-4,2,39700,36
1006,c1603,20150828,1985,1985,1992,1996,1990,1996,1992,11,7,8,159400,32
1007,c1603,20150831,1996,1992,1986,1986,1928,1928,1971,-64,-21,104,2050120,46
1008,c1603,20150901,1928,1971,1931,1940,1913,1923,1927,-48,-44,64,1233540,42
1009,c1603,20150902,1923,1927,1926,1926,1926,1926,1926,-1,-1,4,77040,42
1010,c1603,20150907,1926,1926,1926,1935,1912,1922,1924,-4,-2,18,346360,42
1011,c1603,20150908,1922,1924,1921,1936,1921,1936,1931,12,7,12,231780,42
1012,c1603,20150909,1936,1931,1936,1936,1931,1931,1935,0,4,10,193500,34
1013,c1603,20150910,1931,1935,1933,1940,1932,1939,1936,4,1,8,154880,36
1014,c1603,20150911,1939,1936,1931,1940,1931,1940,1935,4,-1,4,77420,36
1015,c1603,20150914,1940,1935,1927,1927,1916,1921,1919,-14,-16,18,345420,38
1016,c1603,20150915,1921,1919,1922,1926,1915,1926,1920,7,1,40,768280,32
1017,c1603,20150916,1926,1920,1927,1939,1926,1939,1930,19,10,6,115840,30
1018,c1603,20150917,1939,1930,1919,1926,1906,1926,1915,-4,-15,12,229820,30
1019,c1603,20150918,1926,1915,1894,1909,1847,1847,1881,-68,-34,40,752460,36
1020,c1603,20150921,1847,1881,1872,1889,1851,1856,1876,-25,-5,114,2138680,38
1021,c1603,20150922,1856,1876,0,0,0,1868,1868,-8,-8,0,0,38
1022,c1603,20150923,1868,1868,1859,1875,1859,1869,1867,1,-1,6,112060,36
1023,c1603,20150924,1869,1867,1855,1928,1855,1868,1880,1,13,450,8464440,232
1024,c1603,20150925,1868,1880,1872,1872,1859,1859,1864,-21,-16,22,410140,226
1025,c1603,20150928,1859,1864,1855,1856,1855,1855,1855,-9,-9,18,333960,216
1026,c1603,20150929,1855,1855,1858,1858,1817,1852,1842,-3,-13,160,2947300,140
1027,c1603,20150930,1852,1842,1852,1858,1852,1857,1854,15,12,10,185440,138
1028,c1603,20151008,1857,1854,1835,1862,1835,1854,1852,0,-2,54,1000240,94
1029,c1603,20151009,1854,1852,1850,1855,1840,1851,1848,-1,-4,26,480520,94
1030,c1603,20151012,1851,1848,1840,1855,1828,1828,1850,-20,2,64,1184260,54
1031,c1603,20151013,1828,1850,1811,1813,1811,1813,1812,-37,-38,4,72480,54
1032,c1603,20151014,1813,1812,1824,1836,1822,1829,1828,17,16,14,256040,52
1033,c1603,20151015,1829,1828,0,0,0,1828,1828,0,0,0,0,52
1034,c1603,20151016,1828,1828,1852,1852,1829,1831,1835,3,7,14,257020,52
1035,c1603,20151019,1831,1835,1815,1829,1809,1815,1815,-20,-20,52,944160,78
1036,c1603,20151020,1815,1815,1795,1818,1795,1806,1811,-9,-4,38,688520,56
1037,c1603,20151021,1806,1811,1826,1826,1811,1815,1818,4,7,18,327300,52
1038,c1603,20151022,1815,1818,1823,1823,1823,1823,1823,5,5,2,36460,54
1039,c1603,20151023,1823,1823,1823,1824,1804,1819,1815,-4,-8,46,835220,46
1040,c1603,20151026,1819,1815,1826,1840,1826,1831,1833,16,18,12,220000,44
1041,c1603,20151027,1831,1833,1838,1846,1837,1837,1839,4,6,8,147180,44
1042,c1603,20151028,1837,1839,0,0,0,1838,1838,-1,-1,0,0,44
1043,c1603,20151029,1838,1838,1840,1840,1838,1838,1838,0,0,14,257360,44
1044,c1603,20151030,1838,1838,1836,1837,1827,1837,1831,-1,-7,16,293040,34
1045,c1603,20151102,1837,1831,1832,1838,1829,1829,1833,-2,2,6,109980,36
1046,c1603,20151103,1829,1833,1853,1853,1832,1832,1839,-1,6,12,220720,46
1047,c1603,20151104,1832,1839,1837,1846,1837,1846,1841,7,2,4,73660,46
1048,c1603,20151105,1846,1841,1844,1844,1844,1844,1844,3,3,2,36880,48
1049,c1603,20151106,1844,1844,1837,1857,1803,1857,1844,13,0,62,1143300,82
1050,c1603,20151109,1857,1844,1861,1896,1861,1883,1879,39,35,66,1240360,68
1051,c1603,20151110,1883,1879,1859,1859,1834,1859,1850,-20,-29,6,111040,70
1052,c1603,20151111,1859,1850,0,0,0,1856,1856,6,6,0,0,70
1053,c1603,20151112,1856,1856,1881,1898,1881,1893,1883,37,27,68,1280640,82
1054,c1603,20151113,1893,1883,1887,1888,1876,1876,1885,-7,2,10,188500,74
1055,c1603,20151116,1876,1885,1888,1888,1822,1840,1870,-45,-15,44,822980,78
1056,c1603,20151117,1840,1870,1854,1880,1841,1863,1858,-7,-12,16,297400,82
1057,c1603,20151118,1863,1858,1871,1871,1850,1868,1862,10,4,24,447100,74
1058,c1603,20151119,1868,1862,1876,1876,1843,1869,1868,7,6,18,336300,74
1059,c1603,20151120,1869,1868,1858,1867,1848,1854,1858,-14,-10,10,185880,72
1060,c1603,20151123,1854,1858,1861,1861,1861,1861,1861,3,3,2,37220,74
1061,c1603,20151124,1861,1861,0,0,0,1861,1861,0,0,0,0,74
1062,c1603,20151125,1861,1861,1870,1907,1843,1879,1894,18,33,332,6289120,374
1063,c1603,20151126,1879,1894,1908,1931,1899,1924,1916,30,22,24,460040,382
1064,c1603,20151127,1924,1916,1931,1977,1931,1970,1957,54,41,66,1291680,420
1065,c1603,20151130,1970,1957,2016,2016,1988,2002,1995,45,38,24,478860,416
1066,c1603,20151201,2002,1995,2005,2010,1996,2009,2002,14,7,20,400460,418
1067,c1603,20151202,2009,2002,1998,2003,1998,2000,2000,-2,-2,16,320100,414
1068,c1603,20151203,2000,2000,1995,2009,1995,2002,2003,2,3,18,360600,412
1069,c1603,20151204,2002,2003,2006,2009,1989,2001,1999,-2,-4,50,999780,418
1070,c1603,20151207,2001,1999,1984,1986,1958,1977,1965,-22,-34,46,904100,410
1071,c1603,20151208,1977,1965,1920,1998,1920,1972,1967,7,2,30,590320,416
1072,c1603,20151209,1972,1967,1996,1996,1980,1980,1984,13,17,32,635140,406
1073,c1603,20151210,1980,1984,1987,2032,1987,2009,2002,25,18,44,881100,410
1074,c1603,20151211,2009,2002,2001,2013,1998,2010,2007,8,5,18,361260,410
1075,c1603,20151214,2010,2007,1982,2024,1982,1988,2002,-19,-5,8,160220,410
1076,c1603,20151215,1988,2002,1991,2020,1991,2001,2003,-1,1,18,360600,410
1077,c1603,20151216,2001,2003,1946,2013,1946,2005,1996,2,-7,10,199620,408
1078,c1603,20151217,2005,1996,2018,2018,2003,2004,2009,8,13,10,200920,408
1079,c1603,20151218,2004,2009,2011,2021,2011,2016,2014,7,5,8,161180,406
1080,c1603,20151221,2016,2014,2041,2041,2011,2031,2026,17,12,10,202600,404
1081,c1603,20151222,2031,2026,2015,2035,1992,1992,2014,-34,-12,6,120840,404
1082,c1603,20151223,1992,2014,1981,1999,1981,1992,1987,-22,-27,30,596280,412
1083,c1603,20151224,1992,1987,1999,1999,1991,1991,1996,4,9,18,359400,412
1084,c1603,20151225,1991,1996,1982,1982,1966,1972,1969,-24,-27,82,1614620,446
1085,c1603,20151228,1972,1969,1925,1989,1925,1945,1951,-24,-18,20,390340,442
1086,c1603,20151229,1945,1951,1952,1952,1948,1948,1950,-3,-1,28,546040,442
1087,c1603,20151230,1948,1950,1930,1992,1926,1969,1971,19,21,26,512580,450
1088,c1603,20151231,1969,1971,1948,1986,1948,1986,1967,15,-4,22,432740,452
1089,c1605,20150518,2265,2265,2322,2338,2306,2310,2314,45,49,1192,27590380,886
1090,c1605,20150519,2310,2314,2308,2325,2307,2318,2313,4,-1,766,17718660,1354
1091,c1605,20150520,2318,2313,2315,2325,2311,2317,2315,4,2,952,22041280,1706
1092,c1605,20150521,2317,2315,2315,2317,2311,2311,2314,-4,-1,490,11338700,2068
1093,c1605,20150522,2311,2314,2313,2314,2304,2313,2309,-1,-5,578,13347020,2420
1094,c1605,20150525,2313,2309,2311,2313,2297,2300,2303,-9,-6,1646,37921420,3596
1095,c1605,20150526,2300,2303,2303,2303,2290,2290,2294,-13,-9,848,19457920,4214
1096,c1605,20150527,2290,2294,2290,2290,2255,2269,2272,-25,-22,2304,52367380,5834
1097,c1605,20150528,2269,2272,2266,2273,2264,2271,2267,-1,-5,596,13511480,6132
1098,c1605,20150529,2271,2267,2266,2282,2266,2278,2272,11,5,834,18953260,6576
1099,c1605,20150601,2278,2272,2275,2276,2266,2272,2272,0,0,772,17540540,6934
1100,c1605,20150602,2272,2272,2270,2274,2268,2271,2270,-1,-2,1080,24521800,7060
1101,c1605,20150603,2271,2270,2272,2272,2266,2266,2269,-4,-1,652,14794300,7300
1102,c1605,20150604,2266,2269,2264,2267,2214,2215,2240,-54,-29,4666,104525120,9672
1103,c1605,20150605,2215,2240,2226,2231,2209,2213,2215,-27,-25,1986,43997520,10646
1104,c1605,20150608,2213,2215,2211,2212,2187,2206,2201,-9,-14,2224,48960940,11406
1105,c1605,20150609,2206,2201,2208,2217,2191,2206,2207,5,6,2296,50680220,11776
1106,c1605,20150610,2206,2207,2201,2202,2180,2185,2186,-22,-21,2302,50336780,13046
1107,c1605,20150611,2185,2186,2182,2207,2182,2202,2193,16,7,2354,51640680,13004
1108,c1605,20150612,2202,2193,2197,2197,2185,2193,2190,0,-3,2184,47838780,14216
1109,c1605,20150615,2193,2190,2190,2190,2171,2176,2176,-14,-14,4280,93155420,17626
1110,c1605,20150616,2176,2176,2178,2186,2176,2182,2182,6,6,2360,51502320,18920
1111,c1605,20150617,2182,2182,2187,2194,2179,2185,2187,3,5,1718,37579180,19208
1112,c1605,20150618,2185,2187,2187,2193,2178,2185,2184,-2,-3,2082,45473220,20264
1113,c1605,20150619,2185,2184,2184,2189,2180,2181,2185,-3,1,1154,25220220,20554
1114,c1605,20150623,2181,2185,2185,2197,2185,2193,2191,8,6,1350,29586340,20516
1115,c1605,20150624,2193,2191,2196,2196,2182,2184,2186,-7,-5,1870,40895260,21438
1116,c1605,20150625,2184,2186,2185,2189,2182,2186,2186,0,0,1134,24789560,21924
1117,c1605,20150626,2186,2186,2192,2192,2179,2183,2184,-3,-2,3130,68381660,22438
1118,c1605,20150629,2183,2184,2187,2187,2160,2165,2169,-19,-15,3216,69766440,23922
1119,c1605,20150630,2165,2169,2154,2161,2143,2148,2147,-21,-22,4196,90109420,26882
1120,c1605,20150701,2148,2147,2156,2184,2155,2169,2164,22,17,4716,102055940,29452
1121,c1605,20150702,2169,2164,2165,2176,2156,2169,2162,5,-2,5036,108918660,32800
1122,c1605,20150703,2169,2162,2169,2188,2169,2186,2181,24,19,3646,79543640,32552
1123,c1605,20150706,2186,2181,2185,2185,2164,2170,2173,-11,-8,1816,39479620,32694
1124,c1605,20150707,2170,2173,2170,2174,2101,2120,2136,-53,-37,13146,280804040,40028
1125,c1605,20150708,2120,2136,2104,2121,2058,2095,2089,-41,-47,23826,497752220,45964
1126,c1605,20150709,2095,2089,2099,2136,2096,2109,2112,20,23,19280,407241460,55806
1127,c1605,20150710,2109,2112,2114,2149,2111,2126,2132,14,20,16636,354716140,57178
1128,c1605,20150713,2126,2132,2130,2138,2104,2110,2117,-22,-15,11754,248870760,60946
1129,c1605,20150714,2110,2117,2117,2119,2073,2073,2092,-44,-25,33096,692520180,75722
1130,c1605,20150715,2073,2092,2069,2092,2069,2085,2078,-7,-14,15054,312914020,76196
1131,c1605,20150716,2085,2078,2085,2123,2080,2109,2109,31,31,24632,519658200,81588
1132,c1605,20150717,2109,2109,2106,2117,2097,2110,2107,1,-2,25660,540668600,83156
1133,c1605,20150720,2110,2107,2108,2112,2094,2098,2099,-9,-8,13578,285084800,82722
1134,c1605,20150721,2098,2099,2099,2101,2078,2083,2088,-16,-11,15744,328771740,91368
1135,c1605,20150722,2083,2088,2083,2103,2080,2087,2090,-1,2,41762,873240500,98886
1136,c1605,20150723,2087,2090,2085,2089,2080,2087,2084,-3,-6,11448,238614080,102818
1137,c1605,20150724,2087,2084,2080,2088,2036,2038,2059,-46,-25,41892,862649660,122714
1138,c1605,20150727,2038,2059,2037,2037,1977,1977,1981,-82,-78,116392,2306406240,166248
1139,c1605,20150728,1977,1981,1961,1997,1945,1973,1968,-8,-13,106360,2093336920,203932
1140,c1605,20150729,1973,1968,1977,1993,1973,1986,1983,18,15,98414,1951663200,227810
1141,c1605,20150730,1986,1983,1984,1985,1960,1963,1970,-20,-13,77958,1535796260,265410
1142,c1605,20150731,1963,1970,1969,1980,1969,1974,1974,4,4,66604,1315098600,288388
1143,c1605,20150803,1974,1974,1970,1972,1950,1953,1957,-21,-17,77176,1510646560,324314
1144,c1605,20150804,1953,1957,1957,1975,1950,1959,1959,2,2,77746,1523614800,343516
1145,c1605,20150805,1959,1959,1963,1964,1947,1962,1954,3,-5,96192,1880485240,367634
1146,c1605,20150806,1962,1954,1962,1966,1952,1964,1959,10,5,40790,799322080,376084
1147,c1605,20150807,1964,1959,1962,1962,1949,1957,1954,-2,-5,88098,1721710920,408958
1148,c1605,20150810,1957,1954,1956,1970,1953,1963,1960,9,6,70336,1378805220,426216
1149,c1605,20150811,1963,1960,1970,1986,1965,1968,1973,8,13,69466,1370647180,441676
1150,c1605,20150812,1968,1973,1964,1987,1959,1984,1976,11,3,95434,1886318440,447534
1151,c1605,20150813,1984,1976,1971,1997,1971,1983,1982,7,6,93188,1847075440,463228
1152,c1605,20150814,1983,1982,1983,1996,1972,1975,1985,-7,3,79204,1572721860,478882
1153,c1605,20150817,1975,1985,1975,2002,1972,1999,1992,14,7,97312,1939150160,453100
1154,c1605,20150818,1999,1992,1999,2015,1999,2009,2009,17,17,87024,1748471600,452282
1155,c1605,20150819,2009,2009,2010,2014,1995,2005,2003,-4,-6,93202,1867693880,471326
1156,c1605,20150820,2005,2003,2000,2004,1987,1989,1994,-14,-9,69912,1394442100,488788
1157,c1605,20150821,1989,1994,1993,1994,1963,1977,1977,-17,-17,142906,2825743880,522390
1158,c1605,20150824,1977,1977,1970,1973,1952,1966,1963,-11,-14,106568,2092138060,539772
1159,c1605,20150825,1966,1963,1968,2001,1965,1990,1981,27,18,159250,3155255900,540548
1160,c1605,20150826,1990,1981,1999,1999,1984,1987,1989,6,8,44858,892631520,541834
1161,c1605,20150827,1987,1989,1986,1991,1969,1979,1978,-10,-11,88152,1744513600,542608
1162,c1605,20150828,1979,1978,1991,1996,1972,1978,1983,0,5,96912,1922628240,555340
1163,c1605,20150831,1978,1983,1978,1978,1910,1912,1948,-71,-35,203736,3968925160,599984
1164,c1605,20150901,1912,1948,1932,1937,1906,1926,1922,-22,-26,210004,4038198180,613974
1165,c1605,20150902,1926,1922,1922,1926,1914,1923,1919,1,-3,108384,2079980840,632366
1166,c1605,20150907,1923,1919,1916,1928,1896,1918,1912,-1,-7,233980,4474722900,643302
1167,c1605,20150908,1918,1912,1914,1933,1908,1931,1920,19,8,144790,2780730560,644576
1168,c1605,20150909,1931,1920,1936,1940,1919,1920,1925,0,5,153890,2962740360,703726
1169,c1605,20150910,1920,1925,1928,1929,1901,1921,1913,-4,-12,286124,5475279480,719398
1170,c1605,20150911,1921,1913,1922,1934,1920,1925,1927,12,14,109364,2107540140,700466
1171,c1605,20150914,1925,1927,1929,1932,1910,1915,1916,-12,-11,163170,3127336020,718412
1172,c1605,20150915,1915,1916,1915,1924,1907,1914,1914,-2,-2,142626,2730924400,734624
1173,c1605,20150916,1914,1914,1919,1930,1911,1926,1920,12,6,173868,3339519560,740692
1174,c1605,20150917,1926,1920,1927,1929,1894,1907,1908,-13,-12,378026,7213543400,786148
1175,c1605,20150918,1907,1908,1902,1906,1836,1836,1862,-72,-46,956844,17820518660,977844
1176,c1605,20150921,1836,1862,1856,1883,1835,1856,1853,-6,-9,955768,17714085160,956234
1177,c1605,20150922,1856,1853,1859,1862,1833,1839,1843,-14,-10,409422,7548580780,990456
1178,c1605,20150923,1839,1843,1834,1848,1823,1840,1834,-3,-9,531930,9759410580,1003610
1179,c1605,20150924,1840,1834,1839,1847,1831,1836,1837,2,3,261984,4814721360,1013902
1180,c1605,20150925,1836,1837,1838,1864,1831,1839,1845,2,8,337610,6230508700,996750
1181,c1605,20150928,1839,1845,1830,1841,1825,1830,1830,-15,-15,274280,5021051180,1003260
1182,c1605,20150929,1830,1830,1828,1828,1794,1801,1806,-29,-24,368842,6664678100,1030670
1183,c1605,20150930,1801,1806,1801,1813,1797,1799,1802,-7,-4,345270,6223917000,1114854
1184,c1605,20151008,1799,1802,1790,1813,1774,1801,1798,-1,-4,408070,7338801000,1108996
1185,c1605,20151009,1801,1798,1801,1819,1792,1800,1807,2,9,389732,7043791060,1132824
1186,c1605,20151012,1800,1807,1807,1809,1780,1791,1791,-16,-16,522270,9358924220,1217332
1187,c1605,20151013,1791,1791,1786,1793,1760,1770,1772,-21,-19,602938,10684672440,1289768
1188,c1605,20151014,1770,1772,1773,1801,1769,1797,1787,25,15,480076,8579887240,1246620
1189,c1605,20151015,1797,1787,1795,1812,1792,1801,1802,14,15,358602,6463611900,1235520
1190,c1605,20151016,1801,1802,1800,1814,1793,1814,1802,12,0,377462,6804292560,1264302
1191,c1605,20151019,1814,1802,1814,1817,1796,1801,1806,-1,4,409754,7401354800,1254856
1192,c1605,20151020,1801,1806,1801,1804,1788,1792,1794,-14,-12,381944,6855328320,1271622
1193,c1605,20151021,1792,1794,1794,1811,1793,1803,1801,9,7,351574,6332619880,1243666
1194,c1605,20151022,1803,1801,1806,1810,1793,1803,1801,2,0,324054,5837242520,1235914
1195,c1605,20151023,1803,1801,1796,1807,1792,1804,1801,3,0,301368,5427945980,1217216
1196,c1605,20151026,1804,1801,1804,1833,1799,1827,1823,26,22,631118,11505881820,1219142
1197,c1605,20151027,1827,1823,1827,1841,1818,1839,1830,16,7,485356,8884777100,1189538
1198,c1605,20151028,1839,1830,1836,1839,1820,1822,1826,-8,-4,313042,5716488560,1181220
1199,c1605,20151029,1822,1826,1823,1828,1809,1821,1818,-5,-8,323946,5892344420,1179692
1200,c1605,20151030,1821,1818,1821,1827,1810,1810,1815,-8,-3,227300,4126802420,1191808
1201,c1605,20151102,1810,1815,1814,1827,1812,1816,1818,1,3,229220,4167992880,1204352
1202,c1605,20151103,1816,1818,1815,1838,1811,1836,1828,18,10,304964,5576603860,1209766
1203,c1605,20151104,1836,1828,1835,1849,1830,1832,1840,4,12,446468,8215054300,1169594
1204,c1605,20151105,1832,1840,1830,1845,1827,1838,1837,-2,-3,247548,4548424660,1188276
1205,c1605,20151106,1838,1837,1836,1853,1822,1847,1839,10,2,368586,6781626120,1170668
1206,c1605,20151109,1847,1839,1853,1912,1853,1893,1891,54,52,1680192,31787129620,1088800
1207,c1605,20151110,1893,1891,1883,1884,1839,1848,1858,-43,-33,1124692,20903083800,1276598
1208,c1605,20151111,1848,1858,1836,1853,1836,1845,1844,-13,-14,424078,7820510660,1333940
1209,c1605,20151112,1845,1844,1848,1883,1840,1874,1862,30,18,1220504,22732301820,1391544
1210,c1605,20151113,1874,1862,1875,1886,1865,1872,1874,10,12,613978,11511050640,1370140
1211,c1605,20151116,1872,1874,1875,1896,1859,1860,1873,-14,-1,756974,14183059840,1419084
1212,c1605,20151117,1860,1873,1858,1878,1846,1877,1861,4,-12,768070,14296869480,1451640
1213,c1605,20151118,1877,1861,1884,1884,1865,1876,1873,15,12,550832,10320260100,1422790
1214,c1605,20151119,1876,1873,1876,1877,1846,1861,1861,-12,-12,862920,16059453400,1436994
1215,c1605,20151120,1861,1861,1864,1874,1831,1844,1849,-17,-12,1328882,24583762400,1459184
1216,c1605,20151123,1844,1849,1846,1865,1844,1856,1853,7,4,772750,14321216760,1466244
1217,c1605,20151124,1856,1853,1860,1870,1854,1858,1861,5,8,709988,13217705680,1419186
1218,c1605,20151125,1858,1861,1859,1872,1845,1869,1860,8,-1,780576,14521896000,1405074
1219,c1605,20151126,1869,1860,1871,1888,1866,1872,1874,12,14,546662,10248294160,1343372
1220,c1605,20151127,1872,1874,1870,1902,1863,1899,1883,25,9,725926,13676032020,1319560
1221,c1605,20151130,1899,1883,1900,1912,1884,1893,1896,10,13,801646,15204586580,1448470
1222,c1605,20151201,1893,1896,1898,1899,1881,1887,1888,-9,-8,465350,8788757120,1430156
1223,c1605,20151202,1887,1888,1889,1899,1887,1894,1893,6,5,418624,7927036320,1412270
1224,c1605,20151203,1894,1893,1893,1909,1881,1901,1897,8,4,468238,8886177000,1441070
1225,c1605,20151204,1901,1897,1906,1910,1892,1894,1896,-3,-1,586846,11127901200,1417580
1226,c1605,20151207,1894,1896,1890,1891,1854,1869,1872,-27,-24,925162,17319900300,1383074
1227,c1605,20151208,1869,1872,1865,1875,1856,1869,1864,-3,-8,450854,8408151220,1341350
1228,c1605,20151209,1869,1864,1870,1880,1866,1873,1871,9,7,318328,5958630840,1358794
1229,c1605,20151210,1873,1871,1869,1890,1858,1889,1876,18,5,689520,12939033780,1327802
1230,c1605,20151211,1889,1876,1889,1894,1880,1889,1886,13,10,269864,5091967500,1301506
1231,c1605,20151214,1889,1886,1886,1905,1885,1894,1896,8,10,387840,7357167520,1264200
1232,c1605,20151215,1894,1896,1896,1905,1894,1903,1899,7,3,295276,5608360980,1258722
1233,c1605,20151216,1903,1899,1903,1906,1893,1900,1898,1,-1,231544,4395329780,1268158
1234,c1605,20151217,1900,1898,1898,1923,1897,1906,1907,8,9,326372,6224436000,1294700
1235,c1605,20151218,1906,1907,1902,1921,1901,1920,1914,13,7,312044,5972825480,1312050
1236,c1605,20151221,1920,1914,1919,1936,1917,1930,1926,16,12,479070,9231563340,1318926
1237,c1605,20151222,1930,1926,1929,1946,1915,1918,1930,-8,4,636544,12286221080,1278430
1238,c1605,20151223,1918,1930,1915,1918,1902,1910,1909,-20,-21,431076,8230369620,1281822
1239,c1605,20151224,1910,1909,1909,1917,1905,1912,1912,3,3,268822,5140626020,1268932
1240,c1605,20151225,1912,1912,1911,1913,1900,1903,1905,-9,-7,266196,5071900760,1242140
1241,c1605,20151228,1903,1905,1901,1903,1848,1857,1872,-48,-33,1025784,19206654740,1258818
1242,c1605,20151229,1857,1872,1866,1884,1862,1875,1875,3,3,388818,7291774540,1215732
1243,c1605,20151230,1875,1875,1878,1909,1877,1890,1893,15,18,479460,9080301360,1199196
1244,c1605,20151231,1890,1893,1889,1899,1884,1896,1893,3,0,232172,4396852700,1176084
1245,c1607,20150715,2116,2116,0,0,0,2116,2116,0,0,0,0,0
1246,c1607,20150716,2116,2116,2194,2194,2069,2120,2137,4,21,20,427480,2
1247,c1607,20150717,2120,2137,0,0,0,2137,2137,0,0,0,0,2
1248,c1607,20150720,2137,2137,0,0,0,2129,2129,-8,-8,0,0,2
1249,c1607,20150721,2129,2129,0,0,0,2118,2118,-11,-11,0,0,2
1250,c1607,20150722,2118,2118,2073,2121,2073,2108,2100,-10,-18,6,126040,2
1251,c1607,20150723,2108,2100,0,0,0,2094,2094,-6,-6,0,0,2
1252,c1607,20150724,2094,2094,2081,2104,2061,2061,2084,-33,-10,10,208400,4
1253,c1607,20150727,2061,2084,2002,2010,2001,2001,2002,-83,-82,14,280340,14
1254,c1607,20150728,2001,2002,1989,2019,1973,1986,1995,-16,-7,44,877820,28
1255,c1607,20150729,1986,1995,1992,2009,1991,1993,2000,-2,5,62,1240180,46
1256,c1607,20150730,1993,2000,1999,1999,1983,1983,1996,-17,-4,32,638820,60
1257,c1607,20150731,1983,1996,1999,1999,1982,1993,1990,-3,-6,18,358260,60
1258,c1607,20150803,1993,1990,1994,1994,1973,1988,1988,-2,-2,42,835120,72
1259,c1607,20150804,1988,1988,1994,1994,1978,1987,1987,-1,-1,8,159000,70
1260,c1607,20150805,1987,1987,1969,1969,1969,1969,1969,-18,-18,2,39380,72
1261,c1607,20150806,1969,1969,1928,2022,1928,1986,1985,17,16,8,158820,72
1262,c1607,20150807,1986,1985,0,0,0,1985,1985,0,0,0,0,72
1263,c1607,20150810,1985,1985,0,0,0,1985,1985,0,0,0,0,72
1264,c1607,20150811,1985,1985,1991,2000,1976,1995,1990,10,5,24,477820,72
1265,c1607,20150812,1995,1990,0,0,0,1995,1995,5,5,0,0,72
1266,c1607,20150813,1995,1995,2024,2024,1995,2006,2010,11,15,28,562960,72
1267,c1607,20150814,2006,2010,2018,2018,1997,1997,2004,-13,-6,12,240500,74
1268,c1607,20150817,1997,2004,2007,2018,2007,2010,2011,6,7,6,120700,72
1269,c1607,20150818,2010,2011,2020,2020,2020,2020,2020,9,9,6,121200,68
1270,c1607,20150819,2020,2020,2010,2011,2004,2004,2008,-16,-12,58,1165100,68
1271,c1607,20150820,2004,2008,2000,2007,1987,1993,1996,-15,-12,70,1397840,74
1272,c1607,20150821,1993,1996,1998,1998,1980,1980,1988,-16,-8,8,159080,72
1273,c1607,20150824,1980,1988,1978,1978,1963,1963,1971,-25,-17,8,157680,70
1274,c1607,20150825,1963,1971,1995,2002,1992,1999,1998,28,27,12,239800,72
1275,c1607,20150826,1999,1998,2010,2042,1991,1993,2008,-5,10,54,1084660,72
1276,c1607,20150827,1993,2008,1991,1991,1988,1988,1989,-20,-19,4,79580,74
1277,c1607,20150828,1988,1989,1995,1998,1985,1985,1991,-4,2,18,358480,68
1278,c1607,20150831,1985,1991,1965,1981,1959,1959,1966,-32,-25,12,235980,68
1279,c1607,20150901,1959,1966,1926,1952,1923,1930,1929,-36,-37,20,385880,68
1280,c1607,20150902,1930,1929,1950,1950,1923,1928,1933,-1,4,98,1894500,68
1281,c1607,20150907,1928,1933,1923,1944,1917,1931,1927,-2,-6,48,925140,78
1282,c1607,20150908,1931,1927,1943,1944,1923,1933,1932,6,5,26,502380,76
1283,c1607,20150909,1933,1932,1932,1932,1932,1932,1932,0,0,2,38640,78
1284,c1607,20150910,1932,1932,1921,1924,1910,1924,1914,-8,-18,62,1186980,90
1285,c1607,20150911,1924,1914,1930,1930,1925,1925,1927,11,13,4,77100,88
1286,c1607,20150914,1925,1927,1925,1927,1923,1927,1924,0,-3,28,538960,80
1287,c1607,20150915,1927,1924,0,0,0,1924,1924,0,0,0,0,80
1288,c1607,20150916,1924,1924,1932,1932,1932,1932,1932,8,8,10,193200,72
1289,c1607,20150917,1932,1932,1921,1921,1900,1904,1908,-28,-24,186,3549360,214
1290,c1607,20150918,1904,1908,1896,1897,1832,1837,1865,-71,-43,286,5334460,312
1291,c1607,20150921,1837,1865,1815,1839,1807,1819,1820,-46,-45,114,2075620,316
1292,c1607,20150922,1819,1820,1813,1815,1773,1814,1809,-6,-11,76,1375200,290
1293,c1607,20150923,1814,1809,1804,1804,1790,1798,1796,-11,-13,60,1077800,282
1294,c1607,20150924,1798,1796,1800,1805,1794,1803,1799,7,3,90,1619920,250
1295,c1607,20150925,1803,1799,1791,1814,1791,1805,1802,6,3,160,2884320,140
1296,c1607,20150928,1805,1802,1803,1805,1793,1802,1798,0,-4,16,287760,140
1297,c1607,20150929,1802,1798,1773,1780,1760,1765,1768,-33,-30,32,565860,130
1298,c1607,20150930,1765,1768,1764,1775,1760,1761,1765,-7,-3,116,2048480,132
1299,c1607,20151008,1761,1765,1764,1779,1758,1760,1764,-5,-1,12,211700,128
1300,c1607,20151009,1760,1764,1786,1789,1750,1750,1763,-14,-1,42,740480,146
1301,c1607,20151012,1750,1763,1751,1758,1751,1751,1754,-12,-9,20,350960,132
1302,c1607,20151013,1751,1754,1753,1759,1749,1754,1755,0,1,52,912620,140
1303,c1607,20151014,1754,1755,1766,1779,1759,1779,1769,24,14,12,212320,144
1304,c1607,20151015,1779,1769,1780,1796,1780,1784,1786,15,17,12,214380,144
1305,c1607,20151016,1784,1786,1784,1786,1765,1786,1776,0,-10,26,461940,128
1306,c1607,20151019,1786,1776,1775,1804,1766,1779,1779,3,3,242,4305220,204
1307,c1607,20151020,1779,1779,1779,1786,1767,1772,1781,-7,2,54,962180,228
1308,c1607,20151021,1772,1781,1785,1786,1778,1785,1784,4,3,74,1320520,164
1309,c1607,20151022,1785,1784,1789,1789,1785,1786,1786,2,2,28,500180,166
1310,c1607,20151023,1786,1786,1783,1783,1761,1776,1772,-10,-14,34,602760,162
1311,c1607,20151026,1776,1772,1783,1795,1783,1795,1789,23,17,12,214780,168
1312,c1607,20151027,1795,1789,1783,1797,1783,1796,1792,7,3,6,107520,166
1313,c1607,20151028,1796,1792,1786,1786,1786,1786,1786,-6,-6,2,35720,166
1314,c1607,20151029,1786,1786,1787,1787,1787,1787,1787,1,1,2,35740,168
1315,c1607,20151030,1787,1787,0,0,0,1780,1780,-7,-7,0,0,168
1316,c1607,20151102,1780,1780,0,0,0,1780,1780,0,0,0,0,168
1317,c1607,20151103,1780,1780,1787,1805,1787,1805,1795,25,15,82,1472180,232
1318,c1607,20151104,1805,1795,0,0,0,1795,1795,0,0,0,0,232
1319,c1607,20151105,1795,1795,1812,1826,1811,1811,1814,16,19,214,3882620,294
1320,c1607,20151106,1811,1814,1808,1830,1808,1828,1824,14,10,168,3065700,384
1321,c1607,20151109,1828,1824,1873,1896,1862,1876,1872,52,48,202,3782860,496
1322,c1607,20151110,1876,1872,1869,1874,1848,1855,1859,-17,-13,592,11008440,968
1323,c1607,20151111,1855,1859,1849,1850,1848,1848,1848,-11,-11,86,1589760,1046
1324,c1607,20151112,1848,1848,1855,1873,1842,1873,1854,25,6,200,3708080,1138
1325,c1607,20151113,1873,1854,1879,1896,1876,1877,1879,23,25,554,10414200,926
1326,c1607,20151116,1877,1879,1889,1889,1875,1875,1881,-4,2,332,6247900,1252
1327,c1607,20151117,1875,1881,1870,1879,1869,1879,1875,-2,-6,196,3675860,1424
1328,c1607,20151118,1879,1875,1888,1889,1888,1889,1888,14,13,6,113300,1420
1329,c1607,20151119,1889,1888,1880,1880,1853,1874,1871,-14,-17,24,449060,1424
1330,c1607,20151120,1874,1871,1880,1882,1847,1871,1868,0,-3,58,1083900,1438
1331,c1607,20151123,1871,1868,1876,1876,1874,1874,1875,6,7,24,450200,1460
1332,c1607,20151124,1874,1875,1880,1880,1874,1874,1876,-1,1,12,225120,1464
1333,c1607,20151125,1874,1876,1861,1877,1861,1877,1871,1,-5,34,636340,1472
1334,c1607,20151126,1877,1871,1886,1900,1880,1885,1887,14,16,44,830600,1470
1335,c1607,20151127,1885,1887,1879,1900,1879,1900,1894,13,7,48,909280,1492
1336,c1607,20151130,1900,1894,1930,1930,1901,1920,1908,26,14,102,1946200,1514
1337,c1607,20151201,1920,1908,1904,1905,1896,1896,1899,-12,-9,38,721820,1504
1338,c1607,20151202,1896,1899,1905,1908,1895,1908,1904,9,5,36,685440,1484
1339,c1607,20151203,1908,1904,1899,1909,1899,1907,1902,3,-2,16,304460,1484
1340,c1607,20151204,1907,1902,1898,1905,1895,1902,1897,0,-5,26,493320,1484
1341,c1607,20151207,1902,1897,1895,1895,1866,1876,1882,-21,-15,44,828200,1484
1342,c1607,20151208,1876,1882,1873,1877,1873,1877,1875,-5,-7,4,75000,1484
1343,c1607,20151209,1877,1875,0,0,0,1875,1875,0,0,0,0,1484
1344,c1607,20151210,1875,1875,1879,1886,1862,1886,1880,11,5,48,902840,1486
1345,c1607,20151211,1886,1880,1879,1891,1875,1889,1882,9,2,12,225900,1488
1346,c1607,20151214,1889,1882,1898,1898,1886,1892,1891,10,9,8,151340,1484
1347,c1607,20151215,1892,1891,1896,1896,1889,1892,1892,1,1,6,113540,1484
1348,c1607,20151216,1892,1892,1890,1890,1890,1890,1890,-2,-2,2,37800,1486
1349,c1607,20151217,1890,1890,0,0,0,1890,1890,0,0,0,0,1486
1350,c1607,20151218,1890,1890,1908,1924,1883,1903,1902,13,12,66,1255600,1446
1351,c1607,20151221,1903,1902,0,0,0,1911,1911,9,9,0,0,1446
1352,c1607,20151222,1911,1911,1900,1914,1900,1901,1907,-10,-4,40,763020,1424
1353,c1607,20151223,1901,1907,1961,1961,1889,1899,1914,-8,7,20,382840,1420
1354,c1607,20151224,1899,1914,1888,1898,1884,1891,1890,-23,-24,16,302480,1424
1355,c1607,20151225,1891,1890,1882,1887,1875,1885,1881,-5,-9,24,451440,1430
1356,c1607,20151228,1885,1881,1875,1878,1858,1858,1866,-23,-15,84,1567600,1488
1357,c1607,20151229,1858,1866,1865,1865,1848,1859,1857,-7,-9,6,111440,1490
1358,c1607,20151230,1859,1857,1889,1890,1881,1881,1881,24,24,1404,26413180,1534
1359,c1607,20151231,1881,1881,0,0,0,1882,1882,1,1,0,0,1534
1360,c1609,20150917,1914,1914,1910,1916,1864,1868,1880,-46,-34,20738,390019260,16614
1361,c1609,20150918,1868,1880,1868,1868,1805,1805,1822,-75,-58,108896,1984711220,82482
1362,c1609,20150921,1805,1822,1805,1810,1741,1751,1761,-71,-61,217390,3828862380,153502
1363,c1609,20150922,1751,1761,1755,1760,1736,1738,1746,-23,-15,83580,1459488740,179274
1364,c1609,20150923,1738,1746,1737,1742,1723,1740,1731,-6,-15,122172,2115507220,198692
1365,c1609,20150924,1740,1731,1739,1750,1725,1732,1737,1,6,88928,1544722780,221350
1366,c1609,20150925,1732,1737,1736,1760,1732,1752,1751,15,14,116674,2043064240,204242
1367,c1609,20150928,1752,1751,1755,1757,1740,1746,1746,-5,-5,32320,564323760,205242
1368,c1609,20150929,1746,1746,1746,1747,1703,1712,1713,-34,-33,114382,1959973460,242496
1369,c1609,20150930,1712,1713,1712,1720,1703,1710,1712,-3,-1,69312,1186703780,235230
1370,c1609,20151008,1710,1712,1712,1740,1704,1739,1727,27,15,130598,2256612300,246106
1371,c1609,20151009,1739,1727,1738,1751,1730,1735,1738,8,11,130276,2264504200,273618
1372,c1609,20151012,1735,1738,1737,1742,1730,1737,1735,-1,-3,70190,1218023920,284412
1373,c1609,20151013,1737,1735,1727,1738,1709,1718,1717,-17,-18,162594,2793157420,301968
1374,c1609,20151014,1718,1717,1720,1750,1718,1741,1735,24,18,92694,1609014620,300106
1375,c1609,20151015,1741,1735,1737,1756,1737,1746,1745,11,10,63208,1103422740,306576
1376,c1609,20151016,1746,1745,1740,1769,1739,1768,1753,23,8,96646,1694480500,322214
1377,c1609,20151019,1768,1753,1760,1777,1755,1756,1766,3,13,135692,2397269740,328372
1378,c1609,20151020,1756,1766,1758,1764,1734,1743,1745,-23,-21,110854,1934882380,342172
1379,c1609,20151021,1743,1745,1744,1757,1741,1751,1750,6,5,67728,1185448600,336470
1380,c1609,20151022,1751,1750,1755,1756,1744,1750,1748,0,-2,41678,728834640,341222
1381,c1609,20151023,1750,1748,1748,1755,1741,1750,1747,2,-1,39244,685784920,341668
1382,c1609,20151026,1750,1747,1750,1771,1749,1762,1762,15,15,78298,1380261080,345512
1383,c1609,20151027,1762,1762,1766,1770,1752,1766,1761,4,-1,55418,975954020,344666
1384,c1609,20151028,1766,1761,1764,1769,1752,1755,1758,-6,-3,38552,677849760,344824
1385,c1609,20151029,1755,1758,1755,1762,1744,1753,1752,-5,-6,51848,908876980,342550
1386,c1609,20151030,1753,1752,1755,1758,1732,1732,1740,-20,-12,65576,1141654040,351682
1387,c1609,20151102,1732,1740,1738,1755,1735,1747,1746,7,6,51850,905524760,342358
1388,c1609,20151103,1747,1746,1744,1766,1743,1761,1758,15,12,53314,937791620,334354
1389,c1609,20151104,1761,1758,1764,1771,1762,1764,1767,6,9,63788,1127146020,313124
1390,c1609,20151105,1764,1767,1767,1777,1758,1766,1768,-1,1,73036,1291313240,312454
1391,c1609,20151106,1766,1768,1767,1776,1753,1775,1766,7,-2,58672,1036656440,309302
1392,c1609,20151109,1775,1766,1780,1836,1778,1813,1814,47,48,339316,6156927060,294466
1393,c1609,20151110,1813,1814,1810,1810,1749,1753,1770,-61,-44,281172,4977566700,362990
1394,c1609,20151111,1753,1770,1750,1760,1739,1751,1749,-19,-21,103216,1806090220,365652
1395,c1609,20151112,1751,1749,1738,1772,1728,1759,1748,10,-1,302170,5282841000,422620
1396,c1609,20151113,1759,1748,1760,1768,1751,1755,1758,7,10,146486,2575945400,395940
1397,c1609,20151116,1755,1758,1759,1784,1752,1755,1762,-3,4,206828,3646153320,415810
1398,c1609,20151117,1755,1762,1755,1786,1747,1785,1768,23,6,251842,4453078760,430138
1399,c1609,20151118,1785,1768,1786,1793,1771,1777,1780,9,12,130964,2331650740,412426
1400,c1609,20151119,1777,1780,1786,1786,1753,1762,1765,-18,-15,197226,3481294900,388174
1401,c1609,20151120,1762,1765,1766,1778,1724,1743,1748,-22,-17,279422,4886669540,399954
1402,c1609,20151123,1743,1748,1746,1767,1733,1750,1754,2,6,204598,3589354940,388948
1403,c1609,20151124,1750,1754,1759,1764,1751,1755,1757,1,3,105948,1861933080,384728
1404,c1609,20151125,1755,1757,1751,1759,1735,1754,1748,-3,-9,231750,4052613780,365794
1405,c1609,20151126,1754,1748,1759,1775,1752,1760,1762,12,14,112416,1981120500,358982
1406,c1609,20151127,1760,1762,1758,1782,1752,1778,1770,16,8,143520,2540388860,353092
1407,c1609,20151130,1778,1770,1783,1796,1770,1779,1780,9,10,109932,1957696840,359216
1408,c1609,20151201,1779,1780,1784,1784,1766,1767,1771,-13,-9,66392,1176016180,369202
1409,c1609,20151202,1767,1771,1770,1775,1767,1770,1770,-1,-1,52928,937281320,370896
1410,c1609,20151203,1770,1770,1767,1777,1760,1771,1770,1,0,47104,833808700,369170
1411,c1609,20151204,1771,1770,1773,1777,1758,1762,1763,-8,-7,79556,1403126280,365828
1412,c1609,20151207,1762,1763,1763,1765,1729,1738,1741,-25,-22,167722,2921702860,391654
1413,c1609,20151208,1738,1741,1735,1745,1730,1738,1736,-3,-5,100564,1746351660,381096
1414,c1609,20151209,1738,1736,1736,1747,1733,1735,1737,-1,1,54128,940660840,395088
1415,c1609,20151210,1735,1737,1730,1749,1722,1746,1735,9,-2,202302,3510783960,389904
1416,c1609,20151211,1746,1735,1744,1755,1740,1750,1747,15,12,63274,1105613620,390492
1417,c1609,20151214,1750,1747,1750,1753,1740,1745,1746,-2,-1,65328,1141157700,403204
1418,c1609,20151215,1745,1746,1748,1753,1745,1751,1749,5,3,36552,639549420,400190
1419,c1609,20151216,1751,1749,1751,1753,1747,1751,1750,2,1,22952,401721080,396212
1420,c1609,20151217,1751,1750,1747,1761,1746,1752,1751,2,1,64278,1126101520,392996
1421,c1609,20151218,1752,1751,1755,1774,1751,1772,1763,21,12,95128,1677175620,371372
1422,c1609,20151221,1772,1763,1776,1788,1770,1779,1779,16,16,134026,2385193880,383618
1423,c1609,20151222,1779,1779,1776,1783,1739,1741,1757,-38,-22,299974,5273522640,432352
1424,c1609,20151223,1741,1757,1739,1745,1728,1742,1735,-15,-22,174064,3021367600,434622
1425,c1609,20151224,1742,1735,1734,1739,1725,1729,1730,-6,-5,174130,3012865020,487656
1426,c1609,20151225,1729,1730,1730,1732,1714,1716,1721,-14,-9,159924,2752592000,546404
1427,c1609,20151228,1716,1721,1710,1712,1657,1660,1684,-61,-37,555794,9363333140,612358
1428,c1609,20151229,1660,1684,1668,1689,1666,1681,1679,-3,-5,231160,3882479000,573118
1429,c1609,20151230,1681,1679,1688,1729,1684,1702,1703,23,24,230442,3925566280,560600
1430,c1609,20151231,1702,1703,1701,1708,1695,1705,1703,2,0,69832,1189354420,553146
1431,c1611,20151116,1748,1748,1702,1741,1690,1725,1714,-23,-34,370,6342300,292
1432,c1611,20151117,1725,1714,1737,1747,1727,1747,1735,33,21,64,1110600,320
1433,c1611,20151118,1747,1735,1760,1760,1724,1747,1743,12,8,160,2789180,352
1434,c1611,20151119,1747,1743,1728,1756,1727,1756,1743,13,0,212,3695600,278
1435,c1611,20151120,1756,1743,1738,1753,1722,1740,1734,-3,-9,74,1283660,308
1436,c1611,20151123,1740,1734,1729,1740,1727,1740,1732,6,-2,190,3291100,402
1437,c1611,20151124,1740,1732,1744,1749,1729,1744,1745,12,13,96,1675560,424
1438,c1611,20151125,1744,1745,1732,1748,1729,1748,1737,3,-8,58,1007880,450
1439,c1611,20151126,1748,1737,1754,1755,1739,1751,1749,14,12,104,1819720,474
1440,c1611,20151127,1751,1749,1755,1770,1747,1765,1755,16,6,156,2738040,486
1441,c1611,20151130,1765,1755,1771,1779,1757,1757,1768,2,13,40,707240,502
1442,c1611,20151201,1757,1768,1753,1771,1753,1759,1764,-9,-4,44,776480,494
1443,c1611,20151202,1759,1764,1760,1769,1760,1769,1764,5,0,26,458780,494
1444,c1611,20151203,1769,1764,1761,1769,1760,1766,1764,2,0,22,388240,494
1445,c1611,20151204,1766,1764,1774,1775,1758,1758,1765,-6,1,50,882640,480
1446,c1611,20151207,1758,1765,1738,1766,1723,1734,1737,-31,-28,56,972780,508
1447,c1611,20151208,1734,1737,1708,1749,1708,1738,1730,1,-7,38,657580,504
1448,c1611,20151209,1738,1730,1735,1739,1731,1731,1734,1,4,14,242800,506
1449,c1611,20151210,1731,1734,1727,1739,1727,1739,1732,5,-2,10,173240,506
1450,c1611,20151211,1739,1732,1736,1746,1736,1746,1743,14,11,18,313760,508
1451,c1611,20151214,1746,1743,1746,1746,1740,1740,1741,-3,-2,16,278660,520
1452,c1611,20151215,1740,1741,1732,1746,1732,1744,1742,3,1,42,731680,524
1453,c1611,20151216,1744,1742,1748,1748,1747,1747,1747,5,5,4,69900,528
1454,c1611,20151217,1747,1747,1750,1750,1730,1744,1743,-3,-4,30,523040,542
1455,c1611,20151218,1744,1743,1744,1760,1744,1760,1752,17,9,16,280320,542
1456,c1611,20151221,1760,1752,1776,1776,1761,1771,1766,19,14,92,1625220,564
1457,c1611,20151222,1771,1766,1763,1765,1735,1740,1755,-26,-11,300,5267420,754
1458,c1611,20151223,1740,1755,1730,1747,1727,1739,1732,-16,-23,86,1489800,806
1459,c1611,20151224,1739,1732,1728,1733,1723,1727,1728,-5,-4,74,1278800,858
1460,c1611,20151225,1727,1728,1723,1726,1712,1712,1720,-16,-8,100,1720180,902
1461,c1611,20151228,1712,1720,1711,1711,1654,1663,1673,-57,-47,906,15163700,1234
1462,c1611,20151229,1663,1673,1658,1679,1658,1674,1668,1,-5,276,4603720,1260
1463,c1611,20151230,1674,1668,1679,1734,1679,1695,1694,27,26,420,7116740,1274
1464,c1611,20151231,1695,1694,1695,1697,1692,1695,1694,1,0,36,610100,1270
