1,pp1501,20150105,9718,9713,9380,9380,9131,9131,9180,-582,-533,1408,64630710,16722
2,pp1501,20150106,9131,9180,8630,8750,8630,8695,8703,-485,-477,4412,192006370,12768
3,pp1501,20150107,8695,8703,8695,8695,8400,8400,8474,-303,-229,504,21356410,12384
4,pp1501,20150108,8400,8474,8395,8395,8250,8270,8279,-204,-195,78,3228900,12374
5,pp1501,20150109,8270,8279,8270,8388,8108,8108,8314,-171,35,750,31179710,11830
6,pp1501,20150112,8108,8314,8090,8090,7950,7958,7996,-356,-318,708,28307760,11152
7,pp1501,20150113,7958,7996,8050,8050,7920,7920,7962,-76,-34,210,8361000,10958
8,pp1501,20150114,7920,7962,7900,8050,7900,8050,8029,88,67,456,18307000,10748
9,pp1501,20150115,8050,8029,8000,8200,8000,8100,8074,71,45,1144,46184400,9662
10,pp1501,20150116,8100,8074,8130,8130,8130,8130,8552,56,478,188,7971360,0
11,pp1502,20150105,9200,9385,0,0,0,8870,8870,-515,-515,0,0,26
12,pp1502,20150106,8870,8870,8517,8517,8517,8517,8517,-353,-353,10,425850,24
13,pp1502,20150107,8517,8517,0,0,0,8293,8293,-224,-224,0,0,24
14,pp1502,20150108,8293,8293,0,0,0,8293,8293,0,0,0,0,24
15,pp1502,20150109,8293,8293,0,0,0,8293,8293,0,0,0,0,24
16,pp1502,20150112,8293,8293,8224,8239,8135,8239,8199,-54,-94,6,245980,26
17,pp1502,20150113,8239,8199,0,0,0,8199,8199,0,0,0,0,26
18,pp1502,20150114,8199,8199,0,0,0,8199,8199,0,0,0,0,26
19,pp1502,20150115,8199,8199,0,0,0,8199,8199,0,0,0,0,26
20,pp1502,20150116,8199,8199,0,0,0,8526,8526,327,327,0,0,26
21,pp1502,20150119,8526,8526,8526,8526,8526,8526,8526,0,0,2,85260,26
22,pp1502,20150120,8526,8526,8346,8346,8346,8346,8346,-180,-180,18,751140,26
23,pp1502,20150121,8346,8346,8348,8590,8348,8416,8468,70,122,22,931570,28
24,pp1502,20150122,8416,8468,8555,8555,8555,8555,8555,87,87,2,85550,26
25,pp1502,20150123,8555,8555,0,0,0,8555,8555,0,0,0,0,26
26,pp1502,20150126,8555,8555,8550,8550,8550,8550,8550,-5,-5,4,171000,30
27,pp1502,20150127,8550,8550,8389,8389,8389,8389,8389,-161,-161,2,83890,30
28,pp1502,20150128,8389,8389,8451,8451,8054,8054,8210,-335,-179,18,738930,38
29,pp1502,20150129,8054,8210,8256,8256,7720,7720,7988,-490,-222,4,159760,36
30,pp1502,20150130,7720,7988,7900,7900,7630,7630,7720,-358,-268,12,463200,32
31,pp1502,20150202,7630,7720,7360,8130,7360,8130,7745,410,25,4,154900,34
32,pp1502,20150203,8130,7745,0,0,0,7745,7745,0,0,0,0,34
33,pp1502,20150204,7745,7745,8185,8185,8185,8185,8185,440,440,2,81850,32
34,pp1502,20150205,8185,8185,0,0,0,8185,8185,0,0,0,0,32
35,pp1502,20150206,8185,8185,0,0,0,8185,8185,0,0,0,0,32
36,pp1502,20150209,8185,8185,8050,8450,8050,8450,8383,265,198,12,503000,20
37,pp1502,20150210,8450,8383,8880,8880,8880,8880,8880,497,497,4,177600,16
38,pp1502,20150211,8880,8880,0,0,0,8880,8880,0,0,0,0,16
39,pp1502,20150212,8880,8880,0,0,0,8880,8880,0,0,0,0,16
40,pp1502,20150213,8880,8880,0,0,0,8339,8339,-541,-541,0,0,0
41,pp1503,20150105,8450,8450,8600,8600,8600,8600,8600,150,150,2,86000,12
42,pp1503,20150106,8600,8600,0,0,0,8258,8258,-342,-342,0,0,12
43,pp1503,20150107,8258,8258,0,0,0,8200,8200,-58,-58,0,0,12
44,pp1503,20150108,8200,8200,0,0,0,8200,8200,0,0,0,0,12
45,pp1503,20150109,8200,8200,8500,8500,8500,8500,8500,300,300,2,85000,12
46,pp1503,20150112,8500,8500,8500,8500,8160,8160,8289,-340,-211,8,331590,12
47,pp1503,20150113,8160,8289,7960,8369,7960,7966,8098,-323,-191,6,242950,12
48,pp1503,20150114,7966,8098,8059,8339,7814,7929,8024,-169,-74,30,1203640,10
49,pp1503,20150115,7929,8024,8006,8006,8006,8006,8006,-18,-18,2,80060,12
50,pp1503,20150116,8006,8006,7982,7982,7982,7982,7982,-24,-24,2,79820,12
51,pp1503,20150119,7982,7982,0,0,0,7982,7982,0,0,0,0,12
52,pp1503,20150120,7982,7982,0,0,0,7814,7814,-168,-168,0,0,12
53,pp1503,20150121,7814,7814,0,0,0,7928,7928,114,114,0,0,12
54,pp1503,20150122,7928,7928,0,0,0,8009,8009,81,81,0,0,12
55,pp1503,20150123,8009,8009,0,0,0,8009,8009,0,0,0,0,12
56,pp1503,20150126,8009,8009,7800,7800,7800,7800,7800,-209,-209,4,156000,8
57,pp1503,20150127,7800,7800,0,0,0,7800,7800,0,0,0,0,8
58,pp1503,20150128,7800,7800,7751,7751,7488,7488,7516,-312,-284,62,2330140,38
59,pp1503,20150129,7488,7516,0,0,0,7516,7516,0,0,0,0,38
60,pp1503,20150130,7516,7516,0,0,0,7516,7516,0,0,0,0,38
61,pp1503,20150202,7516,7516,7450,7450,7450,7450,7450,-66,-66,6,223500,38
62,pp1503,20150203,7450,7450,7748,7748,7748,7748,7748,298,298,4,154960,38
63,pp1503,20150204,7748,7748,0,0,0,8057,8057,309,309,0,0,38
64,pp1503,20150205,8057,8057,0,0,0,8057,8057,0,0,0,0,38
65,pp1503,20150206,8057,8057,0,0,0,8057,8057,0,0,0,0,38
66,pp1503,20150209,8057,8057,0,0,0,8251,8251,194,194,0,0,38
67,pp1503,20150210,8251,8251,0,0,0,8581,8581,330,330,0,0,38
68,pp1503,20150211,8581,8581,0,0,0,8581,8581,0,0,0,0,38
69,pp1503,20150212,8581,8581,0,0,0,8581,8581,0,0,0,0,38
70,pp1503,20150213,8581,8581,0,0,0,8581,8581,0,0,0,0,38
71,pp1503,20150216,8581,8581,8494,8495,8494,8495,8494,-86,-87,6,254830,38
72,pp1503,20150217,8495,8494,9088,9088,8514,8887,9053,393,559,84,3802530,78
73,pp1503,20150225,8887,9053,0,0,0,9053,9053,0,0,0,0,78
74,pp1503,20150226,9053,9053,0,0,0,9053,9053,0,0,0,0,78
75,pp1503,20150227,9053,9053,0,0,0,9415,9415,362,362,0,0,78
76,pp1503,20150302,9415,9415,9979,9979,9000,9000,9255,-415,-160,10,462790,84
77,pp1503,20150303,9000,9255,0,0,0,9255,9255,0,0,0,0,84
78,pp1503,20150304,9255,9255,0,0,0,9255,9255,0,0,0,0,84
79,pp1503,20150305,9255,9255,8700,8700,8700,8700,8700,-555,-555,2,87000,84
80,pp1503,20150306,8700,8700,0,0,0,8700,8700,0,0,0,0,84
81,pp1503,20150309,8700,8700,0,0,0,8700,8700,0,0,0,0,84
82,pp1503,20150310,8700,8700,0,0,0,8700,8700,0,0,0,0,84
83,pp1503,20150311,8700,8700,0,0,0,8700,8700,0,0,0,0,84
84,pp1503,20150312,8700,8700,0,0,0,8700,8700,0,0,0,0,84
85,pp1503,20150313,8700,8700,0,0,0,9163,9163,463,463,0,0,0
86,pp1504,20150105,8447,8447,8662,8663,7958,8131,8313,-316,-134,578,24025250,180
87,pp1504,20150106,8131,8313,8000,8032,8000,8032,8000,-281,-313,152,6080320,30
88,pp1504,20150107,8032,8000,7868,7955,7868,7955,7925,-45,-75,6,237770,32
89,pp1504,20150108,7955,7925,7937,7937,7937,7937,7937,12,12,2,79370,34
90,pp1504,20150109,7937,7937,7711,7853,7621,7638,7666,-299,-271,34,1303220,32
91,pp1504,20150112,7638,7666,0,0,0,7666,7666,0,0,0,0,32
92,pp1504,20150113,7666,7666,0,0,0,7666,7666,0,0,0,0,32
93,pp1504,20150114,7666,7666,7703,7703,7541,7608,7597,-58,-69,36,1367480,46
94,pp1504,20150115,7608,7597,7627,7742,7626,7677,7690,80,93,14,538360,42
95,pp1504,20150116,7677,7690,7687,7768,7677,7746,7729,56,39,30,1159430,36
96,pp1504,20150119,7746,7729,0,0,0,7801,7801,72,72,0,0,36
97,pp1504,20150120,7801,7801,7788,7884,7781,7781,7809,-20,8,8,312360,30
98,pp1504,20150121,7781,7809,0,0,0,7923,7923,114,114,0,0,30
99,pp1504,20150122,7923,7923,7742,7830,7742,7830,7786,-93,-137,4,155720,30
100,pp1504,20150123,7830,7786,0,0,0,7786,7786,0,0,0,0,30
101,pp1504,20150126,7786,7786,0,0,0,7583,7583,-203,-203,0,0,30
102,pp1504,20150127,7583,7583,0,0,0,7441,7441,-142,-142,0,0,30
103,pp1504,20150128,7441,7441,7681,7681,7606,7606,7631,165,190,20,763170,36
104,pp1504,20150129,7606,7631,7634,7634,7634,7634,7634,3,3,6,229020,36
105,pp1504,20150130,7634,7634,7570,7570,7570,7570,7570,-64,-64,2,75700,34
106,pp1504,20150202,7570,7570,0,0,0,7570,7570,0,0,0,0,34
107,pp1504,20150203,7570,7570,0,0,0,7872,7872,302,302,0,0,34
108,pp1504,20150204,7872,7872,0,0,0,7872,7872,0,0,0,0,34
109,pp1504,20150205,7872,7872,0,0,0,7872,7872,0,0,0,0,34
110,pp1504,20150206,7872,7872,7968,8035,7968,8035,8001,163,129,4,160030,38
111,pp1504,20150209,8035,8001,7961,8094,7961,8094,8027,93,26,4,160550,36
112,pp1504,20150210,8094,8027,0,0,0,8027,8027,0,0,0,0,36
113,pp1504,20150211,8027,8027,0,0,0,8027,8027,0,0,0,0,36
114,pp1504,20150212,8027,8027,0,0,0,8027,8027,0,0,0,0,36
115,pp1504,20150213,8027,8027,8180,8248,8180,8248,8214,221,187,4,164280,34
116,pp1504,20150216,8248,8214,8131,8131,8130,8131,8130,-83,-84,10,406540,24
117,pp1504,20150217,8131,8130,8560,8699,8404,8666,8612,536,482,72,3100400,62
118,pp1504,20150225,8666,8612,0,0,0,8612,8612,0,0,0,0,62
119,pp1504,20150226,8612,8612,8724,8955,8724,8955,8839,343,227,4,176790,62
120,pp1504,20150227,8955,8839,8850,8850,8500,8528,8659,-311,-180,86,3723400,92
121,pp1504,20150302,8528,8659,8600,8724,8432,8517,8578,-142,-81,104,4460610,130
122,pp1504,20150303,8517,8578,8550,8550,8500,8500,8525,-78,-53,4,170500,128
123,pp1504,20150304,8500,8525,0,0,0,8507,8507,-18,-18,0,0,128
124,pp1504,20150305,8507,8507,8167,8167,8167,8167,8167,-340,-340,4,163340,124
125,pp1504,20150306,8167,8167,7999,8155,7999,8155,8077,-12,-90,4,161540,124
126,pp1504,20150309,8155,8077,8069,8069,8069,8069,8069,-8,-8,2,80690,122
127,pp1504,20150310,8069,8069,0,0,0,8069,8069,0,0,0,0,122
128,pp1504,20150311,8069,8069,0,0,0,7976,7976,-93,-93,0,0,122
129,pp1504,20150312,7976,7976,8029,8029,8029,8029,8029,53,53,2,80290,122
130,pp1504,20150313,8029,8029,0,0,0,8040,8040,11,11,0,0,122
131,pp1504,20150316,8040,8040,8097,8360,8097,8360,8233,320,193,20,823380,108
132,pp1504,20150317,8360,8233,8290,8290,8290,8290,8290,57,57,2,82900,106
133,pp1504,20150318,8290,8290,0,0,0,8290,8290,0,0,0,0,106
134,pp1504,20150319,8290,8290,0,0,0,8290,8290,0,0,0,0,106
135,pp1504,20150320,8290,8290,8400,8446,8400,8446,8415,156,125,6,252470,104
136,pp1504,20150323,8446,8415,8417,8422,8112,8422,8268,7,-147,82,3390020,102
137,pp1504,20150324,8422,8268,0,0,0,8268,8268,0,0,0,0,102
138,pp1504,20150325,8268,8268,8595,8598,8271,8598,8582,330,314,94,4033850,106
139,pp1504,20150326,8598,8582,8800,8800,8800,8800,8800,218,218,2,88000,104
140,pp1504,20150327,8800,8800,0,0,0,8800,8800,0,0,0,0,104
141,pp1504,20150330,8800,8800,8712,8712,8712,8712,8712,-88,-88,4,174240,102
142,pp1504,20150331,8712,8712,8792,8792,8712,8712,8723,0,11,14,610640,98
143,pp1504,20150401,8712,8723,0,0,0,8723,8723,0,0,0,0,98
144,pp1504,20150402,8723,8723,0,0,0,8723,8723,0,0,0,0,98
145,pp1504,20150403,8723,8723,9069,9070,9069,9070,9069,347,346,96,4353590,4
146,pp1504,20150407,9070,9069,0,0,0,9069,9069,0,0,0,0,4
147,pp1504,20150408,9069,9069,0,0,0,9069,9069,0,0,0,0,4
148,pp1504,20150409,9069,9069,0,0,0,9069,9069,0,0,0,0,4
149,pp1504,20150410,9069,9069,0,0,0,9069,9069,0,0,0,0,4
150,pp1504,20150413,9069,9069,0,0,0,9069,9069,0,0,0,0,4
151,pp1504,20150414,9069,9069,8900,8900,8900,8900,8900,-169,-169,4,178000,0
152,pp1504,20150415,8900,8900,0,0,0,9063,9063,163,163,0,0,0
153,pp1505,20150105,7972,7892,7892,7892,7552,7597,7691,-295,-201,562276,21622561230,264666
154,pp1505,20150106,7597,7691,7500,7588,7427,7523,7508,-168,-183,698670,26228756460,299502
155,pp1505,20150107,7523,7508,7485,7540,7380,7432,7453,-76,-55,682236,25426022380,332888
156,pp1505,20150108,7432,7453,7480,7498,7388,7389,7447,-64,-6,531934,19808265240,366918
157,pp1505,20150109,7389,7447,7390,7412,7150,7150,7204,-297,-243,1112138,40062622590,420154
158,pp1505,20150112,7150,7204,7100,7215,7076,7203,7155,-1,-49,636866,22787008120,374892
159,pp1505,20150113,7203,7155,7140,7268,7123,7188,7187,33,32,767458,27578980430,359776
160,pp1505,20150114,7188,7187,7250,7295,7150,7199,7208,12,21,732474,26401995360,360046
161,pp1505,20150115,7199,7208,7280,7347,7235,7314,7294,106,86,642340,23427828390,350150
162,pp1505,20150116,7314,7294,7250,7298,7203,7260,7257,-34,-37,552704,20055789200,366878
163,pp1505,20150119,7260,7257,7320,7449,7320,7435,7382,178,125,614316,22676003290,334606
164,pp1505,20150120,7435,7382,7392,7414,7252,7285,7316,-97,-66,516482,18894362740,345654
165,pp1505,20150121,7285,7316,7270,7400,7252,7357,7345,41,29,451430,16580453350,349252
166,pp1505,20150122,7357,7345,7403,7429,7270,7343,7338,-2,-7,652580,23944447980,361158
167,pp1505,20150123,7343,7338,7364,7364,7286,7350,7327,12,-11,477166,17481819150,346118
168,pp1505,20150126,7350,7327,7300,7310,7152,7203,7204,-124,-123,534510,19254472010,359362
169,pp1505,20150127,7203,7204,7240,7248,7189,7225,7221,21,17,319230,11526379970,354234
170,pp1505,20150128,7225,7221,7229,7315,7184,7307,7249,86,28,449890,16306994260,368842
171,pp1505,20150129,7307,7249,7273,7334,7253,7294,7286,45,37,445320,16224738450,371830
172,pp1505,20150130,7294,7286,7285,7310,7193,7218,7228,-68,-58,402976,14564044700,386422
173,pp1505,20150202,7218,7228,7340,7405,7319,7362,7360,134,132,455728,16770874210,378180
174,pp1505,20150203,7362,7360,7450,7599,7435,7588,7503,228,143,671370,25188624310,350898
175,pp1505,20150204,7588,7503,7650,7803,7641,7722,7743,219,240,716684,27748711730,311808
176,pp1505,20150205,7722,7743,7600,7628,7555,7620,7588,-123,-155,431920,16388690160,290716
177,pp1505,20150206,7620,7588,7730,7856,7693,7846,7787,258,199,720726,28061926530,312442
178,pp1505,20150209,7846,7787,7830,7842,7718,7776,7775,-11,-12,512586,19928184690,307756
179,pp1505,20150210,7776,7775,7770,7804,7720,7792,7763,17,-12,409386,15890404320,306070
180,pp1505,20150211,7792,7763,7745,7832,7727,7816,7783,53,20,424490,16521037880,316190
181,pp1505,20150212,7816,7783,7800,7850,7751,7843,7798,60,15,421732,16445427280,305188
182,pp1505,20150213,7843,7798,7900,8109,7900,8109,8017,311,219,767140,30752280480,297250
183,pp1505,20150216,8109,8017,8122,8210,8060,8203,8131,186,114,457116,18586006510,242170
184,pp1505,20150217,8203,8131,8182,8244,8120,8188,8175,57,44,329060,13451161350,218304
185,pp1505,20150225,8188,8175,8060,8258,8031,8227,8168,52,-7,358648,14647765660,219194
186,pp1505,20150226,8227,8168,8290,8399,8261,8396,8323,228,155,481504,20038034540,222606
187,pp1505,20150227,8396,8323,8330,8364,8173,8292,8272,-31,-51,821604,33982731370,245650
188,pp1505,20150302,8292,8272,8342,8601,8340,8532,8491,260,219,872478,37041525240,261942
189,pp1505,20150303,8532,8491,8582,8590,8417,8447,8477,-44,-14,584560,24776735080,237184
190,pp1505,20150304,8447,8477,8460,8468,8320,8439,8400,-38,-77,663964,27887402690,259408
191,pp1505,20150305,8439,8400,8360,8392,8176,8255,8290,-145,-110,801850,33240200410,253400
192,pp1505,20150306,8255,8290,8250,8264,8152,8190,8196,-100,-94,507550,20800068540,250246
193,pp1505,20150309,8190,8196,8100,8143,7999,8108,8061,-88,-135,579606,23363880560,238176
194,pp1505,20150310,8108,8061,8112,8164,8071,8077,8114,16,53,476802,19344594640,244358
195,pp1505,20150311,8077,8114,8018,8060,7931,7931,8002,-183,-112,550380,22021872540,266110
196,pp1505,20150312,7931,8002,7940,8313,7935,8281,8134,279,132,894976,36401534430,251744
197,pp1505,20150313,8281,8134,8248,8377,8209,8358,8315,224,181,950650,39526943240,221716
198,pp1505,20150316,8358,8315,8268,8452,8128,8400,8315,85,0,1280694,53250892770,260196
199,pp1505,20150317,8400,8315,8420,8483,8350,8426,8408,111,93,1159624,48752232510,243250
200,pp1505,20150318,8426,8408,8376,8408,8212,8243,8299,-165,-109,890454,36949719880,221172
201,pp1505,20150319,8243,8299,8350,8493,8350,8428,8430,129,131,850314,35843174150,264484
202,pp1505,20150320,8428,8430,8482,8505,8411,8462,8447,32,17,563982,23822275460,252840
203,pp1505,20150323,8462,8447,8482,8708,8482,8692,8641,245,194,718182,31029552150,233188
204,pp1505,20150324,8692,8641,8776,8817,8661,8745,8740,104,99,600002,26222601710,203898
205,pp1505,20150325,8745,8740,8744,8775,8671,8719,8716,-21,-24,334826,14592728900,204728
206,pp1505,20150326,8719,8716,8825,8883,8721,8844,8807,128,91,342624,15089073670,198460
207,pp1505,20150327,8844,8807,8840,8949,8710,8798,8811,-9,4,579390,25525948500,212132
208,pp1505,20150330,8798,8811,8734,8795,8665,8771,8733,-40,-78,269798,11781177310,188916
209,pp1505,20150331,8771,8733,8771,8879,8771,8831,8822,98,89,157962,6967893460,171802
210,pp1505,20150401,8831,8822,8805,9033,8778,9021,8931,199,109,255198,11396025910,179896
211,pp1505,20150402,9021,8931,9135,9150,9017,9100,9079,169,148,215388,9777558300,150646
212,pp1505,20150403,9100,9079,9080,9145,8852,8972,9014,-107,-65,515314,23225646000,195354
213,pp1505,20150407,8972,9014,9082,9141,9043,9126,9098,112,84,161580,7350849180,185534
214,pp1505,20150408,9126,9098,9150,9448,9125,9411,9311,313,213,345104,16067457900,164058
215,pp1505,20150409,9411,9311,9351,9351,9185,9239,9268,-72,-43,203132,9413239270,145684
216,pp1505,20150410,9239,9268,9209,9329,9132,9213,9237,-55,-31,179104,8272143810,142992
217,pp1505,20150413,9213,9237,9240,9320,9204,9232,9245,-5,8,92636,4282268160,131996
218,pp1505,20150414,9232,9245,9234,9270,8891,8962,9059,-283,-186,212128,9608825430,124808
219,pp1505,20150415,8962,9059,9000,9007,8857,8925,8924,-134,-135,114892,5126940610,113902
220,pp1505,20150416,8925,8924,9000,9143,8975,9091,9057,167,133,148912,6744039810,94136
221,pp1505,20150417,9091,9057,9112,9408,9097,9308,9259,251,202,111720,5172179800,96656
222,pp1505,20150420,9308,9259,9414,9414,9180,9233,9286,-26,27,59264,2751707510,90850
223,pp1505,20150421,9233,9286,9250,9293,9212,9280,9252,-6,-34,40410,1869558530,83800
224,pp1505,20150422,9280,9252,9240,9274,9164,9222,9208,-30,-44,37102,1708218170,71456
225,pp1505,20150423,9222,9208,9205,9350,9205,9290,9284,82,76,24902,1156070540,67204
226,pp1505,20150424,9290,9284,9350,9420,9326,9390,9380,106,96,28338,1329064600,59782
227,pp1505,20150427,9390,9380,9388,9755,9388,9755,9595,375,215,36440,1748266360,43576
228,pp1505,20150428,9755,9595,9725,9880,9670,9714,9753,119,158,14516,707935350,39968
229,pp1505,20150429,9714,9753,9736,9749,9507,9590,9620,-163,-133,16794,807840770,32136
230,pp1505,20150430,9590,9620,9699,9750,9605,9675,9684,55,64,9864,477626910,26194
231,pp1505,20150504,9675,9684,9400,9600,9400,9598,9598,-86,-86,1722,82644710,24526
232,pp1505,20150505,9598,9598,9600,9630,9550,9600,9591,2,-7,1264,60616210,23718
233,pp1505,20150506,9600,9591,9600,9600,9540,9540,9577,-51,-14,1554,74416400,22256
234,pp1505,20150507,9540,9577,9500,9500,9441,9450,9475,-127,-102,252,11939090,22052
235,pp1505,20150508,9450,9475,9450,9450,9300,9390,9370,-85,-105,598,28017300,21988
236,pp1505,20150511,9390,9370,9400,9499,9330,9350,9386,-20,16,138,6476350,21894
237,pp1505,20150512,9350,9386,9360,9380,9190,9330,9326,-56,-60,270,12590100,21856
238,pp1505,20150513,9330,9326,9000,9100,9000,9000,9050,-326,-276,240,10860000,21616
239,pp1505,20150514,9000,9050,9100,9100,8812,8888,8937,-162,-113,668,29852310,21192
240,pp1505,20150515,8888,8937,8850,9100,8850,9100,9460,163,523,348,16269900,0
241,pp1506,20150105,7774,7774,7593,7596,7230,7446,7397,-328,-377,26,961730,18
242,pp1506,20150106,7446,7397,7338,7418,7333,7333,7363,-64,-34,12,441820,18
243,pp1506,20150107,7333,7363,7391,7474,7303,7303,7357,-60,-6,18,662180,20
244,pp1506,20150108,7303,7357,7360,7360,7220,7227,7269,-130,-88,6,218070,22
245,pp1506,20150109,7227,7269,7167,7172,7054,7150,7144,-119,-125,50,1786240,56
246,pp1506,20150112,7150,7144,7055,7150,7013,7148,7128,4,-16,58,2067380,96
247,pp1506,20150113,7148,7128,7174,7174,7174,7174,7174,46,46,2,71740,96
248,pp1506,20150114,7174,7174,7168,7168,7168,7168,7168,-6,-6,2,71680,96
249,pp1506,20150115,7168,7168,7230,7294,7230,7294,7262,126,94,4,145240,96
250,pp1506,20150116,7294,7262,7152,7300,7152,7299,7245,37,-17,56,2028830,110
251,pp1506,20150119,7299,7245,7341,7405,7341,7405,7373,160,128,4,147460,110
252,pp1506,20150120,7405,7373,0,0,0,7373,7373,0,0,0,0,110
253,pp1506,20150121,7373,7373,0,0,0,7373,7373,0,0,0,0,110
254,pp1506,20150122,7373,7373,7422,7422,7320,7320,7371,-53,-2,8,294840,110
255,pp1506,20150123,7320,7371,0,0,0,7371,7371,0,0,0,0,110
256,pp1506,20150126,7371,7371,7220,7220,7220,7220,7220,-151,-151,2,72200,112
257,pp1506,20150127,7220,7220,7278,7278,7278,7278,7278,58,58,2,72780,112
258,pp1506,20150128,7278,7278,7186,7499,7186,7316,7252,38,-26,38,1378050,108
259,pp1506,20150129,7316,7252,7253,7253,7253,7253,7253,1,1,2,72530,108
260,pp1506,20150130,7253,7253,0,0,0,7257,7257,4,4,0,0,108
261,pp1506,20150202,7257,7257,7335,7335,7335,7335,7335,78,78,4,146700,108
262,pp1506,20150203,7335,7335,0,0,0,7477,7477,142,142,0,0,108
263,pp1506,20150204,7477,7477,7776,7776,7747,7747,7769,270,292,64,2486190,116
264,pp1506,20150205,7747,7769,0,0,0,7719,7719,-50,-50,0,0,116
265,pp1506,20150206,7719,7719,7701,7796,7658,7796,7738,77,19,12,464300,112
266,pp1506,20150209,7796,7738,0,0,0,7738,7738,0,0,0,0,112
267,pp1506,20150210,7738,7738,7772,7788,7710,7729,7749,-9,11,8,309990,110
268,pp1506,20150211,7729,7749,7841,7844,7769,7769,7811,20,62,16,624880,110
269,pp1506,20150212,7769,7811,7806,7806,7806,7806,7806,-5,-5,4,156120,110
270,pp1506,20150213,7806,7806,7938,7943,7938,7943,7940,137,134,4,158810,108
271,pp1506,20150216,7943,7940,8094,8213,8094,8213,8108,273,168,58,2351470,154
272,pp1506,20150217,8213,8108,8178,8222,8145,8221,8162,113,54,42,1714220,134
273,pp1506,20150225,8221,8162,0,0,0,8162,8162,0,0,0,0,134
274,pp1506,20150226,8162,8162,0,0,0,8345,8345,183,183,0,0,134
275,pp1506,20150227,8345,8345,8393,8393,8393,8393,8393,48,48,2,83930,136
276,pp1506,20150302,8393,8393,8090,8598,8090,8598,8304,205,-89,142,5896130,168
277,pp1506,20150303,8598,8304,8510,8540,7973,8465,8375,161,71,358,14992320,224
278,pp1506,20150304,8465,8375,8359,8511,8359,8484,8449,109,74,232,9801920,152
279,pp1506,20150305,8484,8449,8352,8444,8179,8292,8375,-157,-74,100,4187520,154
280,pp1506,20150306,8292,8375,8278,8304,8242,8242,8266,-133,-109,120,4959970,174
281,pp1506,20150309,8242,8266,8071,8207,8011,8207,8103,-59,-163,40,1620610,184
282,pp1506,20150310,8207,8103,8170,8186,8116,8133,8140,30,37,82,3337710,162
283,pp1506,20150311,8133,8140,8133,8133,8004,8040,8030,-100,-110,18,722780,160
284,pp1506,20150312,8040,8030,7938,8206,7938,8206,8028,176,-2,28,1124040,160
285,pp1506,20150313,8206,8028,8269,8349,8269,8348,8338,320,310,236,9839130,160
286,pp1506,20150316,8348,8338,8164,8484,8164,8430,8311,92,-27,74,3075160,174
287,pp1506,20150317,8430,8311,8480,8503,8380,8401,8460,90,149,342,14467630,166
288,pp1506,20150318,8401,8460,8399,8399,8261,8261,8352,-199,-108,20,835200,168
289,pp1506,20150319,8261,8352,8498,8548,8332,8404,8454,52,102,186,7863080,172
290,pp1506,20150320,8404,8454,8387,8498,8344,8371,8389,-83,-65,28,1174520,156
291,pp1506,20150323,8371,8389,8683,8683,8483,8555,8604,166,215,20,860480,156
292,pp1506,20150324,8555,8604,8555,8798,8555,8689,8689,85,85,170,7385970,150
293,pp1506,20150325,8689,8689,8680,8725,8582,8653,8702,-36,13,86,3742050,148
294,pp1506,20150326,8653,8702,8685,8860,8685,8814,8762,112,60,16,700960,140
295,pp1506,20150327,8814,8762,8751,8923,8511,8778,8752,16,-10,248,10852950,160
296,pp1506,20150330,8778,8752,8725,8745,8619,8745,8699,-7,-53,28,1217930,148
297,pp1506,20150331,8745,8699,8692,8777,8690,8777,8716,78,17,548,23883270,140
298,pp1506,20150401,8777,8716,8772,8962,8772,8950,8909,234,193,12,534580,144
299,pp1506,20150402,8950,8909,9144,9144,8965,9138,9060,229,151,12,543650,146
300,pp1506,20150403,9138,9060,9040,9067,8776,8889,9021,-171,-39,218,9833400,144
301,pp1506,20150407,8889,9021,9060,9060,9060,9060,9060,39,39,2,90600,144
302,pp1506,20150408,9060,9060,9219,9219,9065,9076,9127,16,67,122,5567640,186
303,pp1506,20150409,9076,9127,9108,9108,8935,8942,9003,-185,-124,38,1710710,174
304,pp1506,20150410,8942,9003,9091,9094,8864,8864,8971,-139,-32,22,986880,174
305,pp1506,20150413,8864,8971,9087,9087,8852,8852,8974,-119,3,48,2153950,172
306,pp1506,20150414,8852,8974,8889,8889,8750,8750,8779,-224,-195,30,1316930,160
307,pp1506,20150415,8750,8779,0,0,0,8779,8779,0,0,0,0,160
308,pp1506,20150416,8779,8779,0,0,0,8801,8801,22,22,0,0,160
309,pp1506,20150417,8801,8801,8919,9120,8919,8939,9002,138,201,26,1170340,156
310,pp1506,20150420,8939,9002,9213,9213,8927,8927,9070,-75,68,4,181400,154
311,pp1506,20150421,8927,9070,0,0,0,9052,9052,-18,-18,0,0,154
312,pp1506,20150422,9052,9052,8920,8936,8920,8936,8928,-116,-124,4,178560,154
313,pp1506,20150423,8936,8928,9007,9110,8941,8941,9014,13,86,10,450720,156
314,pp1506,20150424,8941,9014,9072,9072,9072,9072,9072,58,58,6,272160,150
315,pp1506,20150427,9072,9072,9087,9433,9087,9433,9289,361,217,18,836090,146
316,pp1506,20150428,9433,9289,9522,9660,9368,9640,9591,351,302,48,2301950,134
317,pp1506,20150429,9640,9591,9589,9869,9587,9704,9736,113,145,66,3212960,132
318,pp1506,20150430,9704,9736,9484,9899,9484,9745,9798,9,62,52,2547710,154
319,pp1506,20150504,9745,9798,9704,9704,9625,9625,9669,-173,-129,60,2900890,192
320,pp1506,20150505,9625,9669,9760,9760,9562,9617,9660,-52,-9,42,2028790,184
321,pp1506,20150506,9617,9660,9669,9699,9649,9699,9665,39,5,20,966510,190
322,pp1506,20150507,9699,9665,9589,9589,9407,9408,9503,-257,-162,60,2851030,172
323,pp1506,20150508,9408,9503,9236,9399,9195,9200,9277,-303,-226,58,2690530,154
324,pp1506,20150511,9200,9277,9280,9280,9092,9092,9186,-185,-91,4,183720,152
325,pp1506,20150512,9092,9186,9148,9148,9148,9148,9148,-38,-38,2,91480,150
326,pp1506,20150513,9148,9148,0,0,0,8878,8878,-270,-270,0,0,150
327,pp1506,20150514,8878,8878,9124,9124,9124,9124,9124,246,246,2,91240,148
328,pp1506,20150515,9124,9124,0,0,0,9124,9124,0,0,0,0,148
329,pp1506,20150518,9124,9124,9083,9083,9083,9083,9083,-41,-41,8,363320,146
330,pp1506,20150519,9083,9083,8999,9016,8999,9016,9007,-67,-76,4,180150,142
331,pp1506,20150520,9016,9007,8651,9029,8651,9029,8957,22,-50,12,537440,134
332,pp1506,20150521,9029,8957,9315,9315,9120,9120,9185,163,228,6,275550,130
333,pp1506,20150522,9120,9185,9550,9550,8871,9199,9197,14,12,20,919790,130
334,pp1506,20150525,9199,9197,8852,9525,8852,9000,9125,-197,-72,6,273770,128
335,pp1506,20150526,9000,9125,9000,9000,9000,9000,9000,-125,-125,4,180000,124
336,pp1506,20150527,9000,9000,0,0,0,9000,9000,0,0,0,0,124
337,pp1506,20150528,9000,9000,9299,9299,8942,8945,9014,-55,14,10,450700,124
338,pp1506,20150529,8945,9014,8970,9200,8711,8875,8933,-139,-81,20,893350,118
339,pp1506,20150601,8875,8933,8750,8750,8750,8750,8750,-183,-183,30,1312500,88
340,pp1506,20150602,8750,8750,0,0,0,8750,8750,0,0,0,0,88
341,pp1506,20150603,8750,8750,0,0,0,8750,8750,0,0,0,0,88
342,pp1506,20150604,8750,8750,0,0,0,8750,8750,0,0,0,0,88
343,pp1506,20150605,8750,8750,0,0,0,8750,8750,0,0,0,0,88
344,pp1506,20150608,8750,8750,0,0,0,8750,8750,0,0,0,0,88
345,pp1506,20150609,8750,8750,0,0,0,8750,8750,0,0,0,0,88
346,pp1506,20150610,8750,8750,0,0,0,8750,8750,0,0,0,0,88
347,pp1506,20150611,8750,8750,0,0,0,8750,8750,0,0,0,0,88
348,pp1506,20150612,8750,8750,0,0,0,8750,8750,0,0,0,0,0
349,pp1507,20150105,7716,7716,0,0,0,7716,7716,0,0,0,0,14
350,pp1507,20150106,7716,7716,7408,7520,7408,7520,7440,-196,-276,12,446420,22
351,pp1507,20150107,7520,7440,0,0,0,7440,7440,0,0,0,0,22
352,pp1507,20150108,7440,7440,0,0,0,7440,7440,0,0,0,0,22
353,pp1507,20150109,7440,7440,7144,7144,7143,7143,7143,-297,-297,44,1571470,62
354,pp1507,20150112,7143,7143,7150,7150,7150,7150,7150,7,7,42,1501500,102
355,pp1507,20150113,7150,7150,7164,7201,7138,7141,7162,-9,12,32,1145970,92
356,pp1507,20150114,7141,7162,7182,7205,7175,7205,7188,43,26,10,359410,92
357,pp1507,20150115,7205,7188,7263,7335,7248,7335,7279,147,91,8,291160,86
358,pp1507,20150116,7335,7279,7193,7255,7193,7255,7224,-24,-55,4,144480,84
359,pp1507,20150119,7255,7224,0,0,0,7344,7344,120,120,0,0,84
360,pp1507,20150120,7344,7344,0,0,0,7344,7344,0,0,0,0,84
361,pp1507,20150121,7344,7344,0,0,0,7344,7344,0,0,0,0,84
362,pp1507,20150122,7344,7344,0,0,0,7344,7344,0,0,0,0,84
363,pp1507,20150123,7344,7344,0,0,0,7344,7344,0,0,0,0,84
364,pp1507,20150126,7344,7344,0,0,0,7256,7256,-88,-88,0,0,84
365,pp1507,20150127,7256,7256,0,0,0,7256,7256,0,0,0,0,84
366,pp1507,20150128,7256,7256,0,0,0,7256,7256,0,0,0,0,84
367,pp1507,20150129,7256,7256,0,0,0,7257,7257,1,1,0,0,84
368,pp1507,20150130,7257,7257,0,0,0,7257,7257,0,0,0,0,84
369,pp1507,20150202,7257,7257,0,0,0,7334,7334,77,77,0,0,84
370,pp1507,20150203,7334,7334,0,0,0,7481,7481,147,147,0,0,84
371,pp1507,20150204,7481,7481,7780,7780,7780,7780,7780,299,299,2,77800,82
372,pp1507,20150205,7780,7780,0,0,0,7625,7625,-155,-155,0,0,82
373,pp1507,20150206,7625,7625,7811,7811,7811,7811,7811,186,186,4,156220,82
374,pp1507,20150209,7811,7811,0,0,0,7811,7811,0,0,0,0,82
375,pp1507,20150210,7811,7811,0,0,0,7811,7811,0,0,0,0,82
376,pp1507,20150211,7811,7811,0,0,0,7811,7811,0,0,0,0,82
377,pp1507,20150212,7811,7811,0,0,0,7807,7807,-4,-4,0,0,82
378,pp1507,20150213,7807,7807,0,0,0,7941,7941,134,134,0,0,82
379,pp1507,20150216,7941,7941,8153,8194,8153,8194,8173,253,232,92,3760030,162
380,pp1507,20150217,8194,8173,8115,8201,8115,8179,8144,6,-29,68,2769270,128
381,pp1507,20150225,8179,8144,8164,8164,8163,8163,8163,19,19,12,489800,128
382,pp1507,20150226,8163,8163,8370,8399,8370,8399,8378,236,215,22,921670,128
383,pp1507,20150227,8399,8378,8284,8331,8184,8275,8271,-103,-107,24,992550,140
384,pp1507,20150302,8275,8271,8499,8499,8499,8499,8499,228,228,2,84990,138
385,pp1507,20150303,8499,8499,8447,8447,8447,8447,8447,-52,-52,4,168940,140
386,pp1507,20150304,8447,8447,8368,8368,8368,8368,8368,-79,-79,16,669440,134
387,pp1507,20150305,8368,8368,0,0,0,8305,8305,-63,-63,0,0,134
388,pp1507,20150306,8305,8305,8144,8249,8144,8249,8196,-56,-109,20,819650,134
389,pp1507,20150309,8249,8196,0,0,0,8196,8196,0,0,0,0,134
390,pp1507,20150310,8196,8196,0,0,0,8136,8136,-60,-60,0,0,134
391,pp1507,20150311,8136,8136,0,0,0,8136,8136,0,0,0,0,134
392,pp1507,20150312,8136,8136,0,0,0,8236,8236,100,100,0,0,134
393,pp1507,20150313,8236,8236,0,0,0,8554,8554,318,318,0,0,134
394,pp1507,20150316,8554,8554,8212,8454,8212,8357,8387,-197,-167,80,3354870,132
395,pp1507,20150317,8357,8387,0,0,0,8423,8423,36,36,0,0,132
396,pp1507,20150318,8423,8423,0,0,0,8423,8423,0,0,0,0,132
397,pp1507,20150319,8423,8423,0,0,0,8406,8406,-17,-17,0,0,132
398,pp1507,20150320,8406,8406,8385,8449,8367,8449,8413,43,7,28,1177930,132
399,pp1507,20150323,8449,8413,8587,8631,8587,8631,8603,218,190,10,430170,132
400,pp1507,20150324,8631,8603,8575,8621,8575,8621,8598,18,-5,4,171960,134
401,pp1507,20150325,8621,8598,0,0,0,8652,8652,54,54,0,0,134
402,pp1507,20150326,8652,8652,0,0,0,8781,8781,129,129,0,0,134
403,pp1507,20150327,8781,8781,8890,8890,8724,8734,8796,-47,15,16,703710,132
404,pp1507,20150330,8734,8796,0,0,0,8780,8780,-16,-16,0,0,132
405,pp1507,20150331,8780,8780,8865,8865,8865,8865,8865,85,85,2,88650,132
406,pp1507,20150401,8865,8865,0,0,0,8865,8865,0,0,0,0,132
407,pp1507,20150402,8865,8865,8948,8948,8948,8948,8948,83,83,2,89480,132
408,pp1507,20150403,8948,8948,9036,9036,8677,8677,8918,-271,-30,10,445900,132
409,pp1507,20150407,8677,8918,8979,8980,8979,8980,8979,62,61,6,269390,132
410,pp1507,20150408,8980,8979,9198,9198,9112,9112,9155,133,176,4,183100,132
411,pp1507,20150409,9112,9155,8975,8975,8975,8975,8975,-180,-180,4,179500,136
412,pp1507,20150410,8975,8975,9097,9097,8972,8972,9011,-3,36,20,901130,132
413,pp1507,20150413,8972,9011,0,0,0,9011,9011,0,0,0,0,132
414,pp1507,20150414,9011,9011,8947,9000,8947,8968,8977,-43,-34,24,1077260,142
415,pp1507,20150415,8968,8977,8901,8901,8726,8726,8759,-251,-218,46,2014740,150
416,pp1507,20150416,8726,8759,0,0,0,8801,8801,42,42,0,0,150
417,pp1507,20150417,8801,8801,0,0,0,9001,9001,200,200,0,0,150
418,pp1507,20150420,9001,9001,9297,9298,9148,9148,9263,147,262,30,1389460,144
419,pp1507,20150421,9148,9263,9211,9211,9211,9211,9211,-52,-52,2,92110,142
420,pp1507,20150422,9211,9211,9176,9176,9012,9012,9094,-199,-117,4,181880,142
421,pp1507,20150423,9012,9094,0,0,0,9094,9094,0,0,0,0,142
422,pp1507,20150424,9094,9094,0,0,0,9094,9094,0,0,0,0,142
423,pp1507,20150427,9094,9094,0,0,0,9311,9311,217,217,0,0,142
424,pp1507,20150428,9311,9311,9579,9681,9579,9601,9608,290,297,28,1345250,138
425,pp1507,20150429,9601,9608,9590,9743,9466,9466,9569,-142,-39,104,4976230,150
426,pp1507,20150430,9466,9569,9549,9569,9543,9548,9549,-21,-20,20,954970,154
427,pp1507,20150504,9548,9549,9551,9552,9551,9552,9551,3,2,4,191030,156
428,pp1507,20150505,9552,9551,0,0,0,9551,9551,0,0,0,0,156
429,pp1507,20150506,9551,9551,9550,9587,9550,9587,9574,36,23,6,287240,154
430,pp1507,20150507,9587,9574,9495,9495,9361,9489,9456,-85,-118,30,1418500,150
431,pp1507,20150508,9489,9456,9489,9489,9300,9300,9361,-156,-95,18,842540,148
432,pp1507,20150511,9300,9361,9355,9355,9161,9171,9252,-190,-109,10,462620,152
433,pp1507,20150512,9171,9252,9081,9245,9081,9085,9148,-167,-104,14,640360,150
434,pp1507,20150513,9085,9148,0,0,0,8878,8878,-270,-270,0,0,150
435,pp1507,20150514,8878,8878,8981,8981,8981,8981,8981,103,103,6,269430,154
436,pp1507,20150515,8981,8981,0,0,0,9340,9340,359,359,0,0,154
437,pp1507,20150518,9340,9340,9005,9006,9005,9006,9005,-334,-335,6,270170,148
438,pp1507,20150519,9006,9005,0,0,0,8930,8930,-75,-75,0,0,148
439,pp1507,20150520,8930,8930,8929,8931,8929,8931,8930,1,0,4,178600,148
440,pp1507,20150521,8931,8930,0,0,0,9157,9157,227,227,0,0,148
441,pp1507,20150522,9157,9157,8924,9178,8924,9178,9051,21,-106,4,181020,148
442,pp1507,20150525,9178,9051,8928,9179,8928,9179,9019,128,-32,46,2074420,148
443,pp1507,20150526,9179,9019,0,0,0,9101,9101,82,82,0,0,148
444,pp1507,20150527,9101,9101,9106,9106,9106,9106,9106,5,5,2,91060,148
445,pp1507,20150528,9106,9106,9160,9200,9160,9200,9168,94,62,10,458400,148
446,pp1507,20150529,9200,9168,9200,9200,9001,9001,9054,-167,-114,28,1267610,152
447,pp1507,20150601,9001,9054,8964,8964,8962,8962,8963,-92,-91,18,806710,164
448,pp1507,20150602,8962,8963,0,0,0,8963,8963,0,0,0,0,164
449,pp1507,20150603,8963,8963,8889,8889,8808,8888,8872,-75,-91,10,443620,164
450,pp1507,20150604,8888,8872,8788,8788,8788,8788,8788,-84,-84,2,87880,162
451,pp1507,20150605,8788,8788,8900,8900,8900,8900,8900,112,112,4,178000,166
452,pp1507,20150608,8900,8900,8920,8920,8900,8900,8904,0,4,16,712390,164
453,pp1507,20150609,8900,8904,0,0,0,8900,8900,-4,-4,0,0,164
454,pp1507,20150610,8900,8900,0,0,0,8900,8900,0,0,0,0,164
455,pp1507,20150611,8900,8900,0,0,0,8900,8900,0,0,0,0,164
456,pp1507,20150612,8900,8900,0,0,0,8900,8900,0,0,0,0,164
457,pp1507,20150615,8900,8900,0,0,0,8900,8900,0,0,0,0,164
458,pp1507,20150616,8900,8900,0,0,0,8900,8900,0,0,0,0,164
459,pp1507,20150617,8900,8900,8943,8943,8547,8547,8789,-353,-111,12,527360,164
460,pp1507,20150618,8547,8789,8568,8568,8568,8568,8568,-221,-221,30,1285200,164
461,pp1507,20150619,8568,8568,0,0,0,8568,8568,0,0,0,0,164
462,pp1507,20150623,8568,8568,8880,8880,8880,8880,8880,312,312,2,88800,164
463,pp1507,20150624,8880,8880,0,0,0,8880,8880,0,0,0,0,164
464,pp1507,20150625,8880,8880,8680,8680,8680,8680,8680,-200,-200,2,86800,164
465,pp1507,20150626,8680,8680,8601,8601,8601,8601,8601,-79,-79,2,86010,162
466,pp1507,20150629,8601,8601,8601,8839,8601,8838,8743,237,142,10,437170,160
467,pp1507,20150630,8838,8743,8838,8838,8500,8830,8715,87,-28,76,3312040,126
468,pp1507,20150701,8830,8715,9225,9225,9225,9225,9225,510,510,4,184500,122
469,pp1507,20150702,9225,9225,0,0,0,9225,9225,0,0,0,0,122
470,pp1507,20150703,9225,9225,0,0,0,9225,9225,0,0,0,0,122
471,pp1507,20150706,9225,9225,0,0,0,9225,9225,0,0,0,0,122
472,pp1507,20150707,9225,9225,0,0,0,9225,9225,0,0,0,0,122
473,pp1507,20150708,9225,9225,0,0,0,9225,9225,0,0,0,0,122
474,pp1507,20150709,9225,9225,9225,9225,9225,9225,9225,0,0,2,92250,124
475,pp1507,20150710,9225,9225,0,0,0,8672,8672,-553,-553,0,0,124
476,pp1507,20150713,8672,8672,7979,7979,7979,7979,7979,-693,-693,2,79790,124
477,pp1507,20150714,7979,7979,0,0,0,8913,8913,934,934,0,0,0
478,pp1508,20150105,7420,7420,0,0,0,7061,7061,-359,-359,0,0,64
479,pp1508,20150106,7061,7061,7343,7343,7343,7343,7343,282,282,2,73430,64
480,pp1508,20150107,7343,7343,0,0,0,7338,7338,-5,-5,0,0,64
481,pp1508,20150108,7338,7338,0,0,0,7338,7338,0,0,0,0,64
482,pp1508,20150109,7338,7338,7120,7120,7120,7120,7120,-218,-218,40,1424000,104
483,pp1508,20150112,7120,7120,7117,7117,7117,7117,7117,-3,-3,40,1423400,144
484,pp1508,20150113,7117,7117,7068,7139,7045,7085,7083,-32,-34,10,354170,140
485,pp1508,20150114,7085,7083,7080,7098,7080,7098,7086,15,3,6,212580,140
486,pp1508,20150115,7098,7086,0,0,0,7175,7175,89,89,0,0,140
487,pp1508,20150116,7175,7175,7126,7126,7126,7126,7126,-49,-49,8,285040,140
488,pp1508,20150119,7126,7126,0,0,0,7251,7251,125,125,0,0,140
489,pp1508,20150120,7251,7251,0,0,0,7187,7187,-64,-64,0,0,140
490,pp1508,20150121,7187,7187,0,0,0,7215,7215,28,28,0,0,140
491,pp1508,20150122,7215,7215,0,0,0,7214,7214,-1,-1,0,0,140
492,pp1508,20150123,7214,7214,0,0,0,7204,7204,-10,-10,0,0,140
493,pp1508,20150126,7204,7204,0,0,0,7057,7057,-147,-147,0,0,140
494,pp1508,20150127,7057,7057,0,0,0,7113,7113,56,56,0,0,140
495,pp1508,20150128,7113,7113,0,0,0,7088,7088,-25,-25,0,0,140
496,pp1508,20150129,7088,7088,0,0,0,7135,7135,47,47,0,0,140
497,pp1508,20150130,7135,7135,7134,7181,7083,7172,7124,37,-11,16,569980,146
498,pp1508,20150202,7172,7124,7325,7384,7233,7297,7308,173,184,24,877070,146
499,pp1508,20150203,7297,7308,0,0,0,7449,7449,141,141,0,0,146
500,pp1508,20150204,7449,7449,0,0,0,7746,7746,297,297,0,0,146
501,pp1508,20150205,7746,7746,0,0,0,7591,7591,-155,-155,0,0,146
502,pp1508,20150206,7591,7591,0,0,0,7776,7776,185,185,0,0,146
503,pp1508,20150209,7776,7776,0,0,0,7765,7765,-11,-11,0,0,146
504,pp1508,20150210,7765,7765,0,0,0,7776,7776,11,11,0,0,146
505,pp1508,20150211,7776,7776,0,0,0,7838,7838,62,62,0,0,146
506,pp1508,20150212,7838,7838,0,0,0,7833,7833,-5,-5,0,0,146
507,pp1508,20150213,7833,7833,7867,7867,7867,7867,7867,34,34,2,78670,146
508,pp1508,20150216,7867,7867,8017,8117,8017,8117,8039,250,172,18,723580,160
509,pp1508,20150217,8117,8039,8157,8158,8157,8158,8157,119,118,14,571020,160
510,pp1508,20150225,8158,8157,0,0,0,8176,8176,19,19,0,0,160
511,pp1508,20150226,8176,8176,0,0,0,8176,8176,0,0,0,0,160
512,pp1508,20150227,8176,8176,8215,8215,8176,8176,8189,0,13,6,245670,162
513,pp1508,20150302,8176,8189,8349,8349,8349,8349,8349,160,160,2,83490,162
514,pp1508,20150303,8349,8349,8445,8498,8445,8491,8458,142,109,56,2368420,214
515,pp1508,20150304,8491,8458,8452,8452,8419,8419,8431,-39,-27,30,1264770,202
516,pp1508,20150305,8419,8431,0,0,0,8358,8358,-73,-73,0,0,202
517,pp1508,20150306,8358,8358,0,0,0,8277,8277,-81,-81,0,0,202
518,pp1508,20150309,8277,8277,8008,8008,8008,8008,8008,-269,-269,6,240240,202
519,pp1508,20150310,8008,8008,8018,8018,8018,8018,8018,10,10,10,400900,202
520,pp1508,20150311,8018,8018,0,0,0,8018,8018,0,0,0,0,202
521,pp1508,20150312,8018,8018,8055,8055,8055,8055,8055,37,37,2,80550,204
522,pp1508,20150313,8055,8055,0,0,0,8055,8055,0,0,0,0,204
523,pp1508,20150316,8055,8055,8204,8204,8204,8204,8204,149,149,2,82040,202
524,pp1508,20150317,8204,8204,8316,8316,8316,8316,8316,112,112,4,166320,202
525,pp1508,20150318,8316,8316,0,0,0,8210,8210,-106,-106,0,0,202
526,pp1508,20150319,8210,8210,0,0,0,8210,8210,0,0,0,0,202
527,pp1508,20150320,8210,8210,0,0,0,8210,8210,0,0,0,0,202
528,pp1508,20150323,8210,8210,0,0,0,8210,8210,0,0,0,0,202
529,pp1508,20150324,8210,8210,8300,8538,8300,8538,8426,328,216,24,1011120,198
530,pp1508,20150325,8538,8426,8552,8552,8552,8552,8552,126,126,4,171040,198
531,pp1508,20150326,8552,8552,0,0,0,8610,8610,58,58,0,0,198
532,pp1508,20150327,8610,8610,8614,8614,8408,8460,8494,-150,-116,6,254820,200
533,pp1508,20150330,8460,8494,0,0,0,8443,8443,-51,-51,0,0,200
534,pp1508,20150331,8443,8443,8577,8653,8551,8653,8600,210,157,16,688050,198
535,pp1508,20150401,8653,8600,0,0,0,8790,8790,190,190,0,0,198
536,pp1508,20150402,8790,8790,8756,8878,8756,8878,8837,88,47,6,265110,200
537,pp1508,20150403,8878,8837,8669,8669,8669,8669,8669,-168,-168,2,86690,198
538,pp1508,20150407,8669,8669,8692,8732,8475,8475,8697,-194,28,282,12263310,362
539,pp1508,20150408,8475,8697,8685,8685,8685,8685,8685,-12,-12,164,7121700,200
540,pp1508,20150409,8685,8685,0,0,0,8685,8685,0,0,0,0,200
541,pp1508,20150410,8685,8685,0,0,0,8685,8685,0,0,0,0,200
542,pp1508,20150413,8685,8685,0,0,0,8685,8685,0,0,0,0,200
543,pp1508,20150414,8685,8685,8750,8750,8740,8740,8745,55,60,4,174900,204
544,pp1508,20150415,8740,8745,0,0,0,8690,8690,-55,-55,0,0,204
545,pp1508,20150416,8690,8690,8840,8900,8838,8865,8893,175,203,72,3201830,146
546,pp1508,20150417,8865,8893,8977,9016,8882,8999,8942,106,49,14,625940,146
547,pp1508,20150420,8999,8942,9038,9038,8941,8991,8990,49,48,6,269700,146
548,pp1508,20150421,8991,8990,0,0,0,8990,8990,0,0,0,0,146
549,pp1508,20150422,8990,8990,8857,8858,8854,8858,8857,-132,-133,12,531420,144
550,pp1508,20150423,8858,8857,0,0,0,8857,8857,0,0,0,0,144
551,pp1508,20150424,8857,8857,0,0,0,8857,8857,0,0,0,0,144
552,pp1508,20150427,8857,8857,0,0,0,9072,9072,215,215,0,0,144
553,pp1508,20150428,9072,9072,9235,9378,9099,9262,9249,190,177,72,3329650,140
554,pp1508,20150429,9262,9249,9234,9234,9234,9234,9234,-15,-15,2,92340,140
555,pp1508,20150430,9234,9234,0,0,0,9234,9234,0,0,0,0,140
556,pp1508,20150504,9234,9234,9386,9386,9318,9318,9370,84,136,20,937040,140
557,pp1508,20150505,9318,9370,0,0,0,9370,9370,0,0,0,0,140
558,pp1508,20150506,9370,9370,9467,9467,9331,9331,9421,-39,51,6,282640,140
559,pp1508,20150507,9331,9421,9296,9296,9180,9180,9238,-241,-183,4,184760,140
560,pp1508,20150508,9180,9238,0,0,0,9146,9146,-92,-92,0,0,140
561,pp1508,20150511,9146,9146,9085,9085,9085,9085,9085,-61,-61,2,90850,140
562,pp1508,20150512,9085,9085,0,0,0,8983,8983,-102,-102,0,0,140
563,pp1508,20150513,8983,8983,0,0,0,8718,8718,-265,-265,0,0,140
564,pp1508,20150514,8718,8718,0,0,0,8819,8819,101,101,0,0,140
565,pp1508,20150515,8819,8819,0,0,0,9171,9171,352,352,0,0,140
566,pp1508,20150518,9171,9171,8881,8881,8852,8853,8855,-318,-316,22,974100,140
567,pp1508,20150519,8853,8855,0,0,0,8855,8855,0,0,0,0,140
568,pp1508,20150520,8855,8855,8782,8800,8564,8800,8736,-55,-119,8,349450,142
569,pp1508,20150521,8800,8736,0,0,0,8958,8958,222,222,0,0,142
570,pp1508,20150522,8958,8958,0,0,0,8855,8855,-103,-103,0,0,142
571,pp1508,20150525,8855,8855,8879,8879,8879,8879,8879,24,24,2,88790,140
572,pp1508,20150526,8879,8879,0,0,0,8758,8758,-121,-121,0,0,140
573,pp1508,20150527,8758,8758,0,0,0,8787,8787,29,29,0,0,140
574,pp1508,20150528,8787,8787,0,0,0,8787,8787,0,0,0,0,140
575,pp1508,20150529,8787,8787,0,0,0,8787,8787,0,0,0,0,140
576,pp1508,20150601,8787,8787,0,0,0,8699,8699,-88,-88,0,0,140
577,pp1508,20150602,8699,8699,0,0,0,8700,8700,1,1,0,0,140
578,pp1508,20150603,8700,8700,8901,8901,8901,8901,8901,201,201,2,89010,140
579,pp1508,20150604,8901,8901,0,0,0,8901,8901,0,0,0,0,140
580,pp1508,20150605,8901,8901,0,0,0,9014,9014,113,113,0,0,140
581,pp1508,20150608,9014,9014,8884,8884,8873,8873,8878,-141,-136,6,266350,142
582,pp1508,20150609,8873,8878,8851,8851,8851,8851,8851,-27,-27,2,88510,140
583,pp1508,20150610,8851,8851,0,0,0,8851,8851,0,0,0,0,140
584,pp1508,20150611,8851,8851,9099,9099,9087,9087,9093,236,242,4,181860,140
585,pp1508,20150612,9087,9093,8981,8981,8981,8981,8981,-112,-112,2,89810,138
586,pp1508,20150615,8981,8981,0,0,0,8981,8981,0,0,0,0,138
587,pp1508,20150616,8981,8981,9025,9149,9025,9149,9087,168,106,4,181740,138
588,pp1508,20150617,9149,9087,9449,9449,8998,8998,9223,-89,136,4,184470,138
589,pp1508,20150618,8998,9223,8884,8884,8858,8858,8868,-365,-355,10,443430,142
590,pp1508,20150619,8858,8868,8949,8949,8949,8949,8949,81,81,2,89490,142
591,pp1508,20150623,8949,8949,8838,8838,8763,8763,8786,-186,-163,16,702910,146
592,pp1508,20150624,8763,8786,8771,8771,8764,8764,8769,-22,-17,8,350760,146
593,pp1508,20150625,8764,8769,0,0,0,8572,8572,-197,-197,0,0,146
594,pp1508,20150626,8572,8572,8900,8900,8872,8872,8881,300,309,10,444080,140
595,pp1508,20150629,8872,8881,0,0,0,9027,9027,146,146,0,0,140
596,pp1508,20150630,9027,9027,8755,8955,8754,8955,8854,-72,-173,8,354190,138
597,pp1508,20150701,8955,8854,8881,8881,8800,8800,8840,-54,-14,4,176810,138
598,pp1508,20150702,8800,8840,0,0,0,8840,8840,0,0,0,0,138
599,pp1508,20150703,8840,8840,0,0,0,8840,8840,0,0,0,0,138
600,pp1508,20150706,8840,8840,8600,8600,8600,8600,8600,-240,-240,2,86000,136
601,pp1508,20150707,8600,8600,0,0,0,8600,8600,0,0,0,0,136
602,pp1508,20150708,8600,8600,8400,8400,8256,8256,8364,-344,-236,8,334560,134
603,pp1508,20150709,8256,8364,8512,8512,8101,8512,8462,148,98,54,2284790,92
604,pp1508,20150710,8512,8462,8791,8791,8403,8403,8597,-59,135,4,171940,92
605,pp1508,20150713,8403,8597,0,0,0,8254,8254,-343,-343,0,0,92
606,pp1508,20150714,8254,8254,0,0,0,8254,8254,0,0,0,0,92
607,pp1508,20150715,8254,8254,8250,8255,8250,8255,8252,1,-2,4,165050,90
608,pp1508,20150716,8255,8252,0,0,0,8252,8252,0,0,0,0,90
609,pp1508,20150717,8252,8252,8196,8196,8196,8196,8196,-56,-56,6,245880,94
610,pp1508,20150720,8196,8196,8320,8320,7952,8250,8134,54,-62,8,325380,92
611,pp1508,20150721,8250,8134,0,0,0,8134,8134,0,0,0,0,92
612,pp1508,20150722,8134,8134,0,0,0,8134,8134,0,0,0,0,92
613,pp1508,20150723,8134,8134,0,0,0,8134,8134,0,0,0,0,92
614,pp1508,20150724,8134,8134,7952,7952,7952,7952,7952,-182,-182,2,79520,90
615,pp1508,20150727,7952,7952,7636,7636,7636,7636,7636,-316,-316,2,76360,88
616,pp1508,20150728,7636,7636,7693,7693,7693,7693,7693,57,57,2,76930,86
617,pp1508,20150729,7693,7693,0,0,0,7693,7693,0,0,0,0,86
618,pp1508,20150730,7693,7693,7850,8000,7850,8000,7859,307,166,32,1257500,84
619,pp1508,20150731,8000,7859,7859,8173,7800,7920,7999,61,140,40,1599970,66
620,pp1508,20150803,7920,7999,0,0,0,7999,7999,0,0,0,0,66
621,pp1508,20150804,7999,7999,0,0,0,7999,7999,0,0,0,0,66
622,pp1508,20150805,7999,7999,0,0,0,7999,7999,0,0,0,0,66
623,pp1508,20150806,7999,7999,0,0,0,7999,7999,0,0,0,0,66
624,pp1508,20150807,7999,7999,0,0,0,7999,7999,0,0,0,0,66
625,pp1508,20150810,7999,7999,0,0,0,7999,7999,0,0,0,0,66
626,pp1508,20150811,7999,7999,0,0,0,7999,7999,0,0,0,0,66
627,pp1508,20150812,7999,7999,0,0,0,7999,7999,0,0,0,0,66
628,pp1508,20150813,7999,7999,0,0,0,7999,7999,0,0,0,0,66
629,pp1508,20150814,7999,7999,0,0,0,7999,7999,0,0,0,0,0
630,pp1509,20150105,7598,7567,7542,7542,7213,7245,7343,-322,-224,70416,2585455680,89078
631,pp1509,20150106,7245,7343,7151,7253,7079,7199,7164,-144,-179,99942,3580359450,107490
632,pp1509,20150107,7199,7164,7158,7210,7086,7129,7143,-35,-21,73978,2642141750,119250
633,pp1509,20150108,7129,7143,7161,7210,7132,7133,7178,-10,35,60568,2173829420,121068
634,pp1509,20150109,7133,7178,7160,7162,6895,6926,6980,-252,-198,145418,5075350680,145530
635,pp1509,20150112,6926,6980,6911,6996,6880,6987,6945,7,-35,84960,2950538130,149244
636,pp1509,20150113,6987,6945,6949,6998,6907,6925,6937,-20,-8,71694,2486755600,148492
637,pp1509,20150114,6925,6937,6961,7017,6871,6888,6912,-49,-25,105918,3660769790,167206
638,pp1509,20150115,6888,6912,6975,7026,6933,6996,6978,84,66,110348,3850116150,173134
639,pp1509,20150116,6996,6978,6943,6969,6890,6957,6933,-21,-45,83650,2899783310,178934
640,pp1509,20150119,6957,6933,7050,7166,7020,7148,7088,215,155,102376,3628621080,173274
641,pp1509,20150120,7148,7088,7102,7129,7008,7030,7067,-58,-21,74768,2642060640,184530
642,pp1509,20150121,7030,7067,7000,7250,6990,7112,7099,45,32,84426,2996783560,189762
643,pp1509,20150122,7112,7099,7199,7199,7054,7109,7118,10,19,83864,2985044790,202642
644,pp1509,20150123,7109,7118,7105,7119,7064,7108,7097,-10,-21,47068,1670354390,199910
645,pp1509,20150126,7108,7097,7030,7074,6926,6960,6965,-137,-132,87946,3062788320,219522
646,pp1509,20150127,6960,6965,6981,7004,6956,6990,6980,25,15,42814,1494340330,221892
647,pp1509,20150128,6990,6980,7005,7075,6961,7075,7017,95,37,53560,1879382910,219276
648,pp1509,20150129,7075,7017,7042,7080,7018,7052,7046,35,29,46072,1623259860,215248
649,pp1509,20150130,7052,7046,7070,7070,6977,6994,7004,-52,-42,43034,1507064200,219670
650,pp1509,20150202,6994,7004,7136,7167,7092,7128,7128,124,124,64476,2298036780,212592
651,pp1509,20150203,7128,7128,7194,7377,7194,7373,7279,245,151,111726,4066537790,198198
652,pp1509,20150204,7373,7279,7420,7570,7420,7491,7520,212,241,136284,5124495290,188844
653,pp1509,20150205,7491,7520,7378,7406,7338,7400,7372,-120,-148,70130,2585315400,178840
654,pp1509,20150206,7400,7372,7542,7666,7481,7666,7588,294,216,155012,5881596920,187922
655,pp1509,20150209,7666,7588,7650,7663,7562,7611,7621,23,33,115918,4417362870,193518
656,pp1509,20150210,7611,7621,7603,7630,7580,7626,7604,5,-17,61604,2342387610,193286
657,pp1509,20150211,7626,7604,7580,7670,7564,7648,7619,44,15,62352,2375309930,187422
658,pp1509,20150212,7648,7619,7646,7655,7572,7648,7617,29,-2,73072,2783010040,180736
659,pp1509,20150213,7648,7617,7700,7921,7682,7918,7835,301,218,138708,5434474790,176704
660,pp1509,20150216,7918,7835,7990,7990,7823,7936,7889,101,54,101170,3990854180,180566
661,pp1509,20150217,7936,7889,7930,7961,7814,7918,7873,29,-16,86442,3403026930,184952
662,pp1509,20150225,7918,7873,7858,7936,7775,7895,7848,22,-25,87564,3436239970,175926
663,pp1509,20150226,7895,7848,7950,8103,7943,8100,8008,252,160,121332,4858277640,168220
664,pp1509,20150227,8100,8008,8040,8074,7960,8029,8023,21,15,140812,5648776230,178016
665,pp1509,20150302,8029,8023,8042,8313,8042,8205,8174,182,151,147528,6029630620,188558
666,pp1509,20150303,8205,8174,8230,8258,8068,8070,8118,-104,-56,134994,5479927510,200008
667,pp1509,20150304,8070,8118,8070,8115,8001,8086,8062,-32,-56,130238,5250213500,201196
668,pp1509,20150305,8086,8062,8035,8065,7888,7950,7994,-112,-68,163978,6554530640,201910
669,pp1509,20150306,7950,7994,7944,7944,7862,7868,7895,-126,-99,89976,3551992630,201016
670,pp1509,20150309,7868,7895,7805,7838,7676,7810,7751,-85,-144,150250,5823350440,210814
671,pp1509,20150310,7810,7751,7800,7878,7730,7735,7792,-16,41,127208,4956178460,217806
672,pp1509,20150311,7735,7792,7700,7769,7667,7692,7720,-100,-72,151496,5848300670,211566
673,pp1509,20150312,7692,7720,7700,8028,7696,7984,7866,264,146,260552,10248392940,211542
674,pp1509,20150313,7984,7866,7928,8049,7914,8023,7997,157,131,262906,10513044760,249450
675,pp1509,20150316,8023,7997,7900,8035,7809,8006,7946,9,-51,334518,13291147860,258872
676,pp1509,20150317,8006,7946,8020,8075,7918,7989,7987,43,41,341938,13656581200,276818
677,pp1509,20150318,7989,7987,7940,7980,7756,7757,7852,-230,-135,412706,16203213800,303854
678,pp1509,20150319,7757,7852,7878,7946,7802,7849,7882,-3,30,382784,15087203410,303718
679,pp1509,20150320,7849,7882,7898,7960,7828,7872,7879,-10,-3,335316,13210629900,295150
680,pp1509,20150323,7872,7879,8000,8190,7965,8171,8122,292,243,537264,21820892320,311196
681,pp1509,20150324,8171,8122,8290,8355,8136,8233,8240,111,118,667844,27515764930,336008
682,pp1509,20150325,8233,8240,8201,8250,8161,8176,8203,-64,-37,616610,25291450290,364448
683,pp1509,20150326,8176,8203,8300,8325,8154,8260,8243,57,40,850792,35066037230,393994
684,pp1509,20150327,8260,8243,8202,8274,8151,8255,8219,12,-24,706858,29050543220,383118
685,pp1509,20150330,8255,8219,8182,8263,8126,8219,8182,0,-37,602048,24631020240,398592
686,pp1509,20150331,8219,8182,8240,8298,8202,8233,8248,51,66,571614,23574512960,403422
687,pp1509,20150401,8233,8248,8180,8398,8160,8377,8300,129,52,878208,36447298330,419150
688,pp1509,20150402,8377,8300,8500,8516,8421,8466,8460,166,160,761786,32224639590,443512
689,pp1509,20150403,8466,8460,8450,8456,8122,8158,8275,-302,-185,1258298,52065197900,456070
690,pp1509,20150407,8158,8275,8300,8308,8186,8228,8240,-47,-35,598384,24654663070,449724
691,pp1509,20150408,8228,8240,8254,8488,8232,8394,8354,154,114,1162138,48544806090,395174
692,pp1509,20150409,8394,8354,8302,8345,8220,8305,8289,-49,-65,745280,30889059420,394348
693,pp1509,20150410,8305,8289,8289,8383,8260,8335,8320,46,31,748738,31149892790,405286
694,pp1509,20150413,8335,8320,8380,8510,8351,8381,8408,61,88,829210,34861363830,425438
695,pp1509,20150414,8381,8408,8398,8428,8286,8351,8355,-57,-53,879148,36727494760,430134
696,pp1509,20150415,8351,8355,8400,8400,8280,8334,8337,-21,-18,616584,25702907060,413624
697,pp1509,20150416,8334,8337,8414,8669,8409,8591,8580,254,243,1038202,44542163220,440044
698,pp1509,20150417,8591,8580,8591,8780,8560,8669,8664,89,84,863376,37402657110,461216
699,pp1509,20150420,8669,8664,8728,8807,8675,8689,8741,25,77,686934,30024405030,469068
700,pp1509,20150421,8689,8741,8703,8735,8621,8663,8673,-78,-68,720582,31248485850,493562
701,pp1509,20150422,8663,8673,8628,8630,8513,8586,8566,-87,-107,718660,30782207420,474268
702,pp1509,20150423,8586,8566,8620,8712,8596,8650,8655,84,89,685344,29661539220,473706
703,pp1509,20150424,8650,8655,8745,8771,8639,8681,8705,26,50,653556,28446910360,493140
704,pp1509,20150427,8681,8705,8705,8950,8663,8886,8844,181,139,854574,37791625690,504426
705,pp1509,20150428,8886,8844,8886,8947,8853,8892,8896,48,52,647844,28818494520,485802
706,pp1509,20150429,8892,8896,8902,8968,8766,8824,8883,-72,-13,938358,41681296460,467124
707,pp1509,20150430,8824,8883,8926,8954,8887,8933,8923,50,40,580340,25892212580,477372
708,pp1509,20150504,8933,8923,8943,9027,8864,8910,8948,-13,25,666462,29818805560,485920
709,pp1509,20150505,8910,8948,8920,8920,8833,8885,8870,-63,-78,541926,24036760330,470744
710,pp1509,20150506,8885,8870,9000,9020,8856,8890,8938,20,68,794516,35508023750,513422
711,pp1509,20150507,8890,8938,8800,8810,8703,8709,8755,-229,-183,625970,27404395070,517406
712,pp1509,20150508,8709,8755,8662,8662,8560,8624,8605,-131,-150,599934,25814806330,483812
713,pp1509,20150511,8624,8605,8698,8698,8540,8559,8589,-46,-16,513852,22069152560,508940
714,pp1509,20150512,8559,8589,8538,8554,8418,8436,8469,-153,-120,668836,28323276290,551666
715,pp1509,20150513,8436,8469,8484,8535,8435,8450,8483,-19,14,518676,22000288300,563066
716,pp1509,20150514,8450,8483,8376,8474,8350,8467,8413,-16,-70,544820,22919842660,567016
717,pp1509,20150515,8467,8413,8430,8529,8430,8504,8479,91,66,575734,24409008320,587750
718,pp1509,20150518,8504,8479,8490,8493,8354,8378,8405,-101,-74,502952,21137153720,579122
719,pp1509,20150519,8378,8405,8370,8370,8265,8266,8328,-139,-77,499700,20807771600,547874
720,pp1509,20150520,8266,8328,8150,8328,8097,8275,8218,-53,-110,842262,34611352720,460178
721,pp1509,20150521,8275,8218,8298,8463,8253,8429,8370,211,152,727784,30458746400,473328
722,pp1509,20150522,8429,8370,8482,8489,8365,8430,8422,60,52,518006,21814546000,485538
723,pp1509,20150525,8430,8422,8375,8426,8345,8403,8392,-19,-30,406648,17064219180,481768
724,pp1509,20150526,8403,8392,8485,8566,8324,8325,8456,-67,64,865060,36578520230,483532
725,pp1509,20150527,8325,8456,8295,8367,8285,8343,8326,-113,-130,496430,20667779930,458034
726,pp1509,20150528,8343,8326,8367,8370,8231,8294,8292,-32,-34,451278,18711196520,459288
727,pp1509,20150529,8294,8292,8320,8357,8297,8316,8327,24,35,325204,13540930970,459820
728,pp1509,20150601,8316,8327,8436,8462,8304,8319,8356,-8,29,353788,14781837120,465980
729,pp1509,20150602,8319,8356,8320,8366,8263,8365,8305,9,-51,415198,17241640690,474100
730,pp1509,20150603,8365,8305,8400,8440,8334,8407,8394,102,89,509894,21401926340,469476
731,pp1509,20150604,8407,8394,8368,8496,8336,8460,8403,66,9,505674,21248353860,454424
732,pp1509,20150605,8460,8403,8423,8497,8401,8487,8459,84,56,485372,20530674320,445684
733,pp1509,20150608,8487,8459,8500,8512,8386,8402,8431,-57,-28,322326,13587988400,442928
734,pp1509,20150609,8402,8431,8385,8423,8370,8399,8400,-32,-31,221000,9282016550,440626
735,pp1509,20150610,8399,8400,8450,8590,8435,8586,8495,186,95,505588,21476520960,438984
736,pp1509,20150611,8586,8495,8550,8696,8535,8680,8633,185,138,688530,29720794630,485738
737,pp1509,20150612,8680,8633,8612,8656,8561,8577,8611,-56,-22,541052,23296983700,474026
738,pp1509,20150615,8577,8611,8576,8639,8512,8634,8562,23,-49,361376,15472036760,478020
739,pp1509,20150616,8634,8562,8649,8799,8555,8591,8676,29,114,706318,30640633250,490096
740,pp1509,20150617,8591,8676,8571,8628,8453,8454,8532,-222,-144,473064,20181711180,443334
741,pp1509,20150618,8454,8532,8440,8515,8385,8464,8471,-68,-61,343896,14567298200,415060
742,pp1509,20150619,8464,8471,8493,8573,8483,8536,8535,65,64,448344,19134501670,406728
743,pp1509,20150623,8536,8535,8510,8587,8453,8550,8518,15,-17,379618,16169011770,384984
744,pp1509,20150624,8550,8518,8615,8644,8535,8631,8592,113,74,407676,17514561390,404570
745,pp1509,20150625,8631,8592,8599,8626,8577,8615,8600,23,8,287230,12352300600,406608
746,pp1509,20150626,8615,8600,8610,8736,8604,8708,8668,108,68,495398,21470823910,421836
747,pp1509,20150629,8708,8668,8699,8763,8487,8621,8599,-47,-69,465912,20033741480,401760
748,pp1509,20150630,8621,8599,8588,8654,8537,8619,8592,20,-7,379768,16315241230,406014
749,pp1509,20150701,8619,8592,8628,8698,8595,8613,8648,21,56,329198,14234772980,397704
750,pp1509,20150702,8613,8648,8553,8656,8540,8644,8606,-4,-42,294620,12678569820,390502
751,pp1509,20150703,8644,8606,8643,8643,8565,8596,8600,-10,-6,364080,15657223560,381318
752,pp1509,20150706,8596,8600,8569,8570,8300,8362,8439,-238,-161,579164,24437976150,352042
753,pp1509,20150707,8362,8439,8270,8384,8120,8169,8262,-270,-177,600490,24808324320,330664
754,pp1509,20150708,8169,8262,7933,8038,7932,7932,7951,-330,-311,162446,6458541120,290576
755,pp1509,20150709,7932,7951,8061,8415,8050,8355,8260,404,309,511154,21110772300,250206
756,pp1509,20150710,8355,8260,8379,8490,8283,8339,8373,79,113,492566,20622128930,271972
757,pp1509,20150713,8339,8373,8300,8334,8158,8241,8252,-132,-121,323980,13367459190,267064
758,pp1509,20150714,8241,8252,8280,8350,8195,8195,8278,-57,26,353062,14613834260,274778
759,pp1509,20150715,8195,8278,8300,8323,8195,8226,8240,-52,-38,303452,12503478650,276598
760,pp1509,20150716,8226,8240,8171,8187,8055,8124,8111,-116,-129,336856,13661231380,278894
761,pp1509,20150717,8124,8111,8098,8154,8064,8130,8110,19,-1,240864,9767795800,281666
762,pp1509,20150720,8130,8110,8101,8185,8092,8175,8129,65,19,274620,11162764990,267576
763,pp1509,20150721,8175,8129,8150,8163,8061,8142,8113,13,-16,273990,11114953610,264384
764,pp1509,20150722,8142,8113,8125,8255,8121,8240,8187,127,74,330756,13539585880,249126
765,pp1509,20150723,8240,8187,8200,8244,8179,8211,8212,24,25,244362,10033764020,234584
766,pp1509,20150724,8211,8212,8185,8185,8005,8007,8080,-205,-132,359462,14524010570,222764
767,pp1509,20150727,8007,8080,8011,8018,7757,7790,7825,-290,-255,471434,18446562130,213668
768,pp1509,20150728,7790,7825,7720,7950,7664,7898,7827,73,2,415238,16251456610,194912
769,pp1509,20150729,7898,7827,7958,8055,7924,7957,7987,130,160,260192,10390918750,186884
770,pp1509,20150730,7957,7987,8006,8043,7908,7915,7992,-72,5,205798,8224601200,184090
771,pp1509,20150731,7915,7992,7888,7950,7851,7885,7895,-107,-97,194680,7685455300,187314
772,pp1509,20150803,7885,7895,7815,7843,7615,7730,7720,-165,-175,285424,11018108450,175960
773,pp1509,20150804,7730,7720,7695,7846,7625,7841,7728,121,8,293836,11354478310,165966
774,pp1509,20150805,7841,7728,7856,7982,7796,7978,7896,250,168,309574,12222349690,168626
775,pp1509,20150806,7978,7896,7915,8085,7886,8022,7987,126,91,370158,14782851230,155360
776,pp1509,20150807,8022,7987,8000,8162,7973,8138,8043,151,56,328430,13207910250,138050
777,pp1509,20150810,8138,8043,8099,8180,8060,8177,8117,134,74,145404,5901549330,126758
778,pp1509,20150811,8177,8117,8230,8432,8230,8368,8372,251,255,176876,7404120550,101722
779,pp1509,20150812,8368,8372,8300,8417,8273,8382,8344,10,-28,91720,3826730970,86444
780,pp1509,20150813,8382,8344,8500,8500,8288,8426,8372,82,28,70796,2963565740,70872
781,pp1509,20150814,8426,8372,8376,8465,8372,8399,8408,27,36,62038,2608322900,63050
782,pp1509,20150817,8399,8408,8338,8395,8277,8307,8340,-101,-68,49346,2057772450,54818
783,pp1509,20150818,8307,8340,8279,8319,8189,8220,8239,-120,-101,53946,2222368850,45896
784,pp1509,20150819,8220,8239,8260,8308,8229,8293,8278,54,39,37486,1551631220,42716
785,pp1509,20150820,8293,8278,8238,8274,8161,8251,8230,-27,-48,39106,1609216790,39388
786,pp1509,20150821,8251,8230,8263,8300,8215,8228,8253,-2,23,27796,1147128590,35686
787,pp1509,20150824,8228,8253,8228,8228,7936,7960,8046,-293,-207,33578,1350997130,30108
788,pp1509,20150825,7960,8046,7911,8049,7822,7958,7990,-88,-56,16336,652645650,25410
789,pp1509,20150826,7958,7990,8016,8046,7922,7924,7963,-66,-27,5592,222671820,23442
790,pp1509,20150827,7924,7963,7924,8016,7770,7850,7859,-113,-104,8666,340549700,19480
791,pp1509,20150828,7850,7859,8000,8090,7890,7966,7977,107,118,7130,284390220,15970
792,pp1509,20150831,7966,7977,8000,8020,7805,7841,7849,-136,-128,7066,277316610,10226
793,pp1509,20150901,7841,7849,7976,8064,7850,8010,7925,161,76,5104,202251420,5190
794,pp1509,20150902,8010,7925,7961,8006,7950,7980,7977,55,52,560,22336870,4792
795,pp1509,20150907,7980,7977,7900,8028,7900,7940,7984,-37,7,598,23874490,4280
796,pp1509,20150908,7940,7984,7900,7900,7900,7900,7900,-84,-84,80,3160000,4200
797,pp1509,20150909,7900,7900,7800,7800,7800,7800,7800,-100,-100,80,3120000,4120
798,pp1509,20150910,7800,7800,7700,7750,7660,7750,7699,-50,-101,360,13858570,3814
799,pp1509,20150911,7750,7699,7750,7750,7700,7700,7725,1,26,120,4635000,3804
800,pp1509,20150914,7700,7725,7650,7670,7550,7550,7617,-175,-108,424,16149000,3666
801,pp1509,20150915,7550,7617,7560,7560,7400,7400,7448,-217,-169,206,7672300,3644
802,pp1509,20150916,7400,7448,7410,7680,7410,7680,7886,232,438,316,12409090,0
803,pp1510,20150105,7549,7549,0,0,0,7291,7291,-258,-258,0,0,4
804,pp1510,20150106,7291,7291,7182,7280,7182,7280,7197,-11,-94,28,1007660,6
805,pp1510,20150107,7280,7197,7168,7168,7070,7070,7119,-127,-78,4,142380,6
806,pp1510,20150108,7070,7119,0,0,0,7119,7119,0,0,0,0,6
807,pp1510,20150109,7119,7119,7031,7031,6916,6916,6954,-203,-165,6,208630,6
808,pp1510,20150112,6916,6954,6823,6971,6823,6971,6897,17,-57,4,137940,8
809,pp1510,20150113,6971,6897,6985,6985,6985,6985,6985,88,88,2,69850,6
810,pp1510,20150114,6985,6985,0,0,0,6935,6935,-50,-50,0,0,6
811,pp1510,20150115,6935,6935,6892,6892,6892,6892,6892,-43,-43,2,68920,4
812,pp1510,20150116,6892,6892,0,0,0,6892,6892,0,0,0,0,4
813,pp1510,20150119,6892,6892,0,0,0,7046,7046,154,154,0,0,4
814,pp1510,20150120,7046,7046,0,0,0,7046,7046,0,0,0,0,4
815,pp1510,20150121,7046,7046,0,0,0,7046,7046,0,0,0,0,4
816,pp1510,20150122,7046,7046,0,0,0,7046,7046,0,0,0,0,4
817,pp1510,20150123,7046,7046,7122,7122,7122,7122,7122,76,76,2,71220,6
818,pp1510,20150126,7122,7122,0,0,0,7020,7020,-102,-102,0,0,6
819,pp1510,20150127,7020,7020,6918,6918,6918,6918,6918,-102,-102,2,69180,4
820,pp1510,20150128,6918,6918,0,0,0,6918,6918,0,0,0,0,4
821,pp1510,20150129,6918,6918,0,0,0,6918,6918,0,0,0,0,4
822,pp1510,20150130,6918,6918,0,0,0,6918,6918,0,0,0,0,4
823,pp1510,20150202,6918,6918,0,0,0,6979,6979,61,61,0,0,4
824,pp1510,20150203,6979,6979,0,0,0,7258,7258,279,279,0,0,4
825,pp1510,20150204,7258,7258,0,0,0,7327,7327,69,69,0,0,4
826,pp1510,20150205,7327,7327,0,0,0,7327,7327,0,0,0,0,4
827,pp1510,20150206,7327,7327,0,0,0,7541,7541,214,214,0,0,4
828,pp1510,20150209,7541,7541,7497,7497,7497,7497,7497,-44,-44,2,74970,6
829,pp1510,20150210,7497,7497,0,0,0,7497,7497,0,0,0,0,6
830,pp1510,20150211,7497,7497,0,0,0,7537,7537,40,40,0,0,6
831,pp1510,20150212,7537,7537,7650,7650,7650,7650,7650,113,113,2,76500,4
832,pp1510,20150213,7650,7650,0,0,0,7868,7868,218,218,0,0,4
833,pp1510,20150216,7868,7868,7810,7810,7810,7810,7810,-58,-58,2,78100,2
834,pp1510,20150217,7810,7810,0,0,0,7810,7810,0,0,0,0,2
835,pp1510,20150225,7810,7810,7929,7929,7881,7881,7905,71,95,4,158100,4
836,pp1510,20150226,7881,7905,0,0,0,7919,7919,14,14,0,0,4
837,pp1510,20150227,7919,7919,0,0,0,7919,7919,0,0,0,0,4
838,pp1510,20150302,7919,7919,0,0,0,8098,8098,179,179,0,0,4
839,pp1510,20150303,8098,8098,8141,8208,8141,8194,8164,96,66,68,2776070,62
840,pp1510,20150304,8194,8164,0,0,0,8108,8108,-56,-56,0,0,62
841,pp1510,20150305,8108,8108,8036,8036,8036,8036,8036,-72,-72,6,241080,62
842,pp1510,20150306,8036,8036,0,0,0,7937,7937,-99,-99,0,0,62
843,pp1510,20150309,7937,7937,7716,7809,7716,7809,7762,-128,-175,8,310500,62
844,pp1510,20150310,7809,7762,0,0,0,7762,7762,0,0,0,0,62
845,pp1510,20150311,7762,7762,0,0,0,7758,7758,-4,-4,0,0,62
846,pp1510,20150312,7758,7758,0,0,0,7994,7994,236,236,0,0,62
847,pp1510,20150313,7994,7994,0,0,0,8037,8037,43,43,0,0,62
848,pp1510,20150316,8037,8037,0,0,0,8037,8037,0,0,0,0,62
849,pp1510,20150317,8037,8037,8124,8125,8078,8078,8101,41,64,8,324050,64
850,pp1510,20150318,8078,8101,7806,7868,7806,7864,7836,-237,-265,8,313440,64
851,pp1510,20150319,7864,7836,7947,7998,7947,7998,7972,162,136,4,159450,64
852,pp1510,20150320,7998,7972,0,0,0,7942,7942,-30,-30,0,0,64
853,pp1510,20150323,7942,7942,7942,7942,7942,7942,7942,0,0,2,79420,64
854,pp1510,20150324,7942,7942,8254,8254,8254,8254,8254,312,312,2,82540,62
855,pp1510,20150325,8254,8254,0,0,0,8196,8196,-58,-58,0,0,62
856,pp1510,20150326,8196,8196,8286,8353,8260,8338,8309,142,113,8,332370,64
857,pp1510,20150327,8338,8309,8264,8264,8200,8200,8232,-109,-77,4,164640,64
858,pp1510,20150330,8200,8232,0,0,0,8232,8232,0,0,0,0,64
859,pp1510,20150331,8232,8232,0,0,0,8232,8232,0,0,0,0,64
860,pp1510,20150401,8232,8232,8259,8259,8259,8259,8259,27,27,2,82590,66
861,pp1510,20150402,8259,8259,0,0,0,8452,8452,193,193,0,0,66
862,pp1510,20150403,8452,8452,8456,8456,8370,8370,8393,-82,-59,8,335730,66
863,pp1510,20150407,8370,8393,0,0,0,8358,8358,-35,-35,0,0,66
864,pp1510,20150408,8358,8358,0,0,0,8473,8473,115,115,0,0,66
865,pp1510,20150409,8473,8473,8359,8359,8290,8290,8324,-183,-149,4,166490,66
866,pp1510,20150410,8290,8324,8400,8400,8323,8323,8361,-1,37,4,167230,66
867,pp1510,20150413,8323,8361,8387,8387,8387,8387,8387,26,26,2,83870,66
868,pp1510,20150414,8387,8387,0,0,0,8335,8335,-52,-52,0,0,66
869,pp1510,20150415,8335,8335,0,0,0,8318,8318,-17,-17,0,0,66
870,pp1510,20150416,8318,8318,0,0,0,8318,8318,0,0,0,0,66
871,pp1510,20150417,8318,8318,0,0,0,8399,8399,81,81,0,0,66
872,pp1510,20150420,8399,8399,0,0,0,8473,8473,74,74,0,0,66
873,pp1510,20150421,8473,8473,0,0,0,8408,8408,-65,-65,0,0,66
874,pp1510,20150422,8408,8408,0,0,0,8408,8408,0,0,0,0,66
875,pp1510,20150423,8408,8408,8640,8650,8640,8650,8641,242,233,24,1037000,66
876,pp1510,20150424,8650,8641,8772,8773,8650,8650,8670,9,29,140,6069200,74
877,pp1510,20150427,8650,8670,8778,8850,8778,8850,8814,180,144,16,705120,62
878,pp1510,20150428,8850,8814,8873,8914,8873,8914,8893,100,79,4,177870,62
879,pp1510,20150429,8914,8893,8831,8917,8831,8832,8862,-61,-31,18,797620,62
880,pp1510,20150430,8832,8862,8909,8909,8904,8909,8908,47,46,26,1158070,62
881,pp1510,20150504,8909,8908,0,0,0,8908,8908,0,0,0,0,62
882,pp1510,20150505,8908,8908,0,0,0,8907,8907,-1,-1,0,0,62
883,pp1510,20150506,8907,8907,0,0,0,8975,8975,68,68,0,0,62
884,pp1510,20150507,8975,8975,0,0,0,8792,8792,-183,-183,0,0,62
885,pp1510,20150508,8792,8792,8648,8648,8621,8621,8633,-171,-159,42,1813110,62
886,pp1510,20150511,8621,8633,0,0,0,8633,8633,0,0,0,0,62
887,pp1510,20150512,8633,8633,0,0,0,8633,8633,0,0,0,0,62
888,pp1510,20150513,8633,8633,0,0,0,8633,8633,0,0,0,0,62
889,pp1510,20150514,8633,8633,0,0,0,8562,8562,-71,-71,0,0,62
890,pp1510,20150515,8562,8562,0,0,0,8629,8629,67,67,0,0,62
891,pp1510,20150518,8629,8629,0,0,0,8554,8554,-75,-75,0,0,62
892,pp1510,20150519,8554,8554,8554,8554,8326,8326,8440,-228,-114,4,168800,62
893,pp1510,20150520,8326,8440,8325,8325,8325,8325,8325,-115,-115,32,1332000,94
894,pp1510,20150521,8325,8325,8315,8372,8306,8360,8353,35,28,36,1503700,66
895,pp1510,20150522,8360,8353,8323,8404,8323,8404,8363,51,10,40,1672700,64
896,pp1510,20150525,8404,8363,0,0,0,8334,8334,-29,-29,0,0,64
897,pp1510,20150526,8334,8334,8450,8542,8405,8405,8473,71,139,10,423690,62
898,pp1510,20150527,8405,8473,0,0,0,8343,8343,-130,-130,0,0,62
899,pp1510,20150528,8343,8343,0,0,0,8343,8343,0,0,0,0,62
900,pp1510,20150529,8343,8343,0,0,0,8343,8343,0,0,0,0,62
901,pp1510,20150601,8343,8343,0,0,0,8372,8372,29,29,0,0,62
902,pp1510,20150602,8372,8372,0,0,0,8372,8372,0,0,0,0,62
903,pp1510,20150603,8372,8372,0,0,0,8461,8461,89,89,0,0,62
904,pp1510,20150604,8461,8461,8503,8503,8418,8418,8460,-43,-1,4,169210,64
905,pp1510,20150605,8418,8460,8470,8470,8470,8470,8470,10,10,2,84700,62
906,pp1510,20150608,8470,8470,0,0,0,8442,8442,-28,-28,0,0,62
907,pp1510,20150609,8442,8442,8393,8393,8389,8389,8391,-53,-51,4,167820,66
908,pp1510,20150610,8389,8391,0,0,0,8485,8485,94,94,0,0,66
909,pp1510,20150611,8485,8485,0,0,0,8622,8622,137,137,0,0,66
910,pp1510,20150612,8622,8622,8623,8627,8572,8604,8609,-18,-13,48,2066280,62
911,pp1510,20150615,8604,8609,0,0,0,8609,8609,0,0,0,0,62
912,pp1510,20150616,8609,8609,8746,8746,8694,8694,8707,85,98,8,348280,60
913,pp1510,20150617,8694,8707,8519,8519,8519,8519,8519,-188,-188,4,170380,64
914,pp1510,20150618,8519,8519,8390,8390,8390,8390,8390,-129,-129,4,167800,62
915,pp1510,20150619,8390,8390,8584,8584,8560,8560,8566,170,176,8,342650,68
916,pp1510,20150623,8560,8566,0,0,0,8549,8549,-17,-17,0,0,68
917,pp1510,20150624,8549,8549,0,0,0,8549,8549,0,0,0,0,68
918,pp1510,20150625,8549,8549,8657,8657,8592,8619,8623,70,74,14,603660,68
919,pp1510,20150626,8619,8623,0,0,0,8623,8623,0,0,0,0,68
920,pp1510,20150629,8623,8623,8627,8627,8528,8528,8589,-95,-34,8,343590,70
921,pp1510,20150630,8528,8589,8246,8246,8246,8246,8246,-343,-343,20,824600,86
922,pp1510,20150701,8246,8246,8575,8575,8575,8575,8575,329,329,22,943250,68
923,pp1510,20150702,8575,8575,8667,8669,8585,8649,8650,74,75,38,1643680,68
924,pp1510,20150703,8649,8650,0,0,0,8644,8644,-6,-6,0,0,68
925,pp1510,20150706,8644,8644,8453,8582,8366,8366,8491,-278,-153,10,424570,68
926,pp1510,20150707,8366,8491,8413,8413,8300,8300,8347,-191,-144,16,667780,68
927,pp1510,20150708,8300,8347,0,0,0,8014,8014,-333,-333,0,0,68
928,pp1510,20150709,8014,8014,0,0,0,8325,8325,311,311,0,0,68
929,pp1510,20150710,8325,8325,0,0,0,8325,8325,0,0,0,0,68
930,pp1510,20150713,8325,8325,8290,8290,8284,8284,8286,-41,-39,6,248580,62
931,pp1510,20150714,8284,8286,0,0,0,8250,8250,-36,-36,0,0,62
932,pp1510,20150715,8250,8250,0,0,0,8213,8213,-37,-37,0,0,62
933,pp1510,20150716,8213,8213,8213,8213,8213,8213,8213,0,0,2,82130,64
934,pp1510,20150717,8213,8213,8113,8113,8113,8113,8113,-100,-100,2,81130,62
935,pp1510,20150720,8113,8113,0,0,0,8113,8113,0,0,0,0,62
936,pp1510,20150721,8113,8113,0,0,0,8098,8098,-15,-15,0,0,62
937,pp1510,20150722,8098,8098,0,0,0,8098,8098,0,0,0,0,62
938,pp1510,20150723,8098,8098,0,0,0,8098,8098,0,0,0,0,62
939,pp1510,20150724,8098,8098,0,0,0,7968,7968,-130,-130,0,0,62
940,pp1510,20150727,7968,7968,0,0,0,7717,7717,-251,-251,0,0,62
941,pp1510,20150728,7717,7717,0,0,0,7717,7717,0,0,0,0,62
942,pp1510,20150729,7717,7717,0,0,0,7874,7874,157,157,0,0,62
943,pp1510,20150730,7874,7874,0,0,0,7878,7878,4,4,0,0,62
944,pp1510,20150731,7878,7878,0,0,0,7783,7783,-95,-95,0,0,62
945,pp1510,20150803,7783,7783,0,0,0,7611,7611,-172,-172,0,0,62
946,pp1510,20150804,7611,7611,0,0,0,7618,7618,7,7,0,0,62
947,pp1510,20150805,7618,7618,0,0,0,7783,7783,165,165,0,0,62
948,pp1510,20150806,7783,7783,0,0,0,7872,7872,89,89,0,0,62
949,pp1510,20150807,7872,7872,7994,8185,7994,8185,8142,313,270,10,407120,62
950,pp1510,20150810,8185,8142,0,0,0,8142,8142,0,0,0,0,62
951,pp1510,20150811,8142,8142,8396,8467,8396,8467,8413,325,271,16,673100,64
952,pp1510,20150812,8467,8413,0,0,0,8413,8413,0,0,0,0,64
953,pp1510,20150813,8413,8413,0,0,0,8413,8413,0,0,0,0,64
954,pp1510,20150814,8413,8413,0,0,0,8413,8413,0,0,0,0,64
955,pp1510,20150817,8413,8413,8370,8370,8349,8349,8363,-64,-50,6,250890,64
956,pp1510,20150818,8349,8363,8212,8212,8192,8192,8205,-171,-158,6,246160,60
957,pp1510,20150819,8192,8205,0,0,0,8243,8243,38,38,0,0,60
958,pp1510,20150820,8243,8243,0,0,0,8200,8200,-43,-43,0,0,60
959,pp1510,20150821,8200,8200,0,0,0,8100,8100,-100,-100,0,0,60
960,pp1510,20150824,8100,8100,0,0,0,7950,7950,-150,-150,0,0,60
961,pp1510,20150825,7950,7950,0,0,0,7950,7950,0,0,0,0,60
962,pp1510,20150826,7950,7950,0,0,0,7924,7924,-26,-26,0,0,60
963,pp1510,20150827,7924,7924,7735,7735,7735,7735,7735,-189,-189,2,77350,60
964,pp1510,20150828,7735,7735,0,0,0,7851,7851,116,116,0,0,60
965,pp1510,20150831,7851,7851,0,0,0,7726,7726,-125,-125,0,0,60
966,pp1510,20150901,7726,7726,7778,7778,7778,7778,7778,52,52,38,1477820,60
967,pp1510,20150902,7778,7778,0,0,0,7829,7829,51,51,0,0,60
968,pp1510,20150907,7829,7829,0,0,0,7835,7835,6,6,0,0,60
969,pp1510,20150908,7835,7835,0,0,0,7735,7735,-100,-100,0,0,60
970,pp1510,20150909,7735,7735,0,0,0,7638,7638,-97,-97,0,0,60
971,pp1510,20150910,7638,7638,0,0,0,7540,7540,-98,-98,0,0,60
972,pp1510,20150911,7540,7540,0,0,0,7565,7565,25,25,0,0,60
973,pp1510,20150914,7565,7565,7552,7552,7552,7552,7552,-13,-13,20,755200,58
974,pp1510,20150915,7552,7552,0,0,0,7552,7552,0,0,0,0,58
975,pp1510,20150916,7552,7552,0,0,0,7854,7854,302,302,0,0,58
976,pp1510,20150917,7854,7854,0,0,0,7850,7850,-4,-4,0,0,58
977,pp1510,20150918,7850,7850,0,0,0,7735,7735,-115,-115,0,0,58
978,pp1510,20150921,7735,7735,0,0,0,7735,7735,0,0,0,0,58
979,pp1510,20150922,7735,7735,0,0,0,7735,7735,0,0,0,0,58
980,pp1510,20150923,7735,7735,7513,7776,7512,7776,7612,41,-123,58,2207570,58
981,pp1510,20150924,7776,7612,7514,7790,7470,7521,7529,-91,-83,54,2032930,58
982,pp1510,20150925,7521,7529,0,0,0,7529,7529,0,0,0,0,58
983,pp1510,20150928,7529,7529,7529,7529,7529,7529,7529,0,0,2,75290,56
984,pp1510,20150929,7529,7529,7528,7550,7450,7550,7509,21,-20,36,1351740,40
985,pp1510,20150930,7550,7509,7550,7550,7550,7550,7550,41,41,2,75500,40
986,pp1510,20151008,7550,7550,7580,7580,7580,7580,7580,30,30,4,151600,36
987,pp1510,20151009,7580,7580,0,0,0,7580,7580,0,0,0,0,36
988,pp1510,20151012,7580,7580,7180,7300,7180,7300,7286,-280,-294,36,1311600,4
989,pp1510,20151013,7300,7286,0,0,0,7286,7286,0,0,0,0,4
990,pp1510,20151014,7286,7286,0,0,0,7300,7300,14,14,0,0,4
991,pp1510,20151015,7300,7300,7380,7380,7380,7380,7380,80,80,4,147600,0
992,pp1510,20151016,7380,7380,0,0,0,7380,7380,0,0,0,0,0
993,pp1510,20151019,7380,7380,0,0,0,7380,7380,0,0,0,0,0
994,pp1510,20151020,7380,7380,0,0,0,7380,7380,0,0,0,0,0
995,pp1510,20151021,7380,7380,0,0,0,7321,7321,-59,-59,0,0,0
996,pp1511,20150105,7448,7448,0,0,0,7448,7448,0,0,0,0,36
997,pp1511,20150106,7448,7448,7151,7151,7151,7151,7151,-297,-297,20,715100,40
998,pp1511,20150107,7151,7151,7087,7087,7087,7087,7087,-64,-64,2,70870,40
999,pp1511,20150108,7087,7087,7169,7169,7169,7169,7169,82,82,2,71690,40
1000,pp1511,20150109,7169,7169,7025,7025,6949,6961,6975,-208,-194,14,488250,44
1001,pp1511,20150112,6961,6975,6876,6970,6876,6956,6934,-19,-41,6,208020,44
1002,pp1511,20150113,6956,6934,6956,6956,6875,6878,6906,-56,-28,10,345340,40
1003,pp1511,20150114,6878,6906,6900,6900,6900,6900,6900,-6,-6,4,138000,42
1004,pp1511,20150115,6900,6900,7019,7019,7019,7019,7019,119,119,4,140380,44
1005,pp1511,20150116,7019,7019,0,0,0,6991,6991,-28,-28,0,0,44
1006,pp1511,20150119,6991,6991,7121,7123,7121,7123,7122,132,131,6,213660,42
1007,pp1511,20150120,7123,7122,7075,7075,7075,7075,7075,-47,-47,2,70750,40
1008,pp1511,20150121,7075,7075,7061,7061,7061,7061,7061,-14,-14,4,141220,40
1009,pp1511,20150122,7061,7061,0,0,0,7061,7061,0,0,0,0,40
1010,pp1511,20150123,7061,7061,7019,7019,7019,7019,7019,-42,-42,2,70190,38
1011,pp1511,20150126,7019,7019,0,0,0,7019,7019,0,0,0,0,38
1012,pp1511,20150127,7019,7019,0,0,0,7019,7019,0,0,0,0,38
1013,pp1511,20150128,7019,7019,0,0,0,7019,7019,0,0,0,0,38
1014,pp1511,20150129,7019,7019,0,0,0,7019,7019,0,0,0,0,38
1015,pp1511,20150130,7019,7019,0,0,0,7019,7019,0,0,0,0,38
1016,pp1511,20150202,7019,7019,0,0,0,7019,7019,0,0,0,0,38
1017,pp1511,20150203,7019,7019,7299,7299,7299,7299,7299,280,280,2,72990,36
1018,pp1511,20150204,7299,7299,7534,7534,7534,7534,7534,235,235,8,301360,38
1019,pp1511,20150205,7534,7534,0,0,0,7449,7449,-85,-85,0,0,38
1020,pp1511,20150206,7449,7449,7386,7587,7386,7587,7525,138,76,22,827780,38
1021,pp1511,20150209,7587,7525,7534,7616,7534,7616,7605,91,80,20,760520,42
1022,pp1511,20150210,7616,7605,7385,7385,7385,7385,7385,-220,-220,10,369250,42
1023,pp1511,20150211,7385,7385,0,0,0,7550,7550,165,165,0,0,42
1024,pp1511,20150212,7550,7550,7563,7563,7562,7562,7562,12,12,8,302510,36
1025,pp1511,20150213,7562,7562,7760,7863,7760,7863,7845,301,283,12,470750,28
1026,pp1511,20150216,7863,7845,7830,7830,7830,7830,7830,-15,-15,2,78300,28
1027,pp1511,20150217,7830,7830,0,0,0,7830,7830,0,0,0,0,28
1028,pp1511,20150225,7830,7830,7840,7840,7829,7829,7834,-1,4,4,156690,30
1029,pp1511,20150226,7829,7834,0,0,0,7834,7834,0,0,0,0,30
1030,pp1511,20150227,7834,7834,0,0,0,7839,7839,5,5,0,0,30
1031,pp1511,20150302,7839,7839,8100,8139,8035,8139,8086,300,247,10,404340,30
1032,pp1511,20150303,8139,8086,8062,8062,8062,8062,8062,-24,-24,20,806200,46
1033,pp1511,20150304,8062,8062,8083,8083,8083,8083,8083,21,21,4,161660,46
1034,pp1511,20150305,8083,8083,8031,8031,7901,7901,7955,-182,-128,44,1750240,58
1035,pp1511,20150306,7901,7955,0,0,0,7955,7955,0,0,0,0,58
1036,pp1511,20150309,7955,7955,7725,7783,7725,7783,7754,-172,-201,4,155080,58
1037,pp1511,20150310,7783,7754,0,0,0,7754,7754,0,0,0,0,58
1038,pp1511,20150311,7754,7754,0,0,0,7754,7754,0,0,0,0,58
1039,pp1511,20150312,7754,7754,0,0,0,7900,7900,146,146,0,0,58
1040,pp1511,20150313,7900,7900,0,0,0,8031,8031,131,131,0,0,58
1041,pp1511,20150316,8031,8031,7954,7954,7954,7954,7954,-77,-77,2,79540,58
1042,pp1511,20150317,7954,7954,0,0,0,7954,7954,0,0,0,0,58
1043,pp1511,20150318,7954,7954,0,0,0,7694,7694,-260,-260,0,0,58
1044,pp1511,20150319,7694,7694,0,0,0,7827,7827,133,133,0,0,58
1045,pp1511,20150320,7827,7827,7868,7868,7868,7868,7868,41,41,2,78680,58
1046,pp1511,20150323,7868,7868,7989,7990,7989,7990,7989,122,121,4,159790,62
1047,pp1511,20150324,7990,7989,8190,8190,8100,8100,8128,111,139,10,406410,66
1048,pp1511,20150325,8100,8128,0,0,0,8128,8128,0,0,0,0,66
1049,pp1511,20150326,8128,8128,0,0,0,8128,8128,0,0,0,0,66
1050,pp1511,20150327,8128,8128,8150,8150,8039,8039,8094,-89,-34,4,161890,66
1051,pp1511,20150330,8039,8094,0,0,0,8058,8058,-36,-36,0,0,66
1052,pp1511,20150331,8058,8058,8279,8279,8279,8279,8279,221,221,2,82790,64
1053,pp1511,20150401,8279,8279,8170,8206,8170,8206,8200,-73,-79,12,492000,66
1054,pp1511,20150402,8206,8200,0,0,0,8287,8287,87,87,0,0,66
1055,pp1511,20150403,8287,8287,8093,8155,8093,8153,8147,-134,-140,32,1303630,84
1056,pp1511,20150407,8153,8147,8120,8187,8094,8153,8147,6,0,24,977670,70
1057,pp1511,20150408,8153,8147,8300,8341,8300,8341,8312,194,165,20,831230,66
1058,pp1511,20150409,8341,8312,0,0,0,8166,8166,-146,-146,0,0,66
1059,pp1511,20150410,8166,8166,0,0,0,8202,8202,36,36,0,0,66
1060,pp1511,20150413,8202,8202,0,0,0,8202,8202,0,0,0,0,66
1061,pp1511,20150414,8202,8202,0,0,0,8202,8202,0,0,0,0,66
1062,pp1511,20150415,8202,8202,0,0,0,8202,8202,0,0,0,0,66
1063,pp1511,20150416,8202,8202,0,0,0,8441,8441,239,239,0,0,66
1064,pp1511,20150417,8441,8441,0,0,0,8441,8441,0,0,0,0,66
1065,pp1511,20150420,8441,8441,0,0,0,8516,8516,75,75,0,0,66
1066,pp1511,20150421,8516,8516,0,0,0,8450,8450,-66,-66,0,0,66
1067,pp1511,20150422,8450,8450,8447,8447,8447,8447,8447,-3,-3,2,84470,64
1068,pp1511,20150423,8447,8447,0,0,0,8447,8447,0,0,0,0,64
1069,pp1511,20150424,8447,8447,0,0,0,8447,8447,0,0,0,0,64
1070,pp1511,20150427,8447,8447,0,0,0,8587,8587,140,140,0,0,64
1071,pp1511,20150428,8587,8587,8828,8828,8732,8732,8788,145,201,12,527280,62
1072,pp1511,20150429,8732,8788,0,0,0,8758,8758,-30,-30,0,0,62
1073,pp1511,20150430,8758,8758,0,0,0,8803,8803,45,45,0,0,62
1074,pp1511,20150504,8803,8803,0,0,0,8803,8803,0,0,0,0,62
1075,pp1511,20150505,8803,8803,0,0,0,8803,8803,0,0,0,0,62
1076,pp1511,20150506,8803,8803,0,0,0,8803,8803,0,0,0,0,62
1077,pp1511,20150507,8803,8803,0,0,0,8660,8660,-143,-143,0,0,62
1078,pp1511,20150508,8660,8660,0,0,0,8504,8504,-156,-156,0,0,62
1079,pp1511,20150511,8504,8504,0,0,0,8504,8504,0,0,0,0,62
1080,pp1511,20150512,8504,8504,0,0,0,8504,8504,0,0,0,0,62
1081,pp1511,20150513,8504,8504,8301,8426,8301,8426,8342,-78,-162,12,500560,58
1082,pp1511,20150514,8426,8342,8302,8302,8302,8302,8302,-40,-40,2,83020,56
1083,pp1511,20150515,8302,8302,0,0,0,8302,8302,0,0,0,0,56
1084,pp1511,20150518,8302,8302,0,0,0,8302,8302,0,0,0,0,56
1085,pp1511,20150519,8302,8302,0,0,0,8302,8302,0,0,0,0,56
1086,pp1511,20150520,8302,8302,0,0,0,8302,8302,0,0,0,0,56
1087,pp1511,20150521,8302,8302,0,0,0,8329,8329,27,27,0,0,56
1088,pp1511,20150522,8329,8329,0,0,0,8329,8329,0,0,0,0,56
1089,pp1511,20150525,8329,8329,0,0,0,8329,8329,0,0,0,0,56
1090,pp1511,20150526,8329,8329,0,0,0,8329,8329,0,0,0,0,56
1091,pp1511,20150527,8329,8329,0,0,0,8201,8201,-128,-128,0,0,56
1092,pp1511,20150528,8201,8201,0,0,0,8201,8201,0,0,0,0,56
1093,pp1511,20150529,8201,8201,0,0,0,8235,8235,34,34,0,0,56
1094,pp1511,20150601,8235,8235,0,0,0,8263,8263,28,28,0,0,56
1095,pp1511,20150602,8263,8263,0,0,0,8263,8263,0,0,0,0,56
1096,pp1511,20150603,8263,8263,0,0,0,8351,8351,88,88,0,0,56
1097,pp1511,20150604,8351,8351,0,0,0,8351,8351,0,0,0,0,56
1098,pp1511,20150605,8351,8351,0,0,0,8360,8360,9,9,0,0,56
1099,pp1511,20150608,8360,8360,0,0,0,8360,8360,0,0,0,0,56
1100,pp1511,20150609,8360,8360,0,0,0,8360,8360,0,0,0,0,56
1101,pp1511,20150610,8360,8360,8466,8544,8420,8429,8479,69,119,10,423980,56
1102,pp1511,20150611,8429,8479,0,0,0,8616,8616,137,137,0,0,56
1103,pp1511,20150612,8616,8616,0,0,0,8604,8604,-12,-12,0,0,56
1104,pp1511,20150615,8604,8604,0,0,0,8556,8556,-48,-48,0,0,56
1105,pp1511,20150616,8556,8556,0,0,0,8653,8653,97,97,0,0,56
1106,pp1511,20150617,8653,8653,8393,8490,8393,8490,8441,-163,-212,4,168830,56
1107,pp1511,20150618,8490,8441,0,0,0,8314,8314,-127,-127,0,0,56
1108,pp1511,20150619,8314,8314,0,0,0,8350,8350,36,36,0,0,56
1109,pp1511,20150623,8350,8350,0,0,0,8334,8334,-16,-16,0,0,56
1110,pp1511,20150624,8334,8334,0,0,0,8450,8450,116,116,0,0,56
1111,pp1511,20150625,8450,8450,0,0,0,8523,8523,73,73,0,0,56
1112,pp1511,20150626,8523,8523,0,0,0,8590,8590,67,67,0,0,56
1113,pp1511,20150629,8590,8590,0,0,0,8590,8590,0,0,0,0,56
1114,pp1511,20150630,8590,8590,8514,8514,8514,8514,8514,-76,-76,12,510840,50
1115,pp1511,20150701,8514,8514,8616,8616,8616,8616,8616,102,102,2,86160,50
1116,pp1511,20150702,8616,8616,8515,8515,8421,8421,8491,-195,-125,16,679320,48
1117,pp1511,20150703,8421,8491,0,0,0,8486,8486,-5,-5,0,0,48
1118,pp1511,20150706,8486,8486,8400,8400,8370,8370,8379,-116,-107,12,502760,40
1119,pp1511,20150707,8370,8379,0,0,0,8237,8237,-142,-142,0,0,40
1120,pp1511,20150708,8237,8237,8044,8044,7908,7908,7914,-329,-323,42,1662040,40
1121,pp1511,20150709,7908,7914,8297,8297,8098,8209,8158,295,244,34,1386940,30
1122,pp1511,20150710,8209,8158,0,0,0,8158,8158,0,0,0,0,30
1123,pp1511,20150713,8158,8158,8155,8155,8155,8155,8155,-3,-3,4,163100,30
1124,pp1511,20150714,8155,8155,0,0,0,8155,8155,0,0,0,0,30
1125,pp1511,20150715,8155,8155,0,0,0,8118,8118,-37,-37,0,0,30
1126,pp1511,20150716,8118,8118,8015,8015,8015,8015,8015,-103,-103,2,80150,28
1127,pp1511,20150717,8015,8015,8172,8173,8172,8173,8172,158,157,4,163450,26
1128,pp1511,20150720,8173,8172,0,0,0,8172,8172,0,0,0,0,26
1129,pp1511,20150721,8172,8172,0,0,0,8156,8156,-16,-16,0,0,26
1130,pp1511,20150722,8156,8156,0,0,0,8230,8230,74,74,0,0,26
1131,pp1511,20150723,8230,8230,0,0,0,8230,8230,0,0,0,0,26
1132,pp1511,20150724,8230,8230,0,0,0,8098,8098,-132,-132,0,0,26
1133,pp1511,20150727,8098,8098,7777,7823,7777,7823,7788,-275,-310,8,311540,20
1134,pp1511,20150728,7823,7788,7785,7785,7785,7785,7785,-3,-3,2,77850,18
1135,pp1511,20150729,7785,7785,0,0,0,7944,7944,159,159,0,0,18
1136,pp1511,20150730,7944,7944,0,0,0,7944,7944,0,0,0,0,18
1137,pp1511,20150731,7944,7944,0,0,0,7944,7944,0,0,0,0,18
1138,pp1511,20150803,7944,7944,7759,7759,7759,7759,7759,-185,-185,2,77590,18
1139,pp1511,20150804,7759,7759,0,0,0,7759,7759,0,0,0,0,18
1140,pp1511,20150805,7759,7759,0,0,0,7759,7759,0,0,0,0,18
1141,pp1511,20150806,7759,7759,0,0,0,7759,7759,0,0,0,0,18
1142,pp1511,20150807,7759,7759,0,0,0,7759,7759,0,0,0,0,18
1143,pp1511,20150810,7759,7759,8000,8000,8000,8000,8000,241,241,4,160000,14
1144,pp1511,20150811,8000,8000,0,0,0,8000,8000,0,0,0,0,14
1145,pp1511,20150812,8000,8000,0,0,0,7974,7974,-26,-26,0,0,14
1146,pp1511,20150813,7974,7974,7974,8292,7974,7981,8082,7,108,6,242470,14
1147,pp1511,20150814,7981,8082,0,0,0,8082,8082,0,0,0,0,14
1148,pp1511,20150817,8082,8082,0,0,0,8082,8082,0,0,0,0,14
1149,pp1511,20150818,8082,8082,8082,8082,8082,8082,8082,0,0,4,161640,10
1150,pp1511,20150819,8082,8082,0,0,0,8120,8120,38,38,0,0,10
1151,pp1511,20150820,8120,8120,0,0,0,8073,8073,-47,-47,0,0,10
1152,pp1511,20150821,8073,8073,0,0,0,8095,8095,22,22,0,0,10
1153,pp1511,20150824,8095,8095,0,0,0,7892,7892,-203,-203,0,0,10
1154,pp1511,20150825,7892,7892,0,0,0,7892,7892,0,0,0,0,10
1155,pp1511,20150826,7892,7892,0,0,0,7866,7866,-26,-26,0,0,10
1156,pp1511,20150827,7866,7866,0,0,0,7679,7679,-187,-187,0,0,10
1157,pp1511,20150828,7679,7679,0,0,0,7794,7794,115,115,0,0,10
1158,pp1511,20150831,7794,7794,0,0,0,7794,7794,0,0,0,0,10
1159,pp1511,20150901,7794,7794,0,0,0,7846,7846,52,52,0,0,10
1160,pp1511,20150902,7846,7846,0,0,0,7897,7897,51,51,0,0,10
1161,pp1511,20150907,7897,7897,0,0,0,7903,7903,6,6,0,0,10
1162,pp1511,20150908,7903,7903,0,0,0,7820,7820,-83,-83,0,0,10
1163,pp1511,20150909,7820,7820,0,0,0,7722,7722,-98,-98,0,0,10
1164,pp1511,20150910,7722,7722,0,0,0,7623,7623,-99,-99,0,0,10
1165,pp1511,20150911,7623,7623,7927,7927,7721,7721,7824,98,201,4,156480,10
1166,pp1511,20150914,7721,7824,0,0,0,7811,7811,-13,-13,0,0,10
1167,pp1511,20150915,7811,7811,0,0,0,7638,7638,-173,-173,0,0,10
1168,pp1511,20150916,7638,7638,0,0,0,7943,7943,305,305,0,0,10
1169,pp1511,20150917,7943,7943,0,0,0,7943,7943,0,0,0,0,10
1170,pp1511,20150918,7943,7943,0,0,0,7943,7943,0,0,0,0,10
1171,pp1511,20150921,7943,7943,0,0,0,7943,7943,0,0,0,0,10
1172,pp1511,20150922,7943,7943,0,0,0,7943,7943,0,0,0,0,10
1173,pp1511,20150923,7943,7943,0,0,0,7817,7817,-126,-126,0,0,10
1174,pp1511,20150924,7817,7817,0,0,0,7732,7732,-85,-85,0,0,10
1175,pp1511,20150925,7732,7732,0,0,0,7732,7732,0,0,0,0,10
1176,pp1511,20150928,7732,7732,0,0,0,7732,7732,0,0,0,0,10
1177,pp1511,20150929,7732,7732,0,0,0,7712,7712,-20,-20,0,0,10
1178,pp1511,20150930,7712,7712,7252,7634,7252,7588,7491,-124,-221,6,224740,10
1179,pp1511,20151008,7588,7491,0,0,0,7520,7520,29,29,0,0,10
1180,pp1511,20151009,7520,7520,0,0,0,7520,7520,0,0,0,0,10
1181,pp1511,20151012,7520,7520,0,0,0,7229,7229,-291,-291,0,0,10
1182,pp1511,20151013,7229,7229,0,0,0,7229,7229,0,0,0,0,10
1183,pp1511,20151014,7229,7229,0,0,0,7229,7229,0,0,0,0,10
1184,pp1511,20151015,7229,7229,0,0,0,7308,7308,79,79,0,0,10
1185,pp1511,20151016,7308,7308,0,0,0,7308,7308,0,0,0,0,10
1186,pp1511,20151019,7308,7308,0,0,0,7308,7308,0,0,0,0,10
1187,pp1511,20151020,7308,7308,0,0,0,7308,7308,0,0,0,0,10
1188,pp1511,20151021,7308,7308,0,0,0,7308,7308,0,0,0,0,10
1189,pp1511,20151022,7308,7308,7017,7018,7017,7018,7017,-290,-291,4,140350,6
1190,pp1511,20151023,7018,7017,7250,7297,6944,7200,7131,183,114,36,1283700,6
1191,pp1511,20151026,7200,7131,7050,7050,7050,7050,7050,-81,-81,2,70500,4
1192,pp1511,20151027,7050,7050,6808,7320,6808,7320,7064,270,14,4,141280,4
1193,pp1511,20151028,7320,7064,0,0,0,7064,7064,0,0,0,0,4
1194,pp1511,20151029,7064,7064,7200,7200,7200,7200,7200,136,136,4,144000,4
1195,pp1511,20151030,7200,7200,6913,7392,6913,7000,7096,-200,-104,60,2128840,2
1196,pp1511,20151102,7000,7096,0,0,0,7096,7096,0,0,0,0,2
1197,pp1511,20151103,7096,7096,0,0,0,7096,7096,0,0,0,0,2
1198,pp1511,20151104,7096,7096,0,0,0,7096,7096,0,0,0,0,2
1199,pp1511,20151105,7096,7096,0,0,0,7096,7096,0,0,0,0,2
1200,pp1511,20151106,7096,7096,0,0,0,7096,7096,0,0,0,0,2
1201,pp1511,20151109,7096,7096,7096,7096,7096,7096,7096,0,0,2,70960,0
1202,pp1511,20151110,7096,7096,0,0,0,7096,7096,0,0,0,0,0
1203,pp1511,20151111,7096,7096,0,0,0,7096,7096,0,0,0,0,0
1204,pp1511,20151112,7096,7096,0,0,0,7096,7096,0,0,0,0,0
1205,pp1511,20151113,7096,7096,0,0,0,7096,7096,0,0,0,0,0
1206,pp1512,20150105,7504,7504,0,0,0,7372,7372,-132,-132,0,0,0
1207,pp1512,20150106,7372,7372,0,0,0,7334,7334,-38,-38,0,0,0
1208,pp1512,20150107,7334,7334,0,0,0,7334,7334,0,0,0,0,0
1209,pp1512,20150108,7334,7334,0,0,0,7328,7328,-6,-6,0,0,0
1210,pp1512,20150109,7328,7328,0,0,0,7130,7130,-198,-198,0,0,0
1211,pp1512,20150112,7130,7130,0,0,0,7130,7130,0,0,0,0,0
1212,pp1512,20150113,7130,7130,0,0,0,7093,7093,-37,-37,0,0,0
1213,pp1512,20150114,7093,7093,6981,6981,6838,6838,6909,-255,-184,4,138190,2
1214,pp1512,20150115,6838,6909,0,0,0,7028,7028,119,119,0,0,2
1215,pp1512,20150116,7028,7028,0,0,0,6983,6983,-45,-45,0,0,2
1216,pp1512,20150119,6983,6983,0,0,0,7113,7113,130,130,0,0,2
1217,pp1512,20150120,7113,7113,0,0,0,7067,7067,-46,-46,0,0,2
1218,pp1512,20150121,7067,7067,0,0,0,7067,7067,0,0,0,0,2
1219,pp1512,20150122,7067,7067,0,0,0,7085,7085,18,18,0,0,2
1220,pp1512,20150123,7085,7085,0,0,0,7043,7043,-42,-42,0,0,2
1221,pp1512,20150126,7043,7043,0,0,0,7043,7043,0,0,0,0,2
1222,pp1512,20150127,7043,7043,0,0,0,6941,6941,-102,-102,0,0,2
1223,pp1512,20150128,6941,6941,0,0,0,6941,6941,0,0,0,0,2
1224,pp1512,20150129,6941,6941,0,0,0,6941,6941,0,0,0,0,2
1225,pp1512,20150130,6941,6941,0,0,0,6941,6941,0,0,0,0,2
1226,pp1512,20150202,6941,6941,0,0,0,6941,6941,0,0,0,0,2
1227,pp1512,20150203,6941,6941,0,0,0,7217,7217,276,276,0,0,2
1228,pp1512,20150204,7217,7217,0,0,0,7449,7449,232,232,0,0,2
1229,pp1512,20150205,7449,7449,0,0,0,7303,7303,-146,-146,0,0,2
1230,pp1512,20150206,7303,7303,0,0,0,7377,7377,74,74,0,0,2
1231,pp1512,20150209,7377,7377,0,0,0,7455,7455,78,78,0,0,2
1232,pp1512,20150210,7455,7455,0,0,0,7455,7455,0,0,0,0,2
1233,pp1512,20150211,7455,7455,7719,7719,7382,7382,7550,-73,95,4,151010,4
1234,pp1512,20150212,7382,7550,0,0,0,7561,7561,11,11,0,0,4
1235,pp1512,20150213,7561,7561,0,0,0,7843,7843,282,282,0,0,4
1236,pp1512,20150216,7843,7843,0,0,0,7829,7829,-14,-14,0,0,4
1237,pp1512,20150217,7829,7829,0,0,0,7814,7814,-15,-15,0,0,4
1238,pp1512,20150225,7814,7814,0,0,0,7817,7817,3,3,0,0,4
1239,pp1512,20150226,7817,7817,0,0,0,7976,7976,159,159,0,0,4
1240,pp1512,20150227,7976,7976,0,0,0,7990,7990,14,14,0,0,4
1241,pp1512,20150302,7990,7990,0,0,0,8241,8241,251,251,0,0,4
1242,pp1512,20150303,8241,8241,0,0,0,8217,8217,-24,-24,0,0,4
1243,pp1512,20150304,8217,8217,0,0,0,8238,8238,21,21,0,0,4
1244,pp1512,20150305,8238,8238,0,0,0,8108,8108,-130,-130,0,0,4
1245,pp1512,20150306,8108,8108,0,0,0,8008,8008,-100,-100,0,0,4
1246,pp1512,20150309,8008,8008,0,0,0,7806,7806,-202,-202,0,0,4
1247,pp1512,20150310,7806,7806,0,0,0,7847,7847,41,41,0,0,4
1248,pp1512,20150311,7847,7847,0,0,0,7775,7775,-72,-72,0,0,4
1249,pp1512,20150312,7775,7775,0,0,0,7922,7922,147,147,0,0,4
1250,pp1512,20150313,7922,7922,0,0,0,8053,8053,131,131,0,0,4
1251,pp1512,20150316,8053,8053,0,0,0,7976,7976,-77,-77,0,0,4
1252,pp1512,20150317,7976,7976,0,0,0,8039,8039,63,63,0,0,4
1253,pp1512,20150318,8039,8039,0,0,0,7777,7777,-262,-262,0,0,4
1254,pp1512,20150319,7777,7777,0,0,0,7911,7911,134,134,0,0,4
1255,pp1512,20150320,7911,7911,0,0,0,7952,7952,41,41,0,0,4
1256,pp1512,20150323,7952,7952,7954,8072,7954,8072,8013,120,61,4,160260,4
1257,pp1512,20150324,8072,8013,0,0,0,8013,8013,0,0,0,0,4
1258,pp1512,20150325,8013,8013,0,0,0,8013,8013,0,0,0,0,4
1259,pp1512,20150326,8013,8013,0,0,0,8013,8013,0,0,0,0,4
1260,pp1512,20150327,8013,8013,0,0,0,7980,7980,-33,-33,0,0,4
1261,pp1512,20150330,7980,7980,0,0,0,7980,7980,0,0,0,0,4
1262,pp1512,20150331,7980,7980,0,0,0,8198,8198,218,218,0,0,4
1263,pp1512,20150401,8198,8198,0,0,0,8198,8198,0,0,0,0,4
1264,pp1512,20150402,8198,8198,8466,8466,8466,8466,8466,268,268,10,423300,14
1265,pp1512,20150403,8466,8466,8279,8279,8267,8267,8273,-199,-193,4,165460,12
1266,pp1512,20150407,8267,8273,0,0,0,8273,8273,0,0,0,0,12
1267,pp1512,20150408,8273,8273,8313,8346,8165,8307,8281,34,8,20,828120,12
1268,pp1512,20150409,8307,8281,0,0,0,8136,8136,-145,-145,0,0,12
1269,pp1512,20150410,8136,8136,0,0,0,8165,8165,29,29,0,0,12
1270,pp1512,20150413,8165,8165,8357,8357,8357,8357,8357,192,192,2,83570,10
1271,pp1512,20150414,8357,8357,8272,8272,8272,8272,8272,-85,-85,4,165440,10
1272,pp1512,20150415,8272,8272,0,0,0,8272,8272,0,0,0,0,10
1273,pp1512,20150416,8272,8272,0,0,0,8379,8379,107,107,0,0,10
1274,pp1512,20150417,8379,8379,0,0,0,8512,8512,133,133,0,0,10
1275,pp1512,20150420,8512,8512,8761,8761,8650,8650,8705,138,193,4,174110,10
1276,pp1512,20150421,8650,8705,8609,8609,8609,8609,8609,-96,-96,2,86090,10
1277,pp1512,20150422,8609,8609,0,0,0,8606,8606,-3,-3,0,0,10
1278,pp1512,20150423,8606,8606,0,0,0,8844,8844,238,238,0,0,10
1279,pp1512,20150424,8844,8844,8741,8749,8576,8670,8672,-174,-172,18,780540,20
1280,pp1512,20150427,8670,8672,8772,8772,8772,8772,8772,100,100,2,87720,20
1281,pp1512,20150428,8772,8772,8880,8880,8880,8880,8880,108,108,2,88800,20
1282,pp1512,20150429,8880,8880,0,0,0,8880,8880,0,0,0,0,20
1283,pp1512,20150430,8880,8880,0,0,0,8926,8926,46,46,0,0,20
1284,pp1512,20150504,8926,8926,0,0,0,8951,8951,25,25,0,0,20
1285,pp1512,20150505,8951,8951,8772,8772,8758,8758,8766,-193,-185,10,438320,20
1286,pp1512,20150506,8758,8766,0,0,0,8833,8833,67,67,0,0,20
1287,pp1512,20150507,8833,8833,0,0,0,8653,8653,-180,-180,0,0,20
1288,pp1512,20150508,8653,8653,0,0,0,8497,8497,-156,-156,0,0,20
1289,pp1512,20150511,8497,8497,0,0,0,8482,8482,-15,-15,0,0,20
1290,pp1512,20150512,8482,8482,0,0,0,8364,8364,-118,-118,0,0,20
1291,pp1512,20150513,8364,8364,0,0,0,8205,8205,-159,-159,0,0,20
1292,pp1512,20150514,8205,8205,0,0,0,8166,8166,-39,-39,0,0,20
1293,pp1512,20150515,8166,8166,0,0,0,8230,8230,64,64,0,0,20
1294,pp1512,20150518,8230,8230,0,0,0,8159,8159,-71,-71,0,0,20
1295,pp1512,20150519,8159,8159,0,0,0,8051,8051,-108,-108,0,0,20
1296,pp1512,20150520,8051,8051,0,0,0,7942,7942,-109,-109,0,0,20
1297,pp1512,20150521,7942,7942,0,0,0,7968,7968,26,26,0,0,20
1298,pp1512,20150522,7968,7968,0,0,0,7977,7977,9,9,0,0,20
1299,pp1512,20150525,7977,7977,0,0,0,7949,7949,-28,-28,0,0,20
1300,pp1512,20150526,7949,7949,0,0,0,8081,8081,132,132,0,0,20
1301,pp1512,20150527,8081,8081,8187,8187,8187,8187,8187,106,106,2,81870,20
1302,pp1512,20150528,8187,8187,0,0,0,8154,8154,-33,-33,0,0,20
1303,pp1512,20150529,8154,8154,0,0,0,8188,8188,34,34,0,0,20
1304,pp1512,20150601,8188,8188,0,0,0,8216,8216,28,28,0,0,20
1305,pp1512,20150602,8216,8216,0,0,0,8166,8166,-50,-50,0,0,20
1306,pp1512,20150603,8166,8166,0,0,0,8253,8253,87,87,0,0,20
1307,pp1512,20150604,8253,8253,0,0,0,8253,8253,0,0,0,0,20
1308,pp1512,20150605,8253,8253,0,0,0,8262,8262,9,9,0,0,20
1309,pp1512,20150608,8262,8262,0,0,0,8235,8235,-27,-27,0,0,20
1310,pp1512,20150609,8235,8235,0,0,0,8186,8186,-49,-49,0,0,20
1311,pp1512,20150610,8186,8186,0,0,0,8302,8302,116,116,0,0,20
1312,pp1512,20150611,8302,8302,0,0,0,8436,8436,134,134,0,0,20
1313,pp1512,20150612,8436,8436,0,0,0,8424,8424,-12,-12,0,0,20
1314,pp1512,20150615,8424,8424,0,0,0,8377,8377,-47,-47,0,0,20
1315,pp1512,20150616,8377,8377,0,0,0,8472,8472,95,95,0,0,20
1316,pp1512,20150617,8472,8472,0,0,0,8265,8265,-207,-207,0,0,20
1317,pp1512,20150618,8265,8265,0,0,0,8140,8140,-125,-125,0,0,20
1318,pp1512,20150619,8140,8140,0,0,0,8310,8310,170,170,0,0,20
1319,pp1512,20150623,8310,8310,0,0,0,8294,8294,-16,-16,0,0,20
1320,pp1512,20150624,8294,8294,0,0,0,8366,8366,72,72,0,0,20
1321,pp1512,20150625,8366,8366,0,0,0,8438,8438,72,72,0,0,20
1322,pp1512,20150626,8438,8438,0,0,0,8504,8504,66,66,0,0,20
1323,pp1512,20150629,8504,8504,0,0,0,8471,8471,-33,-33,0,0,20
1324,pp1512,20150630,8471,8471,0,0,0,8397,8397,-74,-74,0,0,20
1325,pp1512,20150701,8397,8397,0,0,0,8497,8497,100,100,0,0,20
1326,pp1512,20150702,8497,8497,0,0,0,8374,8374,-123,-123,0,0,20
1327,pp1512,20150703,8374,8374,0,0,0,8369,8369,-5,-5,0,0,20
1328,pp1512,20150706,8369,8369,0,0,0,8264,8264,-105,-105,0,0,20
1329,pp1512,20150707,8264,8264,0,0,0,8124,8124,-140,-140,0,0,20
1330,pp1512,20150708,8124,8124,0,0,0,7806,7806,-318,-318,0,0,20
1331,pp1512,20150709,7806,7806,8114,8116,7807,8116,8012,310,206,6,240370,20
1332,pp1512,20150710,8116,8012,8388,8388,8297,8297,8346,285,334,8,333870,20
1333,pp1512,20150713,8297,8346,0,0,0,8343,8343,-3,-3,0,0,20
1334,pp1512,20150714,8343,8343,0,0,0,8369,8369,26,26,0,0,20
1335,pp1512,20150715,8369,8369,0,0,0,8331,8331,-38,-38,0,0,20
1336,pp1512,20150716,8331,8331,0,0,0,8226,8226,-105,-105,0,0,20
1337,pp1512,20150717,8226,8226,0,0,0,8387,8387,161,161,0,0,20
1338,pp1512,20150720,8387,8387,0,0,0,8406,8406,19,19,0,0,20
1339,pp1512,20150721,8406,8406,0,0,0,8390,8390,-16,-16,0,0,20
1340,pp1512,20150722,8390,8390,0,0,0,8466,8466,76,76,0,0,20
1341,pp1512,20150723,8466,8466,0,0,0,8491,8491,25,25,0,0,20
1342,pp1512,20150724,8491,8491,0,0,0,8355,8355,-136,-136,0,0,20
1343,pp1512,20150727,8355,8355,8022,8022,8022,8022,8022,-333,-333,4,160440,22
1344,pp1512,20150728,8022,8022,0,0,0,8022,8022,0,0,0,0,22
1345,pp1512,20150729,8022,8022,0,0,0,8185,8185,163,163,0,0,22
1346,pp1512,20150730,8185,8185,7894,8010,7894,8010,7923,-175,-262,8,316920,22
1347,pp1512,20150731,8010,7923,0,0,0,7827,7827,-96,-96,0,0,22
1348,pp1512,20150803,7827,7827,7784,7784,7729,7729,7770,-98,-57,8,310810,28
1349,pp1512,20150804,7729,7770,7784,7784,7784,7784,7784,14,14,2,77840,26
1350,pp1512,20150805,7784,7784,7784,7784,7784,7784,7784,0,0,4,155680,22
1351,pp1512,20150806,7784,7784,0,0,0,7873,7873,89,89,0,0,22
1352,pp1512,20150807,7873,7873,0,0,0,8143,8143,270,270,0,0,22
1353,pp1512,20150810,8143,8143,0,0,0,8053,8053,-90,-90,0,0,22
1354,pp1512,20150811,8053,8053,8374,8374,7935,8119,8233,66,180,56,2305310,28
1355,pp1512,20150812,8119,8233,0,0,0,8233,8233,0,0,0,0,28
1356,pp1512,20150813,8233,8233,0,0,0,8344,8344,111,111,0,0,28
1357,pp1512,20150814,8344,8344,0,0,0,8344,8344,0,0,0,0,28
1358,pp1512,20150817,8344,8344,0,0,0,8295,8295,-49,-49,0,0,28
1359,pp1512,20150818,8295,8295,0,0,0,8295,8295,0,0,0,0,28
1360,pp1512,20150819,8295,8295,0,0,0,7964,7964,-331,-331,0,0,28
1361,pp1512,20150820,7964,7964,0,0,0,7964,7964,0,0,0,0,28
1362,pp1512,20150821,7964,7964,0,0,0,7964,7964,0,0,0,0,28
1363,pp1512,20150824,7964,7964,0,0,0,7765,7765,-199,-199,0,0,28
1364,pp1512,20150825,7765,7765,0,0,0,7759,7759,-6,-6,0,0,28
1365,pp1512,20150826,7759,7759,7724,7724,7724,7724,7724,-35,-35,2,77240,26
1366,pp1512,20150827,7724,7724,0,0,0,7724,7724,0,0,0,0,26
1367,pp1512,20150828,7724,7724,0,0,0,7724,7724,0,0,0,0,26
1368,pp1512,20150831,7724,7724,0,0,0,7724,7724,0,0,0,0,26
1369,pp1512,20150901,7724,7724,0,0,0,7775,7775,51,51,0,0,26
1370,pp1512,20150902,7775,7775,7627,7919,7611,7846,7737,71,-38,58,2243800,34
1371,pp1512,20150907,7846,7737,0,0,0,7743,7743,6,6,0,0,34
1372,pp1512,20150908,7743,7743,7660,7660,7660,7660,7660,-83,-83,2,76600,34
1373,pp1512,20150909,7660,7660,7594,7594,7594,7594,7594,-66,-66,2,75940,34
1374,pp1512,20150910,7594,7594,0,0,0,7496,7496,-98,-98,0,0,34
1375,pp1512,20150911,7496,7496,0,0,0,7693,7693,197,197,0,0,34
1376,pp1512,20150914,7693,7693,7469,7865,7469,7611,7702,-82,9,8,308100,36
1377,pp1512,20150915,7611,7702,0,0,0,7532,7532,-170,-170,0,0,36
1378,pp1512,20150916,7532,7532,0,0,0,7532,7532,0,0,0,0,36
1379,pp1512,20150917,7532,7532,7300,7736,7300,7504,7505,-28,-27,60,2251570,36
1380,pp1512,20150918,7504,7505,7660,7660,7518,7518,7584,13,79,14,530910,34
1381,pp1512,20150921,7518,7584,0,0,0,7584,7584,0,0,0,0,34
1382,pp1512,20150922,7584,7584,0,0,0,7584,7584,0,0,0,0,34
1383,pp1512,20150923,7584,7584,0,0,0,7464,7464,-120,-120,0,0,34
1384,pp1512,20150924,7464,7464,7228,7625,7228,7625,7426,161,-38,4,148530,34
1385,pp1512,20150925,7625,7426,0,0,0,7426,7426,0,0,0,0,34
1386,pp1512,20150928,7426,7426,0,0,0,7426,7426,0,0,0,0,34
1387,pp1512,20150929,7426,7426,0,0,0,7407,7407,-19,-19,0,0,34
1388,pp1512,20150930,7407,7407,0,0,0,7407,7407,0,0,0,0,34
1389,pp1512,20151008,7407,7407,0,0,0,7407,7407,0,0,0,0,34
1390,pp1512,20151009,7407,7407,0,0,0,7450,7450,43,43,0,0,34
1391,pp1512,20151012,7450,7450,0,0,0,7450,7450,0,0,0,0,34
1392,pp1512,20151013,7450,7450,0,0,0,7450,7450,0,0,0,0,34
1393,pp1512,20151014,7450,7450,7463,7747,7152,7747,7465,297,15,20,746520,34
1394,pp1512,20151015,7747,7465,0,0,0,7465,7465,0,0,0,0,34
1395,pp1512,20151016,7465,7465,0,0,0,7465,7465,0,0,0,0,34
1396,pp1512,20151019,7465,7465,0,0,0,7465,7465,0,0,0,0,34
1397,pp1512,20151020,7465,7465,7167,7369,7167,7369,7268,-96,-197,4,145360,34
1398,pp1512,20151021,7369,7268,7107,7107,7107,7107,7107,-161,-161,10,355350,34
1399,pp1512,20151022,7107,7107,7388,7391,7218,7218,7361,111,254,12,441670,28
1400,pp1512,20151023,7218,7361,7439,7439,7439,7439,7439,78,78,2,74390,28
1401,pp1512,20151026,7439,7439,7142,7142,7142,7142,7142,-297,-297,2,71420,28
1402,pp1512,20151027,7142,7142,0,0,0,7156,7156,14,14,0,0,28
1403,pp1512,20151028,7156,7156,0,0,0,7156,7156,0,0,0,0,28
1404,pp1512,20151029,7156,7156,0,0,0,7156,7156,0,0,0,0,28
1405,pp1512,20151030,7156,7156,0,0,0,7156,7156,0,0,0,0,28
1406,pp1512,20151102,7156,7156,6900,7215,6875,7090,7051,-66,-105,256,9026090,32
1407,pp1512,20151103,7090,7051,7060,7060,7060,7060,7060,9,9,2,70600,32
1408,pp1512,20151104,7060,7060,0,0,0,7060,7060,0,0,0,0,32
1409,pp1512,20151105,7060,7060,6990,6990,6990,6990,6990,-70,-70,4,139800,30
1410,pp1512,20151106,6990,6990,0,0,0,6990,6990,0,0,0,0,30
1411,pp1512,20151109,6990,6990,6999,7137,6802,6802,6939,-188,-51,14,485740,22
1412,pp1512,20151110,6802,6939,6711,7057,6711,6840,6869,-99,-70,6,206080,22
1413,pp1512,20151111,6840,6869,6876,6876,6876,6876,6876,7,7,2,68760,22
1414,pp1512,20151112,6876,6876,0,0,0,6876,6876,0,0,0,0,22
1415,pp1512,20151113,6876,6876,0,0,0,6676,6676,-200,-200,0,0,22
1416,pp1512,20151116,6676,6676,6460,6460,6409,6409,6435,-267,-241,8,257400,14
1417,pp1512,20151117,6409,6435,6242,6242,6190,6240,6228,-195,-207,8,249120,8
1418,pp1512,20151118,6240,6228,6219,6219,6200,6200,6212,-28,-16,30,931900,18
1419,pp1512,20151119,6200,6212,6200,6200,6180,6180,6190,-32,-22,8,247600,10
1420,pp1512,20151120,6180,6190,6150,6150,6017,6017,6083,-173,-107,4,121670,6
1421,pp1512,20151123,6017,6083,0,0,0,6083,6083,0,0,0,0,6
1422,pp1512,20151124,6083,6083,0,0,0,6083,6083,0,0,0,0,6
1423,pp1512,20151125,6083,6083,0,0,0,6083,6083,0,0,0,0,6
1424,pp1512,20151126,6083,6083,0,0,0,6083,6083,0,0,0,0,6
1425,pp1512,20151127,6083,6083,6288,6288,6288,6288,6288,205,205,6,188640,0
1426,pp1512,20151130,6288,6288,0,0,0,6288,6288,0,0,0,0,0
1427,pp1512,20151201,6288,6288,0,0,0,6288,6288,0,0,0,0,0
1428,pp1512,20151202,6288,6288,0,0,0,6288,6288,0,0,0,0,0
1429,pp1512,20151203,6288,6288,0,0,0,6288,6288,0,0,0,0,0
1430,pp1512,20151204,6288,6288,0,0,0,6288,6288,0,0,0,0,0
1431,pp1512,20151207,6288,6288,0,0,0,6288,6288,0,0,0,0,0
1432,pp1512,20151208,6288,6288,0,0,0,6288,6288,0,0,0,0,0
1433,pp1512,20151209,6288,6288,0,0,0,6288,6288,0,0,0,0,0
1434,pp1512,20151210,6288,6288,0,0,0,6288,6288,0,0,0,0,0
1435,pp1512,20151211,6288,6288,0,0,0,6288,6288,0,0,0,0,0
1436,pp1512,20151214,6288,6288,0,0,0,6288,6288,0,0,0,0,0
1437,pp1601,20150119,6978,6978,6887,6983,6825,6973,6895,-5,-83,2404,82883240,1702
1438,pp1601,20150120,6973,6895,7000,7000,6862,6891,6903,-4,8,1338,46186910,2786
1439,pp1601,20150121,6891,6903,6873,7000,6860,6959,6947,56,44,2004,69613380,3176
1440,pp1601,20150122,6959,6947,6999,7018,6895,6943,6949,-4,2,2280,79223650,4434
1441,pp1601,20150123,6943,6949,6905,6955,6891,6947,6931,-2,-18,1548,53653450,4874
1442,pp1601,20150126,6947,6931,6883,6900,6786,6820,6815,-111,-116,3794,129293910,7376
1443,pp1601,20150127,6820,6815,6820,6860,6818,6853,6838,38,23,1850,63259980,8310
1444,pp1601,20150128,6853,6838,6863,6960,6835,6960,6898,122,60,2016,69537550,9192
1445,pp1601,20150129,6960,6898,6899,6952,6893,6932,6923,34,25,1574,54489130,9158
1446,pp1601,20150130,6932,6923,6920,6920,6876,6887,6892,-36,-31,1488,51283780,9720
1447,pp1601,20150202,6887,6892,7046,7155,6998,7038,7036,146,144,5208,183236500,10716
1448,pp1601,20150203,7038,7036,7080,7282,7080,7275,7200,239,164,4752,171079160,11274
1449,pp1601,20150204,7275,7200,7340,7488,7340,7402,7431,202,231,6246,232098340,11756
1450,pp1601,20150205,7402,7431,7300,7370,7250,7315,7285,-116,-146,2420,88158470,12518
1451,pp1601,20150206,7315,7285,7380,7545,7380,7542,7495,257,210,7418,278004050,12358
1452,pp1601,20150209,7542,7495,7512,7554,7463,7524,7523,29,28,3922,147535660,13116
1453,pp1601,20150210,7524,7523,7511,7543,7506,7532,7518,9,-5,2750,103379530,13526
1454,pp1601,20150211,7532,7518,7497,7560,7470,7550,7518,32,0,1812,68113630,13550
1455,pp1601,20150212,7550,7518,7550,7559,7481,7537,7521,19,3,1556,58515680,13304
1456,pp1601,20150213,7537,7521,7630,7821,7600,7819,7741,298,220,5218,201977810,13486
1457,pp1601,20150216,7819,7741,7830,7875,7730,7837,7800,96,59,4220,164581360,13554
1458,pp1601,20150217,7837,7800,7841,7860,7725,7803,7776,3,-24,2922,113610310,13752
1459,pp1601,20150225,7803,7776,7715,7795,7601,7754,7694,-22,-82,5036,193738810,12230
1460,pp1601,20150226,7754,7694,7829,7947,7806,7945,7852,251,158,6084,238874200,12170
1461,pp1601,20150227,7945,7852,7852,7929,7836,7908,7887,56,35,5932,233949780,13932
1462,pp1601,20150302,7908,7887,8008,8197,7960,8082,8050,195,163,5902,237573140,16034
1463,pp1601,20150303,8082,8050,8070,8128,7951,7966,8009,-84,-41,5282,211535940,18888
1464,pp1601,20150304,7966,8009,8000,8003,7900,7964,7948,-45,-61,6324,251323720,17786
1465,pp1601,20150305,7964,7948,7905,7944,7770,7835,7879,-113,-69,6580,259219290,19050
1466,pp1601,20150306,7835,7879,7836,7888,7741,7751,7775,-128,-104,5404,210096750,19598
1467,pp1601,20150309,7751,7775,7687,7709,7560,7690,7630,-85,-145,5420,206778420,19638
1468,pp1601,20150310,7690,7630,7692,7749,7608,7610,7664,-20,34,4554,174509630,19580
1469,pp1601,20150311,7610,7664,7583,7638,7550,7574,7591,-90,-73,5264,199795970,20080
1470,pp1601,20150312,7574,7591,7584,7885,7583,7864,7756,273,165,7216,279850420,18666
1471,pp1601,20150313,7864,7756,7822,7926,7792,7889,7871,133,115,10036,395015570,18086
1472,pp1601,20150316,7889,7871,7788,7862,7687,7841,7791,-30,-80,9562,372502910,18024
1473,pp1601,20150317,7841,7791,7842,7888,7738,7787,7797,-4,6,10312,402014420,21832
1474,pp1601,20150318,7787,7797,7751,7775,7562,7574,7628,-223,-169,14804,564639160,29998
1475,pp1601,20150319,7574,7628,7641,7750,7600,7637,7689,9,61,10074,387305240,29996
1476,pp1601,20150320,7637,7689,7686,7721,7591,7625,7639,-64,-50,9690,370143460,31730
1477,pp1601,20150323,7625,7639,7725,7899,7724,7860,7830,221,191,20064,785543760,29838
1478,pp1601,20150324,7860,7830,7940,8050,7835,7920,7933,90,103,16764,664954400,31272
1479,pp1601,20150325,7920,7933,7822,7940,7822,7859,7885,-74,-48,10298,406007510,31870
1480,pp1601,20150326,7859,7885,8035,8035,7840,7951,7934,66,49,17042,676075440,36360
1481,pp1601,20150327,7951,7934,7918,7970,7856,7938,7918,4,-16,8960,354727690,36882
1482,pp1601,20150330,7938,7918,7850,7938,7820,7911,7869,-7,-49,8510,334853310,36826
1483,pp1601,20150331,7911,7869,7950,7974,7900,7931,7934,62,65,9086,360460930,36224
1484,pp1601,20150401,7931,7934,7900,8069,7860,8061,7975,127,41,13988,557833940,35356
1485,pp1601,20150402,8061,7975,8168,8188,8112,8158,8146,183,171,12936,526928520,37538
1486,pp1601,20150403,8158,8146,8121,8141,7821,7859,7961,-287,-185,19300,768256900,44566
1487,pp1601,20150407,7859,7961,7956,8004,7891,7930,7947,-31,-14,13172,523446770,48246
1488,pp1601,20150408,7930,7947,7964,8161,7934,8079,8057,132,110,19974,804730510,47554
1489,pp1601,20150409,8079,8057,8030,8030,7910,7994,7975,-63,-82,15956,636322700,51554
1490,pp1601,20150410,7994,7975,7950,8060,7941,7995,7999,20,24,13980,559139000,52046
1491,pp1601,20150413,7995,7999,8000,8131,8000,8010,8043,11,44,19536,785722140,53538
1492,pp1601,20150414,8010,8043,8039,8055,7937,8000,7997,-43,-46,23100,923665440,61670
1493,pp1601,20150415,8000,7997,8030,8039,7946,8001,7991,4,-6,17670,706073210,66846
1494,pp1601,20150416,8001,7991,8095,8310,8067,8259,8231,268,240,33402,1374749380,67390
1495,pp1601,20150417,8259,8231,8273,8450,8237,8347,8332,116,101,24980,1040684720,69170
1496,pp1601,20150420,8347,8332,8400,8492,8370,8385,8429,53,97,23812,1003557760,75924
1497,pp1601,20150421,8385,8429,8405,8428,8319,8361,8366,-68,-63,16682,697853900,76944
1498,pp1601,20150422,8361,8366,8340,8340,8227,8292,8279,-74,-87,29390,1216600370,89910
1499,pp1601,20150423,8292,8279,8338,8398,8302,8347,8354,68,75,15514,648074210,88940
1500,pp1601,20150424,8347,8354,8395,8462,8336,8375,8401,21,47,32448,1362988870,92420
1501,pp1601,20150427,8375,8401,8397,8609,8352,8546,8516,145,115,32998,1405130830,88960
1502,pp1601,20150428,8546,8516,8560,8600,8512,8559,8556,43,40,17040,729026730,91806
1503,pp1601,20150429,8559,8556,8570,8616,8435,8480,8530,-76,-26,27380,1167846470,91208
1504,pp1601,20150430,8480,8530,8554,8597,8525,8574,8569,44,39,16784,719113640,93006
1505,pp1601,20150504,8574,8569,8574,8661,8513,8558,8587,-11,18,23214,996715870,94286
1506,pp1601,20150505,8558,8587,8575,8575,8497,8531,8521,-56,-66,18698,796672040,97154
1507,pp1601,20150506,8531,8521,8620,8656,8507,8547,8584,26,63,25646,1100816120,97480
1508,pp1601,20150507,8547,8584,8488,8488,8371,8380,8416,-204,-168,23290,980115290,103502
1509,pp1601,20150508,8380,8416,8300,8306,8233,8285,8274,-131,-142,25780,1066611620,108706
1510,pp1601,20150511,8285,8274,8292,8353,8227,8242,8285,-32,11,30776,1274902460,117506
1511,pp1601,20150512,8242,8285,8235,8235,8107,8121,8155,-164,-130,25376,1034792160,121722
1512,pp1601,20150513,8121,8155,8182,8227,8129,8144,8173,-11,18,25864,1057010820,123846
1513,pp1601,20150514,8144,8173,8088,8160,8044,8150,8104,-23,-69,27380,1109489730,122204
1514,pp1601,20150515,8150,8104,8140,8213,8120,8195,8167,91,63,31516,1286960560,121632
1515,pp1601,20150518,8195,8167,8190,8190,8053,8077,8100,-90,-67,27744,1123754450,128398
1516,pp1601,20150519,8077,8100,8060,8063,7975,7976,8025,-124,-75,29312,1176231130,136738
1517,pp1601,20150520,7976,8025,7808,8015,7808,7965,7912,-60,-113,43150,1707021030,133072
1518,pp1601,20150521,7965,7912,8000,8130,7940,8096,8038,184,126,45894,1844532470,136290
1519,pp1601,20150522,8096,8038,8160,8160,8033,8102,8094,64,56,32710,1323919630,139226
1520,pp1601,20150525,8102,8094,8050,8093,8021,8077,8063,-17,-31,21788,878476010,137952
1521,pp1601,20150526,8077,8063,8130,8228,8019,8021,8125,-42,62,53080,2156472320,143866
1522,pp1601,20150527,8021,8125,8025,8044,7981,8029,8011,-96,-114,40604,1626464770,149848
1523,pp1601,20150528,8029,8011,8035,8050,7929,7977,7987,-34,-24,36456,1455898860,154858
1524,pp1601,20150529,7977,7987,7996,8034,7980,8004,8007,17,20,29748,1191069490,154456
1525,pp1601,20150601,8004,8007,8053,8141,7989,8001,8039,-6,32,25732,1034362740,156710
1526,pp1601,20150602,8001,8039,8018,8057,7960,8050,7995,11,-44,40636,1624593720,162984
1527,pp1601,20150603,8050,7995,8070,8109,8025,8075,8072,80,77,32180,1298890070,158234
1528,pp1601,20150604,8075,8072,8049,8145,8013,8120,8068,48,-4,36286,1463946170,156466
1529,pp1601,20150605,8120,8068,8090,8157,8070,8148,8120,80,52,37192,1510075240,155614
1530,pp1601,20150608,8148,8120,8166,8177,8077,8090,8107,-30,-13,29514,1196364530,161452
1531,pp1601,20150609,8090,8107,8100,8110,8065,8091,8090,-16,-17,25836,1045088540,166002
1532,pp1601,20150610,8091,8090,8136,8266,8126,8262,8174,172,84,42250,1726900090,162484
1533,pp1601,20150611,8262,8174,8216,8350,8208,8330,8297,156,123,56386,2339412650,159522
1534,pp1601,20150612,8330,8297,8255,8309,8224,8241,8271,-56,-26,29168,1206379740,157014
1535,pp1601,20150615,8241,8271,8216,8290,8187,8290,8225,19,-46,28832,1185850880,155862
1536,pp1601,20150616,8290,8225,8302,8430,8223,8258,8329,33,104,51514,2145483250,155086
1537,pp1601,20150617,8258,8329,8220,8289,8128,8128,8204,-201,-125,41756,1712949950,162118
1538,pp1601,20150618,8128,8204,8128,8170,8057,8130,8133,-74,-71,27948,1136506880,158528
1539,pp1601,20150619,8130,8133,8164,8225,8150,8195,8187,62,54,28828,1180168380,155050
1540,pp1601,20150623,8195,8187,8140,8242,8110,8198,8176,11,-11,34240,1399806630,151586
1541,pp1601,20150624,8198,8176,8211,8285,8185,8270,8235,94,59,35146,1447222150,148964
1542,pp1601,20150625,8270,8235,8245,8260,8215,8250,8239,15,4,34924,1438866490,148350
1543,pp1601,20150626,8250,8239,8248,8365,8240,8354,8302,115,63,46386,1925587110,143198
1544,pp1601,20150629,8354,8302,8371,8388,8151,8254,8244,-48,-58,57668,2377308790,143748
1545,pp1601,20150630,8254,8244,8230,8285,8181,8255,8226,11,-18,45064,1853522670,140786
1546,pp1601,20150701,8255,8226,8262,8324,8245,8275,8285,49,59,49754,2061227000,142922
1547,pp1601,20150702,8275,8285,8206,8295,8195,8285,8248,0,-37,28988,1195479250,139972
1548,pp1601,20150703,8285,8248,8276,8285,8226,8246,8252,-2,4,36530,1507353130,141048
1549,pp1601,20150706,8246,8252,8200,8220,7960,8020,8085,-232,-167,75550,3054148000,146424
1550,pp1601,20150707,8020,8085,7921,8015,7780,7824,7901,-261,-184,89086,3519680350,153714
1551,pp1601,20150708,7824,7901,7588,7693,7585,7585,7602,-316,-299,40238,1529549570,145482
1552,pp1601,20150709,7585,7602,7650,8055,7650,7996,7896,394,294,103658,4092494270,131008
1553,pp1601,20150710,7996,7896,7993,8127,7927,7986,8017,90,121,64770,2596542580,143710
1554,pp1601,20150713,7986,8017,7965,7969,7803,7886,7897,-131,-120,54066,2134906490,145396
1555,pp1601,20150714,7886,7897,7871,7984,7831,7832,7913,-65,16,63628,2517499820,149844
1556,pp1601,20150715,7832,7913,7922,7983,7838,7866,7879,-47,-34,61402,2419128220,152738
1557,pp1601,20150716,7866,7879,7830,7830,7700,7768,7754,-111,-125,78572,3046426320,158312
1558,pp1601,20150717,7768,7754,7710,7794,7709,7773,7753,19,-1,43776,1697091690,159880
1559,pp1601,20150720,7773,7753,7774,7820,7738,7816,7772,63,19,39968,1553162030,157454
1560,pp1601,20150721,7816,7772,7800,7810,7717,7791,7762,19,-10,51062,1981961270,163756
1561,pp1601,20150722,7791,7762,7780,7896,7771,7884,7829,122,67,83406,3265106840,156024
1562,pp1601,20150723,7884,7829,7850,7880,7818,7844,7850,15,21,60142,2360752280,151328
1563,pp1601,20150724,7844,7850,7800,7810,7647,7648,7716,-202,-134,118778,4582464610,154650
1564,pp1601,20150727,7648,7716,7720,7720,7412,7470,7491,-246,-225,199686,7479655580,171586
1565,pp1601,20150728,7470,7491,7413,7626,7369,7581,7522,90,31,147576,5550801930,168882
1566,pp1601,20150729,7581,7522,7700,7705,7596,7634,7661,112,139,105808,4053096740,164398
1567,pp1601,20150730,7634,7661,7694,7712,7574,7577,7659,-84,-2,105364,4035014730,173484
1568,pp1601,20150731,7577,7659,7535,7610,7531,7567,7565,-92,-94,92524,3500098620,171024
1569,pp1601,20150803,7567,7565,7500,7519,7300,7394,7389,-171,-176,206202,7618170010,194840
1570,pp1601,20150804,7394,7389,7330,7498,7286,7488,7386,99,-3,221662,8186425250,190856
1571,pp1601,20150805,7488,7386,7533,7560,7430,7553,7492,167,106,218010,8167113530,188612
1572,pp1601,20150806,7553,7492,7499,7550,7436,7482,7491,-10,-1,266824,9994873880,209390
1573,pp1601,20150807,7482,7491,7480,7620,7373,7607,7505,116,14,329454,12363497280,218532
1574,pp1601,20150810,7607,7505,7580,7698,7536,7688,7618,183,113,336920,12834628770,226844
1575,pp1601,20150811,7688,7618,7750,7922,7748,7896,7874,278,256,553286,21783546920,226260
1576,pp1601,20150812,7896,7874,7870,7929,7821,7898,7880,24,6,405254,15968834800,217438
1577,pp1601,20150813,7898,7880,7910,7945,7804,7911,7859,31,-21,358884,14102587080,227930
1578,pp1601,20150814,7911,7859,7831,8008,7831,7913,7934,54,75,647010,25667151700,252664
1579,pp1601,20150817,7913,7934,7900,7917,7730,7746,7806,-188,-128,507074,19792661320,230436
1580,pp1601,20150818,7746,7806,7735,7774,7588,7640,7650,-166,-156,522864,20000693640,223498
1581,pp1601,20150819,7640,7650,7660,7745,7626,7701,7691,51,41,597716,22986106850,221950
1582,pp1601,20150820,7701,7691,7619,7676,7525,7650,7593,-41,-98,570184,21649250750,223478
1583,pp1601,20150821,7650,7593,7683,7760,7604,7617,7653,24,60,480488,18387214000,225626
1584,pp1601,20150824,7617,7653,7500,7505,7347,7347,7403,-306,-250,486910,18024153700,236070
1585,pp1601,20150825,7347,7403,7248,7455,7195,7359,7364,-44,-39,499310,18384891470,222590
1586,pp1601,20150826,7359,7364,7440,7447,7313,7364,7371,0,7,407654,15024290420,228572
1587,pp1601,20150827,7364,7371,7400,7474,7361,7467,7423,96,52,491752,18253416940,231610
1588,pp1601,20150828,7467,7423,7710,7719,7600,7628,7665,205,242,471652,18076591370,220482
1589,pp1601,20150831,7628,7665,7655,7658,7531,7551,7575,-114,-90,388692,14723163950,228256
1590,pp1601,20150901,7551,7575,7720,7720,7632,7678,7672,103,97,464922,17835385080,222958
1591,pp1601,20150902,7678,7672,7551,7651,7541,7632,7610,-40,-62,426118,16215508250,218276
1592,pp1601,20150907,7632,7610,7660,7798,7601,7643,7706,33,96,533666,20562670420,239528
1593,pp1601,20150908,7643,7706,7605,7645,7493,7582,7558,-124,-148,685694,25912931430,238844
1594,pp1601,20150909,7582,7558,7680,7729,7626,7630,7673,72,115,741058,28431108210,237078
1595,pp1601,20150910,7630,7673,7557,7622,7472,7622,7537,-51,-136,928298,34984926380,274002
1596,pp1601,20150911,7622,7537,7644,7676,7576,7595,7625,58,88,840514,32045054540,291928
1597,pp1601,20150914,7595,7625,7598,7654,7509,7516,7586,-109,-39,693352,26300740850,301046
1598,pp1601,20150915,7516,7586,7505,7533,7393,7430,7447,-156,-139,805132,29980903120,336244
1599,pp1601,20150916,7430,7447,7490,7502,7374,7436,7421,-11,-26,981924,36434602590,350524
1600,pp1601,20150917,7436,7421,7500,7514,7336,7343,7437,-78,16,1042884,38782674060,398752
1601,pp1601,20150918,7343,7437,7367,7408,7305,7340,7363,-97,-74,1164916,42887209960,379826
1602,pp1601,20150921,7340,7363,7301,7428,7293,7426,7370,63,7,971442,35800348060,360238
1603,pp1601,20150922,7426,7370,7429,7429,7343,7363,7374,-7,4,776358,28626732870,351844
1604,pp1601,20150923,7363,7374,7375,7394,7291,7380,7342,6,-32,1023354,37567439190,344794
1605,pp1601,20150924,7380,7342,7300,7349,7273,7313,7311,-29,-31,910516,33285122560,366472
1606,pp1601,20150925,7313,7311,7337,7344,7216,7216,7282,-95,-29,1022434,37228391610,395452
1607,pp1601,20150928,7216,7282,7205,7249,7168,7178,7215,-104,-67,844070,30450286960,367142
1608,pp1601,20150929,7178,7215,7158,7168,6997,7081,7055,-134,-160,857968,30265404990,336898
1609,pp1601,20150930,7081,7055,7055,7095,7030,7088,7064,33,9,572638,20227138950,323876
1610,pp1601,20151008,7088,7064,7210,7259,7154,7194,7187,130,123,494458,17769045930,310372
1611,pp1601,20151009,7194,7187,7225,7470,7217,7426,7350,239,163,936508,34416793620,305496
1612,pp1601,20151012,7426,7350,7397,7417,7355,7388,7386,38,36,587578,21700677580,306264
1613,pp1601,20151013,7388,7386,7300,7316,7248,7292,7280,-94,-106,604678,22012933950,300282
1614,pp1601,20151014,7292,7280,7260,7332,7233,7248,7279,-32,-1,723040,26318145430,305668
1615,pp1601,20151015,7248,7279,7237,7279,7214,7214,7244,-65,-35,731592,26500375290,314892
1616,pp1601,20151016,7214,7244,7237,7240,7136,7139,7176,-105,-68,769518,27611921080,336958
1617,pp1601,20151019,7139,7176,7152,7169,7065,7098,7109,-78,-67,722434,25679041010,353156
1618,pp1601,20151020,7098,7109,7080,7142,7052,7141,7093,32,-16,771580,27365512040,341440
1619,pp1601,20151021,7141,7093,7120,7132,7061,7102,7097,9,4,820340,29109918200,365324
1620,pp1601,20151022,7102,7097,7110,7212,7105,7157,7171,60,74,923232,33103990740,367596
1621,pp1601,20151023,7157,7171,7146,7168,7021,7079,7085,-92,-86,934156,33094901520,378148
1622,pp1601,20151026,7079,7085,7059,7059,6965,6984,6998,-101,-87,1004494,35149738480,400364
1623,pp1601,20151027,6984,6998,6965,7000,6912,6973,6954,-25,-44,788244,27407629420,391368
1624,pp1601,20151028,6973,6954,6988,6991,6927,6963,6950,9,-4,688002,23911049720,381042
1625,pp1601,20151029,6963,6950,7036,7055,6944,6946,6989,-4,39,645244,22548996830,399584
1626,pp1601,20151030,6946,6989,6935,6941,6810,6842,6868,-147,-121,895076,30738434600,428352
1627,pp1601,20151102,6842,6868,6852,6928,6832,6865,6873,-3,5,783608,26930093240,417940
1628,pp1601,20151103,6865,6873,6855,6865,6755,6780,6793,-93,-80,875844,29752324010,435944
1629,pp1601,20151104,6780,6793,6810,6873,6773,6824,6819,31,26,1096552,37391680850,415862
1630,pp1601,20151105,6824,6819,6750,6774,6627,6641,6692,-178,-127,1131482,37859876300,439720
1631,pp1601,20151106,6641,6692,6627,6695,6607,6655,6651,-37,-41,1029888,34253818910,407236
1632,pp1601,20151109,6655,6651,6620,6685,6600,6620,6639,-31,-12,845808,28078550460,408720
1633,pp1601,20151110,6620,6639,6610,6610,6482,6519,6527,-120,-112,932452,30432696670,415748
1634,pp1601,20151111,6519,6527,6530,6542,6462,6498,6502,-29,-25,919940,29911397970,379736
1635,pp1601,20151112,6498,6502,6490,6520,6451,6471,6490,-31,-12,821988,26676326470,366526
1636,pp1601,20151113,6471,6490,6447,6461,6263,6303,6353,-187,-137,1241032,39427254710,395702
1637,pp1601,20151116,6303,6353,6291,6333,6179,6181,6264,-172,-89,1120294,35090124630,410182
1638,pp1601,20151117,6181,6264,6204,6215,6075,6177,6157,-87,-107,1582158,48707705290,411880
1639,pp1601,20151118,6177,6157,6158,6198,6085,6183,6152,26,-5,1361362,41882170070,365448
1640,pp1601,20151119,6183,6152,6180,6238,6137,6157,6181,5,29,1387652,42885985560,356562
1641,pp1601,20151120,6157,6181,6177,6208,5934,5934,6021,-247,-160,1586614,47767684030,360016
1642,pp1601,20151123,5934,6021,5915,5932,5670,5734,5759,-287,-262,1625038,46795456400,336652
1643,pp1601,20151124,5734,5759,5751,5984,5750,5960,5878,201,119,1782796,52399752780,306958
1644,pp1601,20151125,5960,5878,6030,6052,5882,6015,5984,137,106,1584738,47420060700,267712
1645,pp1601,20151126,6015,5984,6042,6223,6010,6223,6164,239,180,1062912,32759801840,233368
1646,pp1601,20151127,6223,6164,6255,6341,6187,6304,6262,140,98,958646,30019365140,168484
1647,pp1601,20151130,6304,6262,6252,6329,6205,6328,6269,66,7,421158,13201449530,145114
1648,pp1601,20151201,6328,6269,6312,6534,6260,6504,6427,235,158,429136,13791286400,134682
1649,pp1601,20151202,6504,6427,6510,6568,6442,6480,6496,53,69,172754,5611171250,127372
1650,pp1601,20151203,6480,6496,6420,6524,6380,6502,6461,6,-35,144070,4654551070,113066
1651,pp1601,20151204,6502,6461,6510,6560,6425,6441,6479,-20,18,144506,4681901390,96022
1652,pp1601,20151207,6441,6479,6425,6456,6360,6436,6427,-43,-52,97336,3128206690,78320
1653,pp1601,20151208,6436,6427,6400,6400,6148,6182,6234,-245,-193,147002,4582496370,68586
1654,pp1601,20151209,6182,6234,6250,6253,6100,6166,6180,-68,-54,90574,2799104840,62830
1655,pp1601,20151210,6166,6180,6122,6132,6008,6080,6062,-100,-118,100806,3055611890,63094
1656,pp1601,20151211,6080,6062,6052,6080,6005,6037,6031,-25,-31,75438,2275046430,62488
1657,pp1601,20151214,6037,6031,5950,5996,5875,5975,5948,-56,-83,78456,2333306720,55968
1658,pp1601,20151215,5975,5948,6011,6043,5974,6037,6009,89,61,39626,1190741060,54652
1659,pp1601,20151216,6037,6009,6037,6130,6022,6128,6086,119,77,47342,1440638190,49786
1660,pp1601,20151217,6128,6086,6102,6195,6100,6108,6156,22,70,41142,1266365850,45684
1661,pp1601,20151218,6108,6156,6102,6126,6021,6118,6080,-38,-76,27584,838620130,41792
1662,pp1601,20151221,6118,6080,6166,6196,6081,6196,6143,116,63,15218,467468580,35024
1663,pp1601,20151222,6196,6143,6162,6245,6145,6210,6197,67,54,17036,527928250,29654
1664,pp1601,20151223,6210,6197,6225,6269,6160,6261,6199,64,2,10506,325657970,25792
1665,pp1601,20151224,6261,6199,6288,6508,6268,6495,6444,296,245,25898,834550530,19704
1666,pp1601,20151225,6495,6444,6499,6520,6410,6497,6481,53,37,14570,472199600,17216
1667,pp1601,20151228,6497,6481,6492,6495,6430,6430,6451,-51,-30,6562,211675850,14766
1668,pp1601,20151229,6430,6451,6421,6421,6358,6393,6382,-58,-69,6678,213106420,12084
1669,pp1601,20151230,6393,6382,6437,6445,6364,6386,6397,4,15,3766,120460000,9330
1670,pp1601,20151231,6386,6397,6371,6444,6370,6389,6401,-8,4,5068,162209010,5686
1671,pp1602,20150216,7521,7521,7578,7578,7577,7577,7577,56,56,4,151550,4
1672,pp1602,20150217,7577,7577,7529,7529,7529,7529,7529,-48,-48,2,75290,4
1673,pp1602,20150225,7529,7529,0,0,0,7529,7529,0,0,0,0,4
1674,pp1602,20150226,7529,7529,7830,7830,7830,7830,7830,301,301,2,78300,4
1675,pp1602,20150227,7830,7830,7777,7783,7777,7783,7780,-47,-50,4,155600,6
1676,pp1602,20150302,7783,7780,8030,8091,7889,7889,8046,109,266,12,482810,14
1677,pp1602,20150303,7889,8046,7969,7969,7969,7969,7969,-77,-77,2,79690,16
1678,pp1602,20150304,7969,7969,7914,7914,7914,7914,7914,-55,-55,2,79140,16
1679,pp1602,20150305,7914,7914,7885,7912,7821,7859,7868,-55,-46,46,1809860,48
1680,pp1602,20150306,7859,7868,7837,7853,7807,7807,7832,-61,-36,6,234970,46
1681,pp1602,20150309,7807,7832,7586,7761,7586,7761,7629,-71,-203,8,305190,50
1682,pp1602,20150310,7761,7629,7711,7726,7665,7726,7701,97,72,18,693140,40
1683,pp1602,20150311,7726,7701,7696,7696,7650,7650,7662,-51,-39,20,766290,46
1684,pp1602,20150312,7650,7662,7791,7828,7791,7828,7809,166,147,8,312390,40
1685,pp1602,20150313,7828,7809,7898,7898,7898,7898,7898,89,89,4,157960,40
1686,pp1602,20150316,7898,7898,7879,7879,7851,7856,7866,-42,-32,8,314650,40
1687,pp1602,20150317,7856,7866,0,0,0,7860,7860,-6,-6,0,0,40
1688,pp1602,20150318,7860,7860,0,0,0,7661,7661,-199,-199,0,0,40
1689,pp1602,20150319,7661,7661,0,0,0,7661,7661,0,0,0,0,40
1690,pp1602,20150320,7661,7661,0,0,0,7661,7661,0,0,0,0,40
1691,pp1602,20150323,7661,7661,0,0,0,7876,7876,215,215,0,0,40
1692,pp1602,20150324,7876,7876,0,0,0,7901,7901,25,25,0,0,40
1693,pp1602,20150325,7901,7901,7890,7908,7890,7908,7902,7,1,6,237060,42
1694,pp1602,20150326,7908,7902,0,0,0,7902,7902,0,0,0,0,42
1695,pp1602,20150327,7902,7902,0,0,0,7914,7914,12,12,0,0,42
1696,pp1602,20150330,7914,7914,0,0,0,7866,7866,-48,-48,0,0,42
1697,pp1602,20150331,7866,7866,0,0,0,7950,7950,84,84,0,0,42
1698,pp1602,20150401,7950,7950,0,0,0,7991,7991,41,41,0,0,42
1699,pp1602,20150402,7991,7991,8141,8194,8141,8194,8144,203,153,34,1384500,14
1700,pp1602,20150403,8194,8144,7868,7869,7868,7869,7868,-275,-276,4,157370,14
1701,pp1602,20150407,7869,7868,0,0,0,7868,7868,0,0,0,0,14
1702,pp1602,20150408,7868,7868,0,0,0,8033,8033,165,165,0,0,14
1703,pp1602,20150409,8033,8033,0,0,0,8018,8018,-15,-15,0,0,14
1704,pp1602,20150410,8018,8018,0,0,0,8018,8018,0,0,0,0,14
1705,pp1602,20150413,8018,8018,0,0,0,8018,8018,0,0,0,0,14
1706,pp1602,20150414,8018,8018,0,0,0,8018,8018,0,0,0,0,14
1707,pp1602,20150415,8018,8018,0,0,0,8018,8018,0,0,0,0,14
1708,pp1602,20150416,8018,8018,0,0,0,8222,8222,204,204,0,0,14
1709,pp1602,20150417,8222,8222,0,0,0,8307,8307,85,85,0,0,14
1710,pp1602,20150420,8307,8307,0,0,0,8309,8309,2,2,0,0,14
1711,pp1602,20150421,8309,8309,0,0,0,8309,8309,0,0,0,0,14
1712,pp1602,20150422,8309,8309,0,0,0,8223,8223,-86,-86,0,0,14
1713,pp1602,20150423,8223,8223,0,0,0,8243,8243,20,20,0,0,14
1714,pp1602,20150424,8243,8243,0,0,0,8289,8289,46,46,0,0,14
1715,pp1602,20150427,8289,8289,0,0,0,8402,8402,113,113,0,0,14
1716,pp1602,20150428,8402,8402,0,0,0,8522,8522,120,120,0,0,14
1717,pp1602,20150429,8522,8522,0,0,0,8512,8512,-10,-10,0,0,14
1718,pp1602,20150430,8512,8512,0,0,0,8550,8550,38,38,0,0,14
1719,pp1602,20150504,8550,8550,0,0,0,8567,8567,17,17,0,0,14
1720,pp1602,20150505,8567,8567,8496,8496,8496,8496,8496,-71,-71,2,84960,14
1721,pp1602,20150506,8496,8496,0,0,0,8558,8558,62,62,0,0,14
1722,pp1602,20150507,8558,8558,0,0,0,8391,8391,-167,-167,0,0,14
1723,pp1602,20150508,8391,8391,0,0,0,8250,8250,-141,-141,0,0,14
1724,pp1602,20150511,8250,8250,0,0,0,8260,8260,10,10,0,0,14
1725,pp1602,20150512,8260,8260,0,0,0,8131,8131,-129,-129,0,0,14
1726,pp1602,20150513,8131,8131,0,0,0,8148,8148,17,17,0,0,14
1727,pp1602,20150514,8148,8148,0,0,0,8080,8080,-68,-68,0,0,14
1728,pp1602,20150515,8080,8080,0,0,0,8142,8142,62,62,0,0,14
1729,pp1602,20150518,8142,8142,0,0,0,8076,8076,-66,-66,0,0,14
1730,pp1602,20150519,8076,8076,0,0,0,8018,8018,-58,-58,0,0,14
1731,pp1602,20150520,8018,8018,0,0,0,7906,7906,-112,-112,0,0,14
1732,pp1602,20150521,7906,7906,0,0,0,8031,8031,125,125,0,0,14
1733,pp1602,20150522,8031,8031,0,0,0,8086,8086,55,55,0,0,14
1734,pp1602,20150525,8086,8086,0,0,0,8056,8056,-30,-30,0,0,14
1735,pp1602,20150526,8056,8056,8160,8160,8160,8160,8160,104,104,2,81600,12
1736,pp1602,20150527,8160,8160,0,0,0,8046,8046,-114,-114,0,0,12
1737,pp1602,20150528,8046,8046,0,0,0,8022,8022,-24,-24,0,0,12
1738,pp1602,20150529,8022,8022,0,0,0,8042,8042,20,20,0,0,12
1739,pp1602,20150601,8042,8042,0,0,0,8074,8074,32,32,0,0,12
1740,pp1602,20150602,8074,8074,0,0,0,8030,8030,-44,-44,0,0,12
1741,pp1602,20150603,8030,8030,0,0,0,8107,8107,77,77,0,0,12
1742,pp1602,20150604,8107,8107,0,0,0,8103,8103,-4,-4,0,0,12
1743,pp1602,20150605,8103,8103,0,0,0,8155,8155,52,52,0,0,12
1744,pp1602,20150608,8155,8155,0,0,0,8142,8142,-13,-13,0,0,12
1745,pp1602,20150609,8142,8142,8098,8098,8032,8032,8065,-110,-77,4,161300,10
1746,pp1602,20150610,8032,8065,0,0,0,8157,8157,92,92,0,0,10
1747,pp1602,20150611,8157,8157,0,0,0,8279,8279,122,122,0,0,10
1748,pp1602,20150612,8279,8279,0,0,0,8254,8254,-25,-25,0,0,10
1749,pp1602,20150615,8254,8254,0,0,0,8209,8209,-45,-45,0,0,10
1750,pp1602,20150616,8209,8209,8370,8370,8370,8370,8370,161,161,2,83700,12
1751,pp1602,20150617,8370,8370,0,0,0,8245,8245,-125,-125,0,0,12
1752,pp1602,20150618,8245,8245,0,0,0,8168,8168,-77,-77,0,0,12
1753,pp1602,20150619,8168,8168,0,0,0,8222,8222,54,54,0,0,12
1754,pp1602,20150623,8222,8222,0,0,0,8211,8211,-11,-11,0,0,12
1755,pp1602,20150624,8211,8211,0,0,0,8270,8270,59,59,0,0,12
1756,pp1602,20150625,8270,8270,0,0,0,8274,8274,4,4,0,0,12
1757,pp1602,20150626,8274,8274,0,0,0,8337,8337,63,63,0,0,12
1758,pp1602,20150629,8337,8337,0,0,0,8279,8279,-58,-58,0,0,12
1759,pp1602,20150630,8279,8279,0,0,0,8261,8261,-18,-18,0,0,12
1760,pp1602,20150701,8261,8261,0,0,0,8320,8320,59,59,0,0,12
1761,pp1602,20150702,8320,8320,8218,8218,8218,8218,8218,-102,-102,2,82180,10
1762,pp1602,20150703,8218,8218,8279,8279,8279,8279,8279,61,61,2,82790,12
1763,pp1602,20150706,8279,8279,8013,8013,8013,8013,8013,-266,-266,8,320520,12
1764,pp1602,20150707,8013,8013,0,0,0,7831,7831,-182,-182,0,0,12
1765,pp1602,20150708,7831,7831,7608,7608,7608,7608,7608,-223,-223,2,76080,14
1766,pp1602,20150709,7608,7608,7912,7912,7912,7912,7912,304,304,2,79120,12
1767,pp1602,20150710,7912,7912,0,0,0,8033,8033,121,121,0,0,12
1768,pp1602,20150713,8033,8033,0,0,0,7913,7913,-120,-120,0,0,12
1769,pp1602,20150714,7913,7913,0,0,0,7929,7929,16,16,0,0,12
1770,pp1602,20150715,7929,7929,0,0,0,7895,7895,-34,-34,0,0,12
1771,pp1602,20150716,7895,7895,0,0,0,7770,7770,-125,-125,0,0,12
1772,pp1602,20150717,7770,7770,0,0,0,7769,7769,-1,-1,0,0,12
1773,pp1602,20150720,7769,7769,0,0,0,7788,7788,19,19,0,0,12
1774,pp1602,20150721,7788,7788,0,0,0,7778,7778,-10,-10,0,0,12
1775,pp1602,20150722,7778,7778,0,0,0,7845,7845,67,67,0,0,12
1776,pp1602,20150723,7845,7845,0,0,0,7866,7866,21,21,0,0,12
1777,pp1602,20150724,7866,7866,0,0,0,7732,7732,-134,-134,0,0,12
1778,pp1602,20150727,7732,7732,0,0,0,7732,7732,0,0,0,0,12
1779,pp1602,20150728,7732,7732,0,0,0,7763,7763,31,31,0,0,12
1780,pp1602,20150729,7763,7763,0,0,0,7906,7906,143,143,0,0,12
1781,pp1602,20150730,7906,7906,0,0,0,7904,7904,-2,-2,0,0,12
1782,pp1602,20150731,7904,7904,0,0,0,7807,7807,-97,-97,0,0,12
1783,pp1602,20150803,7807,7807,0,0,0,7495,7495,-312,-312,0,0,12
1784,pp1602,20150804,7495,7495,0,0,0,7492,7492,-3,-3,0,0,12
1785,pp1602,20150805,7492,7492,0,0,0,7599,7599,107,107,0,0,12
1786,pp1602,20150806,7599,7599,0,0,0,7598,7598,-1,-1,0,0,12
1787,pp1602,20150807,7598,7598,0,0,0,7612,7612,14,14,0,0,12
1788,pp1602,20150810,7612,7612,0,0,0,7726,7726,114,114,0,0,12
1789,pp1602,20150811,7726,7726,0,0,0,7985,7985,259,259,0,0,12
1790,pp1602,20150812,7985,7985,0,0,0,7991,7991,6,6,0,0,12
1791,pp1602,20150813,7991,7991,0,0,0,7970,7970,-21,-21,0,0,12
1792,pp1602,20150814,7970,7970,0,0,0,8046,8046,76,76,0,0,12
1793,pp1602,20150817,8046,8046,0,0,0,7917,7917,-129,-129,0,0,12
1794,pp1602,20150818,7917,7917,0,0,0,7759,7759,-158,-158,0,0,12
1795,pp1602,20150819,7759,7759,7692,7692,7690,7690,7691,-69,-68,4,153820,10
1796,pp1602,20150820,7690,7691,7596,7596,7507,7507,7553,-184,-138,12,453180,8
1797,pp1602,20150821,7507,7553,0,0,0,7612,7612,59,59,0,0,8
1798,pp1602,20150824,7612,7612,7372,7372,7372,7372,7372,-240,-240,2,73720,8
1799,pp1602,20150825,7372,7372,7184,7447,7184,7447,7271,75,-101,6,218150,8
1800,pp1602,20150826,7447,7271,0,0,0,7277,7277,6,6,0,0,8
1801,pp1602,20150827,7277,7277,0,0,0,7328,7328,51,51,0,0,8
1802,pp1602,20150828,7328,7328,7620,7620,7581,7581,7600,253,272,4,152010,8
1803,pp1602,20150831,7581,7600,7642,7642,7642,7642,7642,42,42,2,76420,8
1804,pp1602,20150901,7642,7642,0,0,0,7739,7739,97,97,0,0,8
1805,pp1602,20150902,7739,7739,0,0,0,7677,7677,-62,-62,0,0,8
1806,pp1602,20150907,7677,7677,0,0,0,7773,7773,96,96,0,0,8
1807,pp1602,20150908,7773,7773,0,0,0,7624,7624,-149,-149,0,0,8
1808,pp1602,20150909,7624,7624,0,0,0,7740,7740,116,116,0,0,8
1809,pp1602,20150910,7740,7740,7542,7542,7486,7486,7514,-254,-226,8,300560,8
1810,pp1602,20150911,7486,7514,0,0,0,7601,7601,87,87,0,0,8
1811,pp1602,20150914,7601,7601,7615,7615,7505,7505,7574,-96,-27,12,454440,8
1812,pp1602,20150915,7505,7574,0,0,0,7436,7436,-138,-138,0,0,8
1813,pp1602,20150916,7436,7436,7476,7476,7400,7400,7438,-36,2,4,148760,8
1814,pp1602,20150917,7400,7438,7454,7454,7390,7392,7395,-46,-43,34,1257240,34
1815,pp1602,20150918,7392,7395,7285,7285,7285,7285,7285,-110,-110,30,1092750,4
1816,pp1602,20150921,7285,7285,7225,7374,7225,7374,7299,89,14,4,145990,4
1817,pp1602,20150922,7374,7299,0,0,0,7302,7302,3,3,0,0,4
1818,pp1602,20150923,7302,7302,7301,7301,7301,7301,7301,-1,-1,20,730100,24
1819,pp1602,20150924,7301,7301,0,0,0,7271,7271,-30,-30,0,0,24
1820,pp1602,20150925,7271,7271,0,0,0,7243,7243,-28,-28,0,0,24
1821,pp1602,20150928,7243,7243,7222,7222,7222,7222,7222,-21,-21,2,72220,22
1822,pp1602,20150929,7222,7222,0,0,0,7062,7062,-160,-160,0,0,22
1823,pp1602,20150930,7062,7062,0,0,0,7071,7071,9,9,0,0,22
1824,pp1602,20151008,7071,7071,0,0,0,7194,7194,123,123,0,0,22
1825,pp1602,20151009,7194,7194,0,0,0,7357,7357,163,163,0,0,22
1826,pp1602,20151012,7357,7357,0,0,0,7393,7393,36,36,0,0,22
1827,pp1602,20151013,7393,7393,7393,7393,7247,7247,7320,-146,-73,4,146400,22
1828,pp1602,20151014,7247,7320,0,0,0,7319,7319,-1,-1,0,0,22
1829,pp1602,20151015,7319,7319,7209,7281,7209,7281,7245,-38,-74,4,144900,20
1830,pp1602,20151016,7281,7245,0,0,0,7177,7177,-68,-68,0,0,20
1831,pp1602,20151019,7177,7177,0,0,0,7110,7110,-67,-67,0,0,20
1832,pp1602,20151020,7110,7110,0,0,0,7110,7110,0,0,0,0,20
1833,pp1602,20151021,7110,7110,7073,7117,7023,7117,7060,7,-50,44,1553400,22
1834,pp1602,20151022,7117,7060,6974,7176,6974,7143,7145,83,85,84,3000910,24
1835,pp1602,20151023,7143,7145,7156,7156,7156,7156,7156,11,11,20,715600,22
1836,pp1602,20151026,7156,7156,0,0,0,7069,7069,-87,-87,0,0,22
1837,pp1602,20151027,7069,7069,6951,6993,6951,6993,6972,-76,-97,8,278880,26
1838,pp1602,20151028,6993,6972,0,0,0,6968,6968,-4,-4,0,0,26
1839,pp1602,20151029,6968,6968,7011,7011,7002,7002,7005,34,37,18,630530,26
1840,pp1602,20151030,7002,7005,0,0,0,6884,6884,-121,-121,0,0,26
1841,pp1602,20151102,6884,6884,0,0,0,6889,6889,5,5,0,0,26
1842,pp1602,20151103,6889,6889,6845,6845,6826,6826,6838,-63,-51,6,205160,26
1843,pp1602,20151104,6826,6838,6890,6896,6890,6896,6893,58,55,4,137860,30
1844,pp1602,20151105,6896,6893,6656,6743,6656,6724,6704,-169,-189,54,1810300,42
1845,pp1602,20151106,6724,6704,0,0,0,6663,6663,-41,-41,0,0,42
1846,pp1602,20151109,6663,6663,6686,6686,6686,6686,6686,23,23,8,267440,42
1847,pp1602,20151110,6686,6686,6687,6701,6638,6638,6683,-48,-3,14,467860,42
1848,pp1602,20151111,6638,6683,0,0,0,6658,6658,-25,-25,0,0,42
1849,pp1602,20151112,6658,6658,6608,6765,6392,6509,6583,-149,-75,84,2765200,42
1850,pp1602,20151113,6509,6583,6507,6523,6416,6416,6482,-167,-101,14,453750,42
1851,pp1602,20151116,6416,6482,6380,6470,6267,6267,6348,-215,-134,32,1015740,54
1852,pp1602,20151117,6267,6348,6100,6542,6100,6250,6302,-98,-46,82,2583970,86
1853,pp1602,20151118,6250,6302,6169,6169,6169,6169,6169,-133,-133,2,61690,86
1854,pp1602,20151119,6169,6169,6280,6300,6248,6248,6276,79,107,6,188280,86
1855,pp1602,20151120,6248,6276,6299,6299,6025,6025,6156,-251,-120,38,1169660,86
1856,pp1602,20151123,6025,6156,5947,5947,5911,5923,5924,-233,-232,26,770220,92
1857,pp1602,20151124,5923,5924,5862,6059,5862,6059,5925,135,1,22,651770,86
1858,pp1602,20151125,6059,5925,5985,6058,5900,6055,5976,130,51,20,597610,86
1859,pp1602,20151126,6055,5976,6134,6215,6061,6213,6207,237,231,474,14712940,82
1860,pp1602,20151127,6213,6207,6288,6384,6288,6370,6370,163,163,22,700760,80
1861,pp1602,20151130,6370,6370,0,0,0,6370,6370,0,0,0,0,80
1862,pp1602,20151201,6370,6370,6288,6570,6288,6530,6461,160,91,30,969210,86
1863,pp1602,20151202,6530,6461,0,0,0,6461,6461,0,0,0,0,86
1864,pp1602,20151203,6461,6461,6500,6600,6356,6497,6489,36,28,50,1622280,58
1865,pp1602,20151204,6497,6489,6353,6450,6353,6448,6425,-41,-64,16,514070,66
1866,pp1602,20151207,6448,6425,6400,6400,6400,6400,6400,-25,-25,2,64000,66
1867,pp1602,20151208,6400,6400,6240,6248,6102,6102,6209,-298,-191,8,248380,66
1868,pp1602,20151209,6102,6209,6386,6386,6190,6190,6216,-19,7,26,808160,86
1869,pp1602,20151210,6190,6216,6200,6200,6051,6051,6149,-165,-67,16,491920,86
1870,pp1602,20151211,6051,6149,6149,6150,6149,6150,6149,1,0,4,122990,86
1871,pp1602,20151214,6150,6149,0,0,0,6065,6065,-84,-84,0,0,86
1872,pp1602,20151215,6065,6065,6065,6065,6065,6065,6065,0,0,2,60650,86
1873,pp1602,20151216,6065,6065,0,0,0,6065,6065,0,0,0,0,86
1874,pp1602,20151217,6065,6065,0,0,0,6065,6065,0,0,0,0,86
1875,pp1602,20151218,6065,6065,0,0,0,6065,6065,0,0,0,0,86
1876,pp1602,20151221,6065,6065,0,0,0,6065,6065,0,0,0,0,86
1877,pp1602,20151222,6065,6065,6366,6366,6116,6116,6199,51,134,6,185980,86
1878,pp1602,20151223,6116,6199,6125,6269,6125,6269,6224,70,25,148,4606240,86
1879,pp1602,20151224,6269,6224,6449,6498,6231,6410,6389,186,165,18,575040,80
1880,pp1602,20151225,6410,6389,0,0,0,6389,6389,0,0,0,0,80
1881,pp1602,20151228,6389,6389,0,0,0,6389,6389,0,0,0,0,80
1882,pp1602,20151229,6389,6389,6499,6499,6430,6451,6473,62,84,78,2524780,90
1883,pp1602,20151230,6451,6473,6476,6480,6450,6480,6469,7,-4,14,452890,92
1884,pp1602,20151231,6480,6469,6479,6479,6461,6461,6476,-8,7,12,388560,102
1885,pp1603,20150316,7756,7756,0,0,0,7725,7725,-31,-31,0,0,0
1886,pp1603,20150317,7725,7725,0,0,0,7769,7769,44,44,0,0,0
1887,pp1603,20150318,7769,7769,7652,7652,7485,7485,7568,-284,-201,4,151370,2
1888,pp1603,20150319,7485,7568,0,0,0,7568,7568,0,0,0,0,2
1889,pp1603,20150320,7568,7568,0,0,0,7633,7633,65,65,0,0,2
1890,pp1603,20150323,7633,7633,0,0,0,7823,7823,190,190,0,0,2
1891,pp1603,20150324,7823,7823,0,0,0,7838,7838,15,15,0,0,2
1892,pp1603,20150325,7838,7838,0,0,0,7863,7863,25,25,0,0,2
1893,pp1603,20150326,7863,7863,7998,7998,7982,7982,7991,119,128,10,399590,12
1894,pp1603,20150327,7982,7991,0,0,0,7991,7991,0,0,0,0,12
1895,pp1603,20150330,7991,7991,0,0,0,7991,7991,0,0,0,0,12
1896,pp1603,20150331,7991,7991,0,0,0,7991,7991,0,0,0,0,12
1897,pp1603,20150401,7991,7991,8028,8028,8028,8028,8028,37,37,8,321120,8
1898,pp1603,20150402,8028,8028,8190,8190,8185,8185,8187,157,159,4,163750,12
1899,pp1603,20150403,8185,8187,7860,7860,7860,7860,7860,-327,-327,6,235800,14
1900,pp1603,20150407,7860,7860,0,0,0,7860,7860,0,0,0,0,14
1901,pp1603,20150408,7860,7860,0,0,0,7968,7968,108,108,0,0,14
1902,pp1603,20150409,7968,7968,0,0,0,7887,7887,-81,-81,0,0,14
1903,pp1603,20150410,7887,7887,0,0,0,7910,7910,23,23,0,0,14
1904,pp1603,20150413,7910,7910,0,0,0,7953,7953,43,43,0,0,14
1905,pp1603,20150414,7953,7953,0,0,0,7953,7953,0,0,0,0,14
1906,pp1603,20150415,7953,7953,0,0,0,7953,7953,0,0,0,0,14
1907,pp1603,20150416,7953,7953,0,0,0,8191,8191,238,238,0,0,14
1908,pp1603,20150417,8191,8191,0,0,0,8310,8310,119,119,0,0,14
1909,pp1603,20150420,8310,8310,0,0,0,8406,8406,96,96,0,0,14
1910,pp1603,20150421,8406,8406,0,0,0,8406,8406,0,0,0,0,14
1911,pp1603,20150422,8406,8406,0,0,0,8319,8319,-87,-87,0,0,14
1912,pp1603,20150423,8319,8319,8400,8400,8400,8400,8400,81,81,2,84000,16
1913,pp1603,20150424,8400,8400,8471,8471,8355,8355,8413,-45,13,4,168260,16
1914,pp1603,20150427,8355,8413,8588,8588,8588,8588,8588,175,175,2,85880,18
1915,pp1603,20150428,8588,8588,0,0,0,8628,8628,40,40,0,0,18
1916,pp1603,20150429,8628,8628,0,0,0,8602,8602,-26,-26,0,0,18
1917,pp1603,20150430,8602,8602,0,0,0,8602,8602,0,0,0,0,18
1918,pp1603,20150504,8602,8602,8586,8586,8563,8563,8581,-39,-21,10,429070,18
1919,pp1603,20150505,8563,8581,0,0,0,8510,8510,-71,-71,0,0,18
1920,pp1603,20150506,8510,8510,0,0,0,8572,8572,62,62,0,0,18
1921,pp1603,20150507,8572,8572,8420,8420,8420,8420,8420,-152,-152,2,84200,20
1922,pp1603,20150508,8420,8420,0,0,0,8278,8278,-142,-142,0,0,20
1923,pp1603,20150511,8278,8278,0,0,0,8289,8289,11,11,0,0,20
1924,pp1603,20150512,8289,8289,0,0,0,8159,8159,-130,-130,0,0,20
1925,pp1603,20150513,8159,8159,8161,8229,8161,8229,8195,70,36,4,163900,20
1926,pp1603,20150514,8229,8195,0,0,0,8126,8126,-69,-69,0,0,20
1927,pp1603,20150515,8126,8126,0,0,0,8189,8189,63,63,0,0,20
1928,pp1603,20150518,8189,8189,0,0,0,8122,8122,-67,-67,0,0,20
1929,pp1603,20150519,8122,8122,0,0,0,8044,8044,-78,-78,0,0,20
1930,pp1603,20150520,8044,8044,0,0,0,7931,7931,-113,-113,0,0,20
1931,pp1603,20150521,7931,7931,0,0,0,7931,7931,0,0,0,0,20
1932,pp1603,20150522,7931,7931,0,0,0,7931,7931,0,0,0,0,20
1933,pp1603,20150525,7931,7931,0,0,0,7931,7931,0,0,0,0,20
1934,pp1603,20150526,7931,7931,0,0,0,8033,8033,102,102,0,0,20
1935,pp1603,20150527,8033,8033,0,0,0,7921,7921,-112,-112,0,0,20
1936,pp1603,20150528,7921,7921,0,0,0,7898,7898,-23,-23,0,0,20
1937,pp1603,20150529,7898,7898,0,0,0,7917,7917,19,19,0,0,20
1938,pp1603,20150601,7917,7917,0,0,0,7948,7948,31,31,0,0,20
1939,pp1603,20150602,7948,7948,0,0,0,7905,7905,-43,-43,0,0,20
1940,pp1603,20150603,7905,7905,0,0,0,7905,7905,0,0,0,0,20
1941,pp1603,20150604,7905,7905,0,0,0,7905,7905,0,0,0,0,20
1942,pp1603,20150605,7905,7905,0,0,0,7955,7955,50,50,0,0,20
1943,pp1603,20150608,7955,7955,0,0,0,7943,7943,-12,-12,0,0,20
1944,pp1603,20150609,7943,7943,0,0,0,7868,7868,-75,-75,0,0,20
1945,pp1603,20150610,7868,7868,8119,8182,8119,8182,8161,314,293,6,244830,18
1946,pp1603,20150611,8182,8161,8338,8338,8338,8338,8338,177,177,2,83380,18
1947,pp1603,20150612,8338,8338,8274,8274,8274,8274,8274,-64,-64,2,82740,16
1948,pp1603,20150615,8274,8274,8175,8175,8175,8175,8175,-99,-99,2,81750,14
1949,pp1603,20150616,8175,8175,8351,8351,8351,8351,8351,176,176,2,83510,12
1950,pp1603,20150617,8351,8351,8213,8213,8213,8213,8213,-138,-138,6,246390,6
1951,pp1603,20150618,8213,8213,8177,8179,8177,8179,8178,-34,-35,20,817800,26
1952,pp1603,20150619,8179,8178,0,0,0,8232,8232,54,54,0,0,26
1953,pp1603,20150623,8232,8232,0,0,0,8221,8221,-11,-11,0,0,26
1954,pp1603,20150624,8221,8221,0,0,0,8280,8280,59,59,0,0,26
1955,pp1603,20150625,8280,8280,0,0,0,8284,8284,4,4,0,0,26
1956,pp1603,20150626,8284,8284,0,0,0,8347,8347,63,63,0,0,26
1957,pp1603,20150629,8347,8347,0,0,0,8289,8289,-58,-58,0,0,26
1958,pp1603,20150630,8289,8289,0,0,0,8271,8271,-18,-18,0,0,26
1959,pp1603,20150701,8271,8271,0,0,0,8330,8330,59,59,0,0,26
1960,pp1603,20150702,8330,8330,0,0,0,8228,8228,-102,-102,0,0,26
1961,pp1603,20150703,8228,8228,0,0,0,8289,8289,61,61,0,0,26
1962,pp1603,20150706,8289,8289,0,0,0,8023,8023,-266,-266,0,0,26
1963,pp1603,20150707,8023,8023,0,0,0,7841,7841,-182,-182,0,0,26
1964,pp1603,20150708,7841,7841,0,0,0,7618,7618,-223,-223,0,0,26
1965,pp1603,20150709,7618,7618,0,0,0,7922,7922,304,304,0,0,26
1966,pp1603,20150710,7922,7922,0,0,0,8043,8043,121,121,0,0,26
1967,pp1603,20150713,8043,8043,7897,7897,7840,7840,7886,-203,-157,22,867550,14
1968,pp1603,20150714,7840,7886,0,0,0,7901,7901,15,15,0,0,14
1969,pp1603,20150715,7901,7901,0,0,0,7868,7868,-33,-33,0,0,14
1970,pp1603,20150716,7868,7868,7732,7732,7732,7732,7732,-136,-136,2,77320,14
1971,pp1603,20150717,7732,7732,0,0,0,7732,7732,0,0,0,0,14
1972,pp1603,20150720,7732,7732,0,0,0,7750,7750,18,18,0,0,14
1973,pp1603,20150721,7750,7750,0,0,0,7741,7741,-9,-9,0,0,14
1974,pp1603,20150722,7741,7741,0,0,0,7807,7807,66,66,0,0,14
1975,pp1603,20150723,7807,7807,0,0,0,7827,7827,20,20,0,0,14
1976,pp1603,20150724,7827,7827,0,0,0,7694,7694,-133,-133,0,0,14
1977,pp1603,20150727,7694,7694,7460,7460,7460,7460,7460,-234,-234,6,223800,8
1978,pp1603,20150728,7460,7460,0,0,0,7490,7490,30,30,0,0,8
1979,pp1603,20150729,7490,7490,7443,7616,7443,7616,7498,126,8,202,7573390,68
1980,pp1603,20150730,7616,7498,7580,7580,7580,7580,7580,82,82,2,75800,70
1981,pp1603,20150731,7580,7580,0,0,0,7544,7544,-36,-36,0,0,70
1982,pp1603,20150803,7544,7544,7261,7261,7261,7261,7261,-283,-283,2,72610,70
1983,pp1603,20150804,7261,7261,7191,7277,7191,7277,7248,16,-13,6,217450,66
1984,pp1603,20150805,7277,7248,7408,7408,7399,7399,7405,151,157,6,222150,62
1985,pp1603,20150806,7399,7405,7361,7361,7361,7361,7361,-44,-44,2,73610,62
1986,pp1603,20150807,7361,7361,7302,7302,7302,7302,7302,-59,-59,2,73020,62
1987,pp1603,20150810,7302,7302,7413,7485,7413,7485,7456,183,154,12,447390,58
1988,pp1603,20150811,7485,7456,0,0,0,7706,7706,250,250,0,0,58
1989,pp1603,20150812,7706,7706,7604,7604,7604,7604,7604,-102,-102,2,76040,58
1990,pp1603,20150813,7604,7604,0,0,0,7584,7584,-20,-20,0,0,58
1991,pp1603,20150814,7584,7584,7732,7885,7732,7806,7814,222,230,8,312590,54
1992,pp1603,20150817,7806,7814,7513,7615,7513,7615,7594,-199,-220,10,379730,46
1993,pp1603,20150818,7615,7594,7295,7539,7295,7473,7482,-121,-112,22,823070,32
1994,pp1603,20150819,7473,7482,7512,7562,7512,7520,7536,38,54,20,753600,14
1995,pp1603,20150820,7520,7536,7293,7293,7293,7293,7293,-243,-243,2,72930,14
1996,pp1603,20150821,7293,7293,0,0,0,7350,7350,57,57,0,0,14
1997,pp1603,20150824,7350,7350,7068,7068,7068,7068,7068,-282,-282,2,70680,14
1998,pp1603,20150825,7068,7068,0,0,0,7068,7068,0,0,0,0,14
1999,pp1603,20150826,7068,7068,0,0,0,7074,7074,6,6,0,0,14
2000,pp1603,20150827,7074,7074,0,0,0,7123,7123,49,49,0,0,14
2001,pp1603,20150828,7123,7123,0,0,0,7387,7387,264,264,0,0,14
2002,pp1603,20150831,7387,7387,0,0,0,7427,7427,40,40,0,0,14
2003,pp1603,20150901,7427,7427,0,0,0,7522,7522,95,95,0,0,14
2004,pp1603,20150902,7522,7522,0,0,0,7462,7462,-60,-60,0,0,14
2005,pp1603,20150907,7462,7462,0,0,0,7556,7556,94,94,0,0,14
2006,pp1603,20150908,7556,7556,7373,7373,7373,7373,7373,-183,-183,2,73730,14
2007,pp1603,20150909,7373,7373,7409,7597,7409,7507,7494,134,121,48,1798780,12
2008,pp1603,20150910,7507,7494,0,0,0,7276,7276,-218,-218,0,0,12
2009,pp1603,20150911,7276,7276,7564,7564,7350,7350,7491,74,215,6,224740,10
2010,pp1603,20150914,7350,7491,0,0,0,7465,7465,-26,-26,0,0,10
2011,pp1603,20150915,7465,7465,0,0,0,7329,7329,-136,-136,0,0,10
2012,pp1603,20150916,7329,7329,0,0,0,7330,7330,1,1,0,0,10
2013,pp1603,20150917,7330,7330,0,0,0,7288,7288,-42,-42,0,0,10
2014,pp1603,20150918,7288,7288,0,0,0,7180,7180,-108,-108,0,0,10
2015,pp1603,20150921,7180,7180,0,0,0,7193,7193,13,13,0,0,10
2016,pp1603,20150922,7193,7193,0,0,0,7196,7196,3,3,0,0,10
2017,pp1603,20150923,7196,7196,0,0,0,7196,7196,0,0,0,0,10
2018,pp1603,20150924,7196,7196,0,0,0,7166,7166,-30,-30,0,0,10
2019,pp1603,20150925,7166,7166,0,0,0,7138,7138,-28,-28,0,0,10
2020,pp1603,20150928,7138,7138,0,0,0,7118,7118,-20,-20,0,0,10
2021,pp1603,20150929,7118,7118,0,0,0,6961,6961,-157,-157,0,0,10
2022,pp1603,20150930,6961,6961,0,0,0,6969,6969,8,8,0,0,10
2023,pp1603,20151008,6969,6969,0,0,0,7090,7090,121,121,0,0,10
2024,pp1603,20151009,7090,7090,0,0,0,7250,7250,160,160,0,0,10
2025,pp1603,20151012,7250,7250,0,0,0,7250,7250,0,0,0,0,10
2026,pp1603,20151013,7250,7250,0,0,0,7179,7179,-71,-71,0,0,10
2027,pp1603,20151014,7179,7179,0,0,0,7179,7179,0,0,0,0,10
2028,pp1603,20151015,7179,7179,0,0,0,7107,7107,-72,-72,0,0,10
2029,pp1603,20151016,7107,7107,0,0,0,7041,7041,-66,-66,0,0,10
2030,pp1603,20151019,7041,7041,0,0,0,6976,6976,-65,-65,0,0,10
2031,pp1603,20151020,6976,6976,0,0,0,6961,6961,-15,-15,0,0,10
2032,pp1603,20151021,6961,6961,0,0,0,6913,6913,-48,-48,0,0,10
2033,pp1603,20151022,6913,6913,0,0,0,6996,6996,83,83,0,0,10
2034,pp1603,20151023,6996,6996,0,0,0,7006,7006,10,10,0,0,10
2035,pp1603,20151026,7006,7006,0,0,0,6920,6920,-86,-86,0,0,10
2036,pp1603,20151027,6920,6920,0,0,0,6826,6826,-94,-94,0,0,10
2037,pp1603,20151028,6826,6826,0,0,0,6823,6823,-3,-3,0,0,10
2038,pp1603,20151029,6823,6823,6946,6946,6946,6946,6946,123,123,2,69460,8
2039,pp1603,20151030,6946,6946,0,0,0,6826,6826,-120,-120,0,0,8
2040,pp1603,20151102,6826,6826,0,0,0,6830,6830,4,4,0,0,8
2041,pp1603,20151103,6830,6830,0,0,0,6780,6780,-50,-50,0,0,8
2042,pp1603,20151104,6780,6780,0,0,0,6834,6834,54,54,0,0,8
2043,pp1603,20151105,6834,6834,0,0,0,6647,6647,-187,-187,0,0,8
2044,pp1603,20151106,6647,6647,0,0,0,6607,6607,-40,-40,0,0,8
2045,pp1603,20151109,6607,6607,0,0,0,6629,6629,22,22,0,0,8
2046,pp1603,20151110,6629,6629,6522,6522,6522,6522,6522,-107,-107,2,65220,6
2047,pp1603,20151111,6522,6522,0,0,0,6498,6498,-24,-24,0,0,6
2048,pp1603,20151112,6498,6498,0,0,0,6425,6425,-73,-73,0,0,6
2049,pp1603,20151113,6425,6425,0,0,0,6327,6327,-98,-98,0,0,6
2050,pp1603,20151116,6327,6327,0,0,0,6197,6197,-130,-130,0,0,6
2051,pp1603,20151117,6197,6197,0,0,0,6153,6153,-44,-44,0,0,6
2052,pp1603,20151118,6153,6153,0,0,0,6024,6024,-129,-129,0,0,6
2053,pp1603,20151119,6024,6024,0,0,0,6128,6128,104,104,0,0,6
2054,pp1603,20151120,6128,6128,0,0,0,6011,6011,-117,-117,0,0,6
2055,pp1603,20151123,6011,6011,0,0,0,5785,5785,-226,-226,0,0,6
2056,pp1603,20151124,5785,5785,5855,5855,5855,5855,5855,70,70,2,58550,8
2057,pp1603,20151125,5855,5855,5922,5943,5808,5943,5896,88,41,14,412720,16
2058,pp1603,20151126,5943,5896,0,0,0,6123,6123,227,227,0,0,16
2059,pp1603,20151127,6123,6123,0,0,0,6283,6283,160,160,0,0,16
2060,pp1603,20151130,6283,6283,0,0,0,6290,6290,7,7,0,0,16
2061,pp1603,20151201,6290,6290,6255,6377,6255,6377,6352,87,62,10,317630,24
2062,pp1603,20151202,6377,6352,0,0,0,6420,6420,68,68,0,0,24
2063,pp1603,20151203,6420,6420,0,0,0,6447,6447,27,27,0,0,24
2064,pp1603,20151204,6447,6447,6501,6501,6209,6209,6355,-238,-92,4,127100,22
2065,pp1603,20151207,6209,6355,6120,6120,6120,6120,6120,-235,-235,4,122400,18
2066,pp1603,20151208,6120,6120,0,0,0,5938,5938,-182,-182,0,0,18
2067,pp1603,20151209,5938,5938,0,0,0,5944,5944,6,6,0,0,18
2068,pp1603,20151210,5944,5944,0,0,0,5880,5880,-64,-64,0,0,18
2069,pp1603,20151211,5880,5880,0,0,0,5880,5880,0,0,0,0,18
2070,pp1603,20151214,5880,5880,0,0,0,5800,5800,-80,-80,0,0,18
2071,pp1603,20151215,5800,5800,0,0,0,5800,5800,0,0,0,0,18
2072,pp1603,20151216,5800,5800,0,0,0,5874,5874,74,74,0,0,18
2073,pp1603,20151217,5874,5874,0,0,0,5941,5941,67,67,0,0,18
2074,pp1603,20151218,5941,5941,0,0,0,5868,5868,-73,-73,0,0,18
2075,pp1603,20151221,5868,5868,0,0,0,5928,5928,60,60,0,0,18
2076,pp1603,20151222,5928,5928,0,0,0,6058,6058,130,130,0,0,18
2077,pp1603,20151223,6058,6058,6099,6100,6099,6100,6099,42,41,4,121990,20
2078,pp1603,20151224,6100,6099,6275,6275,6275,6275,6275,176,176,2,62750,20
2079,pp1603,20151225,6275,6275,0,0,0,6311,6311,36,36,0,0,20
2080,pp1603,20151228,6311,6311,0,0,0,6282,6282,-29,-29,0,0,20
2081,pp1603,20151229,6282,6282,0,0,0,6364,6364,82,82,0,0,20
2082,pp1603,20151230,6364,6364,0,0,0,6361,6361,-3,-3,0,0,20
2083,pp1603,20151231,6361,6361,0,0,0,6367,6367,6,6,0,0,20
2084,pp1604,20150416,7997,7997,8086,8534,8086,8534,8310,537,313,4,166200,0
2085,pp1604,20150417,8534,8310,0,0,0,8411,8411,101,101,0,0,0
2086,pp1604,20150420,8411,8411,0,0,0,8508,8508,97,97,0,0,0
2087,pp1604,20150421,8508,8508,0,0,0,8445,8445,-63,-63,0,0,0
2088,pp1604,20150422,8445,8445,0,0,0,8358,8358,-87,-87,0,0,0
2089,pp1604,20150423,8358,8358,0,0,0,8439,8439,81,81,0,0,0
2090,pp1604,20150424,8439,8439,0,0,0,8452,8452,13,13,0,0,0
2091,pp1604,20150427,8452,8452,0,0,0,8627,8627,175,175,0,0,0
2092,pp1604,20150428,8627,8627,0,0,0,8667,8667,40,40,0,0,0
2093,pp1604,20150429,8667,8667,0,0,0,8561,8561,-106,-106,0,0,0
2094,pp1604,20150430,8561,8561,0,0,0,8561,8561,0,0,0,0,0
2095,pp1604,20150504,8561,8561,0,0,0,8541,8541,-20,-20,0,0,0
2096,pp1604,20150505,8541,8541,0,0,0,8471,8471,-70,-70,0,0,0
2097,pp1604,20150506,8471,8471,0,0,0,8533,8533,62,62,0,0,0
2098,pp1604,20150507,8533,8533,0,0,0,8382,8382,-151,-151,0,0,0
2099,pp1604,20150508,8382,8382,0,0,0,8241,8241,-141,-141,0,0,0
2100,pp1604,20150511,8241,8241,0,0,0,8251,8251,10,10,0,0,0
2101,pp1604,20150512,8251,8251,0,0,0,8122,8122,-129,-129,0,0,0
2102,pp1604,20150513,8122,8122,0,0,0,8157,8157,35,35,0,0,0
2103,pp1604,20150514,8157,8157,0,0,0,8089,8089,-68,-68,0,0,0
2104,pp1604,20150515,8089,8089,8385,8385,8009,8009,8197,-80,108,4,163940,0
2105,pp1604,20150518,8009,8197,0,0,0,8130,8130,-67,-67,0,0,0
2106,pp1604,20150519,8130,8130,0,0,0,8055,8055,-75,-75,0,0,0
2107,pp1604,20150520,8055,8055,0,0,0,7942,7942,-113,-113,0,0,0
2108,pp1604,20150521,7942,7942,0,0,0,8068,8068,126,126,0,0,0
2109,pp1604,20150522,8068,8068,0,0,0,8124,8124,56,56,0,0,0
2110,pp1604,20150525,8124,8124,0,0,0,8093,8093,-31,-31,0,0,0
2111,pp1604,20150526,8093,8093,0,0,0,8197,8197,104,104,0,0,0
2112,pp1604,20150527,8197,8197,0,0,0,8082,8082,-115,-115,0,0,0
2113,pp1604,20150528,8082,8082,0,0,0,8058,8058,-24,-24,0,0,0
2114,pp1604,20150529,8058,8058,0,0,0,8078,8078,20,20,0,0,0
2115,pp1604,20150601,8078,8078,0,0,0,8110,8110,32,32,0,0,0
2116,pp1604,20150602,8110,8110,0,0,0,8066,8066,-44,-44,0,0,0
2117,pp1604,20150603,8066,8066,0,0,0,8143,8143,77,77,0,0,0
2118,pp1604,20150604,8143,8143,0,0,0,8139,8139,-4,-4,0,0,0
2119,pp1604,20150605,8139,8139,0,0,0,8191,8191,52,52,0,0,0
2120,pp1604,20150608,8191,8191,0,0,0,8178,8178,-13,-13,0,0,0
2121,pp1604,20150609,8178,8178,0,0,0,8101,8101,-77,-77,0,0,0
2122,pp1604,20150610,8101,8101,0,0,0,8402,8402,301,301,0,0,0
2123,pp1604,20150611,8402,8402,0,0,0,8584,8584,182,182,0,0,0
2124,pp1604,20150612,8584,8584,0,0,0,8519,8519,-65,-65,0,0,0
2125,pp1604,20150615,8519,8519,0,0,0,8418,8418,-101,-101,0,0,0
2126,pp1604,20150616,8418,8418,0,0,0,8599,8599,181,181,0,0,0
2127,pp1604,20150617,8599,8599,0,0,0,8457,8457,-142,-142,0,0,0
2128,pp1604,20150618,8457,8457,0,0,0,8421,8421,-36,-36,0,0,0
2129,pp1604,20150619,8421,8421,0,0,0,8476,8476,55,55,0,0,0
2130,pp1604,20150623,8476,8476,0,0,0,8465,8465,-11,-11,0,0,0
2131,pp1604,20150624,8465,8465,0,0,0,8526,8526,61,61,0,0,0
2132,pp1604,20150625,8526,8526,0,0,0,8530,8530,4,4,0,0,0
2133,pp1604,20150626,8530,8530,0,0,0,8595,8595,65,65,0,0,0
2134,pp1604,20150629,8595,8595,0,0,0,8535,8535,-60,-60,0,0,0
2135,pp1604,20150630,8535,8535,0,0,0,8517,8517,-18,-18,0,0,0
2136,pp1604,20150701,8517,8517,0,0,0,8578,8578,61,61,0,0,0
2137,pp1604,20150702,8578,8578,0,0,0,8473,8473,-105,-105,0,0,0
2138,pp1604,20150703,8473,8473,0,0,0,8535,8535,62,62,0,0,0
2139,pp1604,20150706,8535,8535,0,0,0,8261,8261,-274,-274,0,0,0
2140,pp1604,20150707,8261,8261,0,0,0,8073,8073,-188,-188,0,0,0
2141,pp1604,20150708,8073,8073,0,0,0,7844,7844,-229,-229,0,0,0
2142,pp1604,20150709,7844,7844,0,0,0,8157,8157,313,313,0,0,0
2143,pp1604,20150710,8157,8157,0,0,0,8281,8281,124,124,0,0,0
2144,pp1604,20150713,8281,8281,0,0,0,8120,8120,-161,-161,0,0,0
2145,pp1604,20150714,8120,8120,0,0,0,8136,8136,16,16,0,0,0
2146,pp1604,20150715,8136,8136,0,0,0,8102,8102,-34,-34,0,0,0
2147,pp1604,20150716,8102,8102,0,0,0,7962,7962,-140,-140,0,0,0
2148,pp1604,20150717,7962,7962,0,0,0,7961,7961,-1,-1,0,0,0
2149,pp1604,20150720,7961,7961,0,0,0,7980,7980,19,19,0,0,0
2150,pp1604,20150721,7980,7980,0,0,0,7970,7970,-10,-10,0,0,0
2151,pp1604,20150722,7970,7970,0,0,0,8038,8038,68,68,0,0,0
2152,pp1604,20150723,8038,8038,0,0,0,8059,8059,21,21,0,0,0
2153,pp1604,20150724,8059,8059,0,0,0,7922,7922,-137,-137,0,0,0
2154,pp1604,20150727,7922,7922,0,0,0,7682,7682,-240,-240,0,0,0
2155,pp1604,20150728,7682,7682,0,0,0,7713,7713,31,31,0,0,0
2156,pp1604,20150729,7713,7713,0,0,0,7721,7721,8,8,0,0,0
2157,pp1604,20150730,7721,7721,0,0,0,7805,7805,84,84,0,0,0
2158,pp1604,20150731,7805,7805,0,0,0,7710,7710,-95,-95,0,0,0
2159,pp1604,20150803,7710,7710,7460,7460,7460,7460,7460,-250,-250,8,298400,8
2160,pp1604,20150804,7460,7460,0,0,0,7447,7447,-13,-13,0,0,8
2161,pp1604,20150805,7447,7447,0,0,0,7608,7608,161,161,0,0,8
2162,pp1604,20150806,7608,7608,7450,7450,7342,7342,7387,-266,-221,10,369360,2
2163,pp1604,20150807,7342,7387,0,0,0,7328,7328,-59,-59,0,0,2
2164,pp1604,20150810,7328,7328,0,0,0,7482,7482,154,154,0,0,2
2165,pp1604,20150811,7482,7482,0,0,0,7733,7733,251,251,0,0,2
2166,pp1604,20150812,7733,7733,0,0,0,7631,7631,-102,-102,0,0,2
2167,pp1604,20150813,7631,7631,0,0,0,7611,7611,-20,-20,0,0,2
2168,pp1604,20150814,7611,7611,0,0,0,7841,7841,230,230,0,0,2
2169,pp1604,20150817,7841,7841,0,0,0,7621,7621,-220,-220,0,0,2
2170,pp1604,20150818,7621,7621,0,0,0,7509,7509,-112,-112,0,0,2
2171,pp1604,20150819,7509,7509,0,0,0,7563,7563,54,54,0,0,2
2172,pp1604,20150820,7563,7563,0,0,0,7320,7320,-243,-243,0,0,2
2173,pp1604,20150821,7320,7320,0,0,0,7377,7377,57,57,0,0,2
2174,pp1604,20150824,7377,7377,0,0,0,7094,7094,-283,-283,0,0,2
2175,pp1604,20150825,7094,7094,0,0,0,6997,6997,-97,-97,0,0,2
2176,pp1604,20150826,6997,6997,0,0,0,7003,7003,6,6,0,0,2
2177,pp1604,20150827,7003,7003,0,0,0,7052,7052,49,49,0,0,2
2178,pp1604,20150828,7052,7052,0,0,0,7313,7313,261,261,0,0,2
2179,pp1604,20150831,7313,7313,0,0,0,7353,7353,40,40,0,0,2
2180,pp1604,20150901,7353,7353,0,0,0,7447,7447,94,94,0,0,2
2181,pp1604,20150902,7447,7447,0,0,0,7387,7387,-60,-60,0,0,2
2182,pp1604,20150907,7387,7387,0,0,0,7480,7480,93,93,0,0,2
2183,pp1604,20150908,7480,7480,0,0,0,7299,7299,-181,-181,0,0,2
2184,pp1604,20150909,7299,7299,0,0,0,7418,7418,119,119,0,0,2
2185,pp1604,20150910,7418,7418,0,0,0,7202,7202,-216,-216,0,0,2
2186,pp1604,20150911,7202,7202,0,0,0,7414,7414,212,212,0,0,2
2187,pp1604,20150914,7414,7414,0,0,0,7388,7388,-26,-26,0,0,2
2188,pp1604,20150915,7388,7388,0,0,0,7253,7253,-135,-135,0,0,2
2189,pp1604,20150916,7253,7253,0,0,0,7254,7254,1,1,0,0,2
2190,pp1604,20150917,7254,7254,0,0,0,7213,7213,-41,-41,0,0,2
2191,pp1604,20150918,7213,7213,0,0,0,7106,7106,-107,-107,0,0,2
2192,pp1604,20150921,7106,7106,7310,7340,7310,7340,7325,234,219,4,146500,6
2193,pp1604,20150922,7340,7325,0,0,0,7328,7328,3,3,0,0,6
2194,pp1604,20150923,7328,7328,7150,7150,7150,7150,7150,-178,-178,4,143000,2
2195,pp1604,20150924,7150,7150,0,0,0,7120,7120,-30,-30,0,0,2
2196,pp1604,20150925,7120,7120,7047,7268,7047,7268,7157,148,37,20,715740,4
2197,pp1604,20150928,7268,7157,0,0,0,7137,7137,-20,-20,0,0,4
2198,pp1604,20150929,7137,7137,0,0,0,6979,6979,-158,-158,0,0,4
2199,pp1604,20150930,6979,6979,0,0,0,6987,6987,8,8,0,0,4
2200,pp1604,20151008,6987,6987,7014,7014,7014,7014,7014,27,27,2,70140,6
2201,pp1604,20151009,7014,7014,0,0,0,7173,7173,159,159,0,0,6
2202,pp1604,20151012,7173,7173,0,0,0,7173,7173,0,0,0,0,6
2203,pp1604,20151013,7173,7173,0,0,0,7103,7103,-70,-70,0,0,6
2204,pp1604,20151014,7103,7103,7065,7226,7065,7226,7145,123,42,12,428730,12
2205,pp1604,20151015,7226,7145,0,0,0,7073,7073,-72,-72,0,0,12
2206,pp1604,20151016,7073,7073,0,0,0,7007,7007,-66,-66,0,0,12
2207,pp1604,20151019,7007,7007,0,0,0,6942,6942,-65,-65,0,0,12
2208,pp1604,20151020,6942,6942,0,0,0,6927,6927,-15,-15,0,0,12
2209,pp1604,20151021,6927,6927,6945,6945,6945,6945,6945,18,18,2,69450,12
2210,pp1604,20151022,6945,6945,0,0,0,7028,7028,83,83,0,0,12
2211,pp1604,20151023,7028,7028,0,0,0,7038,7038,10,10,0,0,12
2212,pp1604,20151026,7038,7038,0,0,0,6952,6952,-86,-86,0,0,12
2213,pp1604,20151027,6952,6952,0,0,0,6857,6857,-95,-95,0,0,12
2214,pp1604,20151028,6857,6857,6956,6956,6956,6956,6956,99,99,2,69560,12
2215,pp1604,20151029,6956,6956,0,0,0,7081,7081,125,125,0,0,12
2216,pp1604,20151030,7081,7081,0,0,0,6959,6959,-122,-122,0,0,12
2217,pp1604,20151102,6959,6959,0,0,0,6964,6964,5,5,0,0,12
2218,pp1604,20151103,6964,6964,0,0,0,6913,6913,-51,-51,0,0,12
2219,pp1604,20151104,6913,6913,0,0,0,6968,6968,55,55,0,0,12
2220,pp1604,20151105,6968,6968,0,0,0,6777,6777,-191,-191,0,0,12
2221,pp1604,20151106,6777,6777,0,0,0,6736,6736,-41,-41,0,0,12
2222,pp1604,20151109,6736,6736,0,0,0,6759,6759,23,23,0,0,12
2223,pp1604,20151110,6759,6759,6563,6563,6498,6498,6530,-261,-229,120,3918300,12
2224,pp1604,20151111,6498,6530,6498,6498,6353,6353,6379,-177,-151,12,382760,14
2225,pp1604,20151112,6353,6379,6353,6353,6352,6352,6352,-27,-27,8,254110,10
2226,pp1604,20151113,6352,6352,0,0,0,6255,6255,-97,-97,0,0,10
2227,pp1604,20151116,6255,6255,0,0,0,6126,6126,-129,-129,0,0,10
2228,pp1604,20151117,6126,6126,0,0,0,6082,6082,-44,-44,0,0,10
2229,pp1604,20151118,6082,6082,0,0,0,5954,5954,-128,-128,0,0,10
2230,pp1604,20151119,5954,5954,0,0,0,6057,6057,103,103,0,0,10
2231,pp1604,20151120,6057,6057,0,0,0,5815,5815,-242,-242,0,0,10
2232,pp1604,20151123,5815,5815,5520,5520,5520,5520,5520,-295,-295,2,55200,10
2233,pp1604,20151124,5520,5520,0,0,0,5586,5586,66,66,0,0,10
2234,pp1604,20151125,5586,5586,0,0,0,5625,5625,39,39,0,0,10
2235,pp1604,20151126,5625,5625,5773,5828,5717,5777,5779,152,154,220,6357220,10
2236,pp1604,20151127,5777,5779,5873,5873,5873,5873,5873,94,94,4,117460,14
2237,pp1604,20151130,5873,5873,5735,5735,5735,5735,5735,-138,-138,2,57350,12
2238,pp1604,20151201,5735,5735,0,0,0,5791,5791,56,56,0,0,12
2239,pp1604,20151202,5791,5791,0,0,0,5853,5853,62,62,0,0,12
2240,pp1604,20151203,5853,5853,0,0,0,5878,5878,25,25,0,0,12
2241,pp1604,20151204,5878,5878,5995,5995,5771,5771,5883,-107,5,4,117660,12
2242,pp1604,20151207,5771,5883,0,0,0,5666,5666,-217,-217,0,0,12
2243,pp1604,20151208,5666,5666,5573,5581,5573,5581,5579,-85,-87,8,223160,14
2244,pp1604,20151209,5581,5579,0,0,0,5585,5585,6,6,0,0,14
2245,pp1604,20151210,5585,5585,0,0,0,5525,5525,-60,-60,0,0,14
2246,pp1604,20151211,5525,5525,5643,5643,5584,5584,5618,59,93,50,1404520,12
2247,pp1604,20151214,5584,5618,5573,5644,5573,5644,5608,26,-10,4,112170,12
2248,pp1604,20151215,5644,5608,0,0,0,5608,5608,0,0,0,0,12
2249,pp1604,20151216,5608,5608,0,0,0,5679,5679,71,71,0,0,12
2250,pp1604,20151217,5679,5679,0,0,0,5744,5744,65,65,0,0,12
2251,pp1604,20151218,5744,5744,0,0,0,5674,5674,-70,-70,0,0,12
2252,pp1604,20151221,5674,5674,5735,5735,5735,5735,5735,61,61,6,172050,14
2253,pp1604,20151222,5735,5735,0,0,0,5861,5861,126,126,0,0,14
2254,pp1604,20151223,5861,5861,5812,5812,5780,5780,5798,-81,-63,6,173950,10
2255,pp1604,20151224,5780,5798,6070,6070,6070,6070,6070,272,272,2,60700,12
2256,pp1604,20151225,6070,6070,5881,5881,5881,5881,5881,-189,-189,2,58810,12
2257,pp1604,20151228,5881,5881,5899,5899,5890,5890,5894,9,13,4,117890,12
2258,pp1604,20151229,5890,5894,5962,5962,5740,5948,5844,54,-50,58,1694800,26
2259,pp1604,20151230,5948,5844,0,0,0,5841,5841,-3,-3,0,0,26
2260,pp1604,20151231,5841,5841,0,0,0,5847,5847,6,6,0,0,26
2261,pp1605,20150518,8104,8104,8000,8010,7860,7870,7903,-234,-201,2758,108989040,2234
2262,pp1605,20150519,7870,7903,7872,7872,7805,7805,7833,-98,-70,2852,111699910,4366
2263,pp1605,20150520,7805,7833,7735,7841,7662,7803,7730,-30,-103,2318,89592560,5254
2264,pp1605,20150521,7803,7730,7850,7928,7754,7892,7836,162,106,2338,91610150,5930
2265,pp1605,20150522,7892,7836,7942,7952,7828,7898,7892,62,56,1482,58482410,6458
2266,pp1605,20150525,7898,7892,7881,7881,7820,7863,7854,-29,-38,836,32830590,6648
2267,pp1605,20150526,7863,7854,7900,7986,7811,7811,7901,-43,47,1690,66770060,6938
2268,pp1605,20150527,7811,7901,7790,7835,7765,7823,7795,-78,-106,1642,64004190,7986
2269,pp1605,20150528,7823,7795,7830,7839,7750,7785,7787,-10,-8,1486,57859410,9080
2270,pp1605,20150529,7785,7787,7808,7830,7786,7805,7809,18,22,994,38814040,9420
2271,pp1605,20150601,7805,7809,7900,7900,7788,7809,7829,0,20,810,31708730,9796
2272,pp1605,20150602,7809,7829,7793,7850,7762,7850,7792,21,-37,1746,68029710,10894
2273,pp1605,20150603,7850,7792,7881,7894,7830,7870,7868,78,76,1504,59168230,10748
2274,pp1605,20150604,7870,7868,7860,7935,7816,7915,7857,47,-11,1562,61368560,11302
2275,pp1605,20150605,7915,7857,7857,7948,7857,7927,7922,70,65,2148,85084020,11664
2276,pp1605,20150608,7927,7922,7950,7962,7890,7904,7918,-18,-4,3680,145698230,14516
2277,pp1605,20150609,7904,7918,7884,7921,7880,7909,7907,-9,-11,1072,42384350,15036
2278,pp1605,20150610,7909,7907,7950,8060,7949,8060,7983,153,76,2016,80474340,15220
2279,pp1605,20150611,8060,7983,8032,8146,8011,8114,8101,131,118,1654,66995350,14794
2280,pp1605,20150612,8114,8101,8099,8101,8030,8037,8072,-64,-29,1020,41168550,14878
2281,pp1605,20150615,8037,8072,8020,8077,7997,8074,8019,2,-53,1364,54694690,15066
2282,pp1605,20150616,8074,8019,8100,8218,8035,8069,8120,50,101,1496,60738000,15810
2283,pp1605,20150617,8069,8120,8018,8085,7947,7947,7996,-173,-124,2722,108825960,17882
2284,pp1605,20150618,7947,7996,7950,7976,7880,7938,7946,-58,-50,700,27812750,18008
2285,pp1605,20150619,7938,7946,7968,8023,7960,7991,7992,45,46,1470,58741910,18148
2286,pp1605,20150623,7991,7992,7950,8035,7920,7987,7969,-5,-23,1656,65988200,18462
2287,pp1605,20150624,7987,7969,8037,8076,7995,8069,8030,100,61,932,37420990,18110
2288,pp1605,20150625,8069,8030,8021,8050,8008,8031,8029,1,-1,756,30352740,18168
2289,pp1605,20150626,8031,8029,8048,8120,8040,8117,8082,88,53,2190,88502140,17702
2290,pp1605,20150629,8117,8082,8088,8111,7950,8032,8022,-50,-60,3122,125229280,18572
2291,pp1605,20150630,8032,8022,8026,8045,7960,8020,8001,-2,-21,1208,48328300,18488
2292,pp1605,20150701,8020,8001,8046,8079,8011,8036,8051,35,50,2738,110231070,18632
2293,pp1605,20150702,8036,8051,7960,8052,7881,8041,8013,-10,-38,1028,41190250,18934
2294,pp1605,20150703,8041,8013,8040,8044,7996,8015,8017,2,4,1782,71440290,19072
2295,pp1605,20150706,8015,8017,7974,7974,7750,7813,7851,-204,-166,5306,208305500,21952
2296,pp1605,20150707,7813,7851,7780,7800,7611,7652,7685,-199,-166,10520,404265990,28482
2297,pp1605,20150708,7652,7685,7594,7594,7378,7378,7424,-307,-261,7030,260986450,31246
2298,pp1605,20150709,7378,7424,7440,7848,7440,7800,7688,376,264,11106,426942560,26674
2299,pp1605,20150710,7800,7688,7800,7900,7728,7785,7818,97,130,7094,277326810,26198
2300,pp1605,20150713,7785,7818,7783,7783,7600,7673,7676,-145,-142,6216,238587070,27478
2301,pp1605,20150714,7673,7676,7705,7762,7627,7627,7685,-49,9,6418,246641540,29096
2302,pp1605,20150715,7627,7685,7683,7800,7629,7648,7656,-37,-29,5900,225860680,27978
2303,pp1605,20150716,7648,7656,7625,7625,7490,7558,7544,-98,-112,5600,211235070,31048
2304,pp1605,20150717,7558,7544,7523,7568,7500,7560,7539,16,-5,1802,67933140,31102
2305,pp1605,20150720,7560,7539,7560,7601,7530,7600,7555,61,16,1304,49262780,31174
2306,pp1605,20150721,7600,7555,7636,7636,7511,7583,7552,28,-3,2826,106721900,32256
2307,pp1605,20150722,7583,7552,7563,7670,7560,7651,7617,99,65,3656,139255780,30638
2308,pp1605,20150723,7651,7617,7611,7655,7601,7625,7634,8,17,6168,235438120,28914
2309,pp1605,20150724,7625,7634,7586,7587,7439,7440,7493,-194,-141,8996,337045230,34968
2310,pp1605,20150727,7440,7493,7461,7461,7212,7283,7297,-210,-196,19188,700127190,44922
2311,pp1605,20150728,7283,7297,7250,7420,7200,7395,7336,98,39,8582,314803220,43560
2312,pp1605,20150729,7395,7336,7430,7500,7397,7426,7465,90,129,6852,255778240,41680
2313,pp1605,20150730,7426,7465,7450,7502,7375,7375,7452,-90,-13,4292,159924870,42914
2314,pp1605,20150731,7375,7452,7360,7398,7333,7368,7360,-84,-92,3266,120202180,43424
2315,pp1605,20150803,7368,7360,7310,7318,7118,7204,7196,-156,-164,15894,571866310,52418
2316,pp1605,20150804,7204,7196,7150,7299,7101,7289,7184,93,-12,12054,432993400,50058
2317,pp1605,20150805,7289,7184,7350,7350,7230,7340,7282,156,98,11572,421346990,49254
2318,pp1605,20150806,7340,7282,7298,7310,7223,7257,7265,-25,-17,10700,388685990,49788
2319,pp1605,20150807,7257,7265,7220,7363,7150,7346,7271,81,6,11334,412082090,48286
2320,pp1605,20150810,7346,7271,7290,7415,7281,7408,7355,137,84,13642,501748580,45506
2321,pp1605,20150811,7408,7355,7460,7649,7450,7641,7597,286,242,24154,917563550,44962
2322,pp1605,20150812,7641,7597,7580,7650,7556,7619,7607,22,10,13590,516942800,43256
2323,pp1605,20150813,7619,7607,7648,7652,7538,7639,7588,32,-19,8620,327065590,43838
2324,pp1605,20150814,7639,7588,7580,7725,7566,7629,7653,41,65,10938,418565920,41080
2325,pp1605,20150817,7629,7653,7590,7638,7441,7451,7520,-202,-133,13412,504354680,42066
2326,pp1605,20150818,7451,7520,7440,7478,7305,7349,7359,-171,-161,11770,433078250,45676
2327,pp1605,20150819,7349,7359,7370,7438,7333,7404,7395,45,36,11810,436686620,45360
2328,pp1605,20150820,7404,7395,7311,7376,7237,7356,7296,-39,-99,13160,480134560,46154
2329,pp1605,20150821,7356,7296,7329,7570,7315,7325,7377,29,81,12198,449952950,48858
2330,pp1605,20150824,7325,7377,7269,7269,7082,7082,7119,-295,-258,29520,1050910910,62630
2331,pp1605,20150825,7082,7119,7050,7168,6935,7078,7088,-41,-31,32652,1157242830,64170
2332,pp1605,20150826,7078,7088,7120,7159,7038,7089,7094,1,6,30318,1075530400,69026
2333,pp1605,20150827,7089,7094,7091,7185,7090,7184,7144,90,50,40918,1461734340,65100
2334,pp1605,20150828,7184,7144,7428,7428,7310,7338,7373,194,229,42246,1557597560,62294
2335,pp1605,20150831,7338,7373,7368,7385,7250,7266,7289,-107,-84,23270,848125980,62728
2336,pp1605,20150901,7266,7289,7336,7426,7336,7404,7392,115,103,36360,1343954340,67468
2337,pp1605,20150902,7404,7392,7302,7365,7274,7355,7328,-37,-64,33714,1235389090,67814
2338,pp1605,20150907,7355,7328,7328,7507,7328,7366,7419,38,91,28972,1074755830,69492
2339,pp1605,20150908,7366,7419,7358,7365,7226,7306,7284,-113,-135,32882,1197562820,77870
2340,pp1605,20150909,7306,7284,7400,7444,7350,7353,7396,69,112,35296,1305389270,75966
2341,pp1605,20150910,7353,7396,7300,7342,7208,7338,7272,-58,-124,57114,2076939710,86872
2342,pp1605,20150911,7338,7272,7362,7400,7310,7327,7356,55,84,45038,1656680050,90592
2343,pp1605,20150914,7327,7356,7320,7383,7253,7262,7325,-94,-31,42638,1561720300,98118
2344,pp1605,20150915,7262,7325,7262,7277,7166,7205,7215,-120,-110,54758,1975487990,108878
2345,pp1605,20150916,7205,7215,7250,7269,7160,7216,7205,1,-10,52272,1883209070,110410
2346,pp1605,20150917,7216,7205,7290,7292,7143,7154,7228,-51,23,62596,2262453770,120096
2347,pp1605,20150918,7154,7228,7150,7195,7108,7140,7153,-88,-75,50796,1816899520,123646
2348,pp1605,20150921,7140,7153,7100,7204,7088,7199,7159,46,6,37492,1342106760,119076
2349,pp1605,20150922,7199,7159,7203,7217,7138,7160,7167,1,8,28240,1012084160,122214
2350,pp1605,20150923,7160,7167,7162,7190,7100,7172,7142,5,-25,46274,1652549880,126934
2351,pp1605,20150924,7172,7142,7143,7143,7080,7114,7113,-28,-29,36878,1311603140,133994
2352,pp1605,20150925,7114,7113,7129,7139,7006,7006,7071,-107,-42,60328,2133000890,126982
2353,pp1605,20150928,7006,7071,7001,7012,6937,6945,6984,-126,-87,55390,1934469480,114764
2354,pp1605,20150929,6945,6984,6950,6950,6792,6864,6846,-120,-138,57686,1974724710,122810
2355,pp1605,20150930,6864,6846,6860,6879,6816,6878,6851,32,5,28342,970940180,126802
2356,pp1605,20151008,6878,6851,7020,7040,6943,6978,6970,127,119,38894,1355535560,124640
2357,pp1605,20151009,6978,6970,7010,7233,7000,7188,7119,218,149,54218,1929972860,119560
2358,pp1605,20151012,7188,7119,7170,7177,7124,7157,7151,38,32,31606,1130129870,121622
2359,pp1605,20151013,7157,7151,7080,7085,7008,7046,7040,-105,-111,39184,1379427430,120452
2360,pp1605,20151014,7046,7040,7016,7083,6997,7011,7040,-29,0,33984,1196301340,128048
2361,pp1605,20151015,7011,7040,7025,7039,6987,6996,7010,-44,-30,37700,1321480970,132946
2362,pp1605,20151016,6996,7010,7024,7024,6917,6922,6956,-88,-54,36126,1256568360,140910
2363,pp1605,20151019,6922,6956,6925,6946,6853,6882,6893,-74,-63,40466,1394768730,148850
2364,pp1605,20151020,6882,6893,6843,6914,6840,6909,6872,16,-21,37746,1297022150,144044
2365,pp1605,20151021,6909,6872,6895,6912,6859,6896,6888,24,16,37000,1274280560,154226
2366,pp1605,20151022,6896,6888,6900,6997,6896,6941,6958,53,70,44944,1563804310,149124
2367,pp1605,20151023,6941,6958,6930,6958,6835,6888,6890,-70,-68,43074,1484097160,154044
2368,pp1605,20151026,6888,6890,6855,6868,6795,6811,6818,-79,-72,49626,1691908050,160152
2369,pp1605,20151027,6811,6818,6770,6805,6740,6776,6769,-42,-49,47864,1620129690,164394
2370,pp1605,20151028,6776,6769,6765,6792,6746,6782,6765,13,-4,38628,1306659950,166238
2371,pp1605,20151029,6782,6765,6870,6873,6761,6763,6806,-2,41,38846,1321970710,165620
2372,pp1605,20151030,6763,6806,6776,6776,6665,6703,6713,-103,-93,56738,1904473960,178556
2373,pp1605,20151102,6703,6713,6703,6773,6686,6722,6721,9,8,49890,1676782040,178556
2374,pp1605,20151103,6722,6721,6721,6723,6634,6644,6671,-77,-50,81434,2716348560,187016
2375,pp1605,20151104,6644,6671,6666,6720,6650,6690,6682,19,11,86494,2890179730,192638
2376,pp1605,20151105,6690,6682,6655,6655,6526,6537,6591,-145,-91,103870,3423251500,201938
2377,pp1605,20151106,6537,6591,6500,6560,6485,6535,6522,-56,-69,93152,3038034550,199744
2378,pp1605,20151109,6535,6522,6470,6556,6470,6504,6519,-18,-3,61944,2019065000,203934
2379,pp1605,20151110,6504,6519,6498,6498,6311,6350,6388,-169,-131,137486,4391675930,208726
2380,pp1605,20151111,6350,6388,6320,6354,6266,6286,6307,-102,-81,122946,3877309400,216260
2381,pp1605,20151112,6286,6307,6250,6289,6213,6245,6246,-62,-61,170196,5315346200,220382
2382,pp1605,20151113,6245,6246,6220,6228,6111,6129,6177,-117,-69,211764,6541227370,230536
2383,pp1605,20151116,6129,6177,6110,6120,5986,5988,6050,-189,-127,241982,7320363470,250022
2384,pp1605,20151117,5988,6050,6010,6010,5895,5966,5949,-84,-101,343202,10209152470,248636
2385,pp1605,20151118,5966,5949,5980,5980,5836,5892,5899,-57,-50,330666,9754075090,250410
2386,pp1605,20151119,5892,5899,5892,5964,5810,5826,5876,-73,-23,332456,9768832270,260086
2387,pp1605,20151120,5826,5876,5845,5871,5641,5641,5693,-235,-183,480916,13691234360,298186
2388,pp1605,20151123,5641,5693,5639,5639,5352,5352,5414,-341,-279,589974,15970838070,332518
2389,pp1605,20151124,5352,5414,5348,5608,5335,5570,5486,156,72,960352,26344408080,329650
2390,pp1605,20151125,5570,5486,5620,5660,5440,5530,5520,44,34,1151526,31784175170,381792
2391,pp1605,20151126,5530,5520,5520,5740,5505,5740,5681,220,161,1178546,33480739260,340214
2392,pp1605,20151127,5740,5681,5740,5810,5638,5724,5702,43,21,1466588,41812667470,346492
2393,pp1605,20151130,5724,5702,5690,5690,5525,5665,5604,-37,-98,1487366,41676243150,363938
2394,pp1605,20151201,5665,5604,5650,5846,5624,5804,5765,200,161,1801748,51937871330,395910
2395,pp1605,20151202,5804,5765,5830,5890,5743,5766,5808,1,43,1479292,42959182380,440504
2396,pp1605,20151203,5766,5808,5680,5797,5626,5777,5710,-31,-98,1488698,42504929300,457446
2397,pp1605,20151204,5777,5710,5820,5833,5696,5709,5755,-1,45,1472110,42361038050,454318
2398,pp1605,20151207,5709,5755,5627,5735,5551,5710,5684,-45,-71,1302884,37028543840,472772
2399,pp1605,20151208,5710,5684,5584,5611,5400,5400,5482,-284,-202,1487484,40773204260,513566
2400,pp1605,20151209,5400,5482,5424,5470,5383,5447,5434,-35,-48,1380366,37510542900,512054
2401,pp1605,20151210,5447,5434,5420,5496,5362,5466,5443,32,9,1589114,43253700480,538356
2402,pp1605,20151211,5466,5443,5446,5494,5410,5481,5456,38,13,1413590,38562754730,575194
2403,pp1605,20151214,5481,5456,5420,5543,5361,5521,5471,65,15,1763012,48235294800,603972
2404,pp1605,20151215,5521,5471,5560,5606,5500,5523,5550,52,79,1285550,35680128660,590526
2405,pp1605,20151216,5523,5550,5519,5568,5505,5540,5539,-10,-11,1201566,33283235720,571470
2406,pp1605,20151217,5540,5539,5521,5625,5510,5529,5570,-10,31,1433718,39933652970,554626
2407,pp1605,20151218,5529,5570,5512,5569,5465,5565,5522,-5,-48,1525388,42121380370,559270
2408,pp1605,20151221,5565,5522,5575,5720,5546,5717,5630,195,108,1597198,44964282410,565696
2409,pp1605,20151222,5717,5630,5708,5795,5692,5794,5744,164,114,1510868,43395284180,575152
2410,pp1605,20151223,5794,5744,5782,5802,5680,5766,5738,22,-6,1543840,44295051240,586584
2411,pp1605,20151224,5766,5738,5801,5951,5796,5887,5888,149,150,2597512,76480512320,646276
2412,pp1605,20151225,5887,5888,5897,5914,5840,5870,5865,-18,-23,1469024,43085910740,633576
2413,pp1605,20151228,5870,5865,5868,5920,5731,5736,5807,-129,-58,1613154,46843432740,640722
2414,pp1605,20151229,5736,5807,5720,5842,5690,5825,5755,18,-52,1672192,48125361300,592636
2415,pp1605,20151230,5825,5755,5868,5898,5777,5815,5833,60,78,1843764,53782069590,605356
2416,pp1605,20151231,5815,5833,5806,5926,5787,5825,5859,-8,26,1982910,58093943140,595356
2417,pp1606,20150615,8101,8101,0,0,0,8048,8048,-53,-53,0,0,0
2418,pp1606,20150616,8048,8048,0,0,0,8149,8149,101,101,0,0,0
2419,pp1606,20150617,8149,8149,0,0,0,8025,8025,-124,-124,0,0,0
2420,pp1606,20150618,8025,8025,0,0,0,7975,7975,-50,-50,0,0,0
2421,pp1606,20150619,7975,7975,0,0,0,8021,8021,46,46,0,0,0
2422,pp1606,20150623,8021,8021,0,0,0,7998,7998,-23,-23,0,0,0
2423,pp1606,20150624,7998,7998,0,0,0,8059,8059,61,61,0,0,0
2424,pp1606,20150625,8059,8059,0,0,0,8058,8058,-1,-1,0,0,0
2425,pp1606,20150626,8058,8058,0,0,0,8111,8111,53,53,0,0,0
2426,pp1606,20150629,8111,8111,7829,8086,7828,8086,7966,-25,-145,34,1354340,4
2427,pp1606,20150630,8086,7966,0,0,0,7946,7946,-20,-20,0,0,4
2428,pp1606,20150701,7946,7946,0,0,0,7995,7995,49,49,0,0,4
2429,pp1606,20150702,7995,7995,7840,7840,7840,7840,7840,-155,-155,2,78400,6
2430,pp1606,20150703,7840,7840,8021,8021,7986,7986,8009,146,169,6,240280,0
2431,pp1606,20150706,7986,8009,0,0,0,7844,7844,-165,-165,0,0,0
2432,pp1606,20150707,7844,7844,0,0,0,7679,7679,-165,-165,0,0,0
2433,pp1606,20150708,7679,7679,0,0,0,7419,7419,-260,-260,0,0,0
2434,pp1606,20150709,7419,7419,0,0,0,7682,7682,263,263,0,0,0
2435,pp1606,20150710,7682,7682,0,0,0,7811,7811,129,129,0,0,0
2436,pp1606,20150713,7811,7811,7510,7832,7510,7832,7671,21,-140,20,767100,10
2437,pp1606,20150714,7832,7671,7549,7885,7549,7885,7717,214,46,8,308680,6
2438,pp1606,20150715,7885,7717,0,0,0,7688,7688,-29,-29,0,0,6
2439,pp1606,20150716,7688,7688,0,0,0,7576,7576,-112,-112,0,0,6
2440,pp1606,20150717,7576,7576,0,0,0,7571,7571,-5,-5,0,0,6
2441,pp1606,20150720,7571,7571,0,0,0,7587,7587,16,16,0,0,6
2442,pp1606,20150721,7587,7587,0,0,0,7584,7584,-3,-3,0,0,6
2443,pp1606,20150722,7584,7584,0,0,0,7649,7649,65,65,0,0,6
2444,pp1606,20150723,7649,7649,0,0,0,7666,7666,17,17,0,0,6
2445,pp1606,20150724,7666,7666,0,0,0,7525,7525,-141,-141,0,0,6
2446,pp1606,20150727,7525,7525,0,0,0,7329,7329,-196,-196,0,0,6
2447,pp1606,20150728,7329,7329,0,0,0,7368,7368,39,39,0,0,6
2448,pp1606,20150729,7368,7368,0,0,0,7497,7497,129,129,0,0,6
2449,pp1606,20150730,7497,7497,0,0,0,7484,7484,-13,-13,0,0,6
2450,pp1606,20150731,7484,7484,0,0,0,7392,7392,-92,-92,0,0,6
2451,pp1606,20150803,7392,7392,0,0,0,7228,7228,-164,-164,0,0,6
2452,pp1606,20150804,7228,7228,0,0,0,7216,7216,-12,-12,0,0,6
2453,pp1606,20150805,7216,7216,0,0,0,7314,7314,98,98,0,0,6
2454,pp1606,20150806,7314,7314,0,0,0,7297,7297,-17,-17,0,0,6
2455,pp1606,20150807,7297,7297,0,0,0,7303,7303,6,6,0,0,6
2456,pp1606,20150810,7303,7303,0,0,0,7387,7387,84,84,0,0,6
2457,pp1606,20150811,7387,7387,0,0,0,7630,7630,243,243,0,0,6
2458,pp1606,20150812,7630,7630,0,0,0,7640,7640,10,10,0,0,6
2459,pp1606,20150813,7640,7640,7425,7602,7425,7602,7513,-38,-127,4,150270,6
2460,pp1606,20150814,7602,7513,0,0,0,7577,7577,64,64,0,0,6
2461,pp1606,20150817,7577,7577,0,0,0,7446,7446,-131,-131,0,0,6
2462,pp1606,20150818,7446,7446,0,0,0,7287,7287,-159,-159,0,0,6
2463,pp1606,20150819,7287,7287,0,0,0,7322,7322,35,35,0,0,6
2464,pp1606,20150820,7322,7322,0,0,0,7224,7224,-98,-98,0,0,6
2465,pp1606,20150821,7224,7224,0,0,0,7304,7304,80,80,0,0,6
2466,pp1606,20150824,7304,7304,0,0,0,7049,7049,-255,-255,0,0,6
2467,pp1606,20150825,7049,7049,0,0,0,7019,7019,-30,-30,0,0,6
2468,pp1606,20150826,7019,7019,0,0,0,7024,7024,5,5,0,0,6
2469,pp1606,20150827,7024,7024,0,0,0,7073,7073,49,49,0,0,6
2470,pp1606,20150828,7073,7073,0,0,0,7299,7299,226,226,0,0,6
2471,pp1606,20150831,7299,7299,0,0,0,7216,7216,-83,-83,0,0,6
2472,pp1606,20150901,7216,7216,0,0,0,7317,7317,101,101,0,0,6
2473,pp1606,20150902,7317,7317,0,0,0,7254,7254,-63,-63,0,0,6
2474,pp1606,20150907,7254,7254,0,0,0,7344,7344,90,90,0,0,6
2475,pp1606,20150908,7344,7344,7333,7333,7124,7124,7228,-220,-116,4,144570,6
2476,pp1606,20150909,7124,7228,0,0,0,7339,7339,111,111,0,0,6
2477,pp1606,20150910,7339,7339,0,0,0,7216,7216,-123,-123,0,0,6
2478,pp1606,20150911,7216,7216,0,0,0,7299,7299,83,83,0,0,6
2479,pp1606,20150914,7299,7299,0,0,0,7269,7269,-30,-30,0,0,6
2480,pp1606,20150915,7269,7269,6984,7149,6984,7119,7081,-150,-188,28,991410,2
2481,pp1606,20150916,7119,7081,0,0,0,7072,7072,-9,-9,0,0,2
2482,pp1606,20150917,7072,7072,0,0,0,7094,7094,22,22,0,0,2
2483,pp1606,20150918,7094,7094,7166,7166,7166,7166,7166,72,72,2,71660,4
2484,pp1606,20150921,7166,7166,0,0,0,7172,7172,6,6,0,0,4
2485,pp1606,20150922,7172,7172,0,0,0,7180,7180,8,8,0,0,4
2486,pp1606,20150923,7180,7180,0,0,0,7155,7155,-25,-25,0,0,4
2487,pp1606,20150924,7155,7155,0,0,0,7126,7126,-29,-29,0,0,4
2488,pp1606,20150925,7126,7126,0,0,0,7084,7084,-42,-42,0,0,4
2489,pp1606,20150928,7084,7084,0,0,0,6997,6997,-87,-87,0,0,4
2490,pp1606,20150929,6997,6997,0,0,0,6859,6859,-138,-138,0,0,4
2491,pp1606,20150930,6859,6859,0,0,0,6864,6864,5,5,0,0,4
2492,pp1606,20151008,6864,6864,0,0,0,6983,6983,119,119,0,0,4
2493,pp1606,20151009,6983,6983,0,0,0,7132,7132,149,149,0,0,4
2494,pp1606,20151012,7132,7132,0,0,0,7132,7132,0,0,0,0,4
2495,pp1606,20151013,7132,7132,0,0,0,7132,7132,0,0,0,0,4
2496,pp1606,20151014,7132,7132,0,0,0,7132,7132,0,0,0,0,4
2497,pp1606,20151015,7132,7132,7054,7054,7016,7016,7035,-116,-97,24,844200,28
2498,pp1606,20151016,7016,7035,0,0,0,6973,6973,-62,-62,0,0,28
2499,pp1606,20151019,6973,6973,6922,6922,6872,6872,6905,-101,-68,6,207160,32
2500,pp1606,20151020,6872,6905,0,0,0,6905,6905,0,0,0,0,32
2501,pp1606,20151021,6905,6905,0,0,0,6921,6921,16,16,0,0,32
2502,pp1606,20151022,6921,6921,0,0,0,6991,6991,70,70,0,0,32
2503,pp1606,20151023,6991,6991,0,0,0,6923,6923,-68,-68,0,0,32
2504,pp1606,20151026,6923,6923,0,0,0,6851,6851,-72,-72,0,0,32
2505,pp1606,20151027,6851,6851,0,0,0,6802,6802,-49,-49,0,0,32
2506,pp1606,20151028,6802,6802,0,0,0,6798,6798,-4,-4,0,0,32
2507,pp1606,20151029,6798,6798,6841,6841,6841,6841,6841,43,43,14,478870,32
2508,pp1606,20151030,6841,6841,0,0,0,6841,6841,0,0,0,0,32
2509,pp1606,20151102,6841,6841,0,0,0,6849,6849,8,8,0,0,32
2510,pp1606,20151103,6849,6849,0,0,0,6799,6799,-50,-50,0,0,32
2511,pp1606,20151104,6799,6799,0,0,0,6810,6810,11,11,0,0,32
2512,pp1606,20151105,6810,6810,0,0,0,6718,6718,-92,-92,0,0,32
2513,pp1606,20151106,6718,6718,0,0,0,6648,6648,-70,-70,0,0,32
2514,pp1606,20151109,6648,6648,0,0,0,6645,6645,-3,-3,0,0,32
2515,pp1606,20151110,6645,6645,0,0,0,6512,6512,-133,-133,0,0,32
2516,pp1606,20151111,6512,6512,0,0,0,6430,6430,-82,-82,0,0,32
2517,pp1606,20151112,6430,6430,0,0,0,6368,6368,-62,-62,0,0,32
2518,pp1606,20151113,6368,6368,6171,6245,6143,6245,6199,-123,-169,40,1239920,30
2519,pp1606,20151116,6245,6199,0,0,0,6072,6072,-127,-127,0,0,30
2520,pp1606,20151117,6072,6072,0,0,0,5971,5971,-101,-101,0,0,30
2521,pp1606,20151118,5971,5971,0,0,0,5921,5921,-50,-50,0,0,30
2522,pp1606,20151119,5921,5921,5905,5990,5905,5990,5947,69,26,8,237900,30
2523,pp1606,20151120,5990,5947,0,0,0,5762,5762,-185,-185,0,0,30
2524,pp1606,20151123,5762,5762,0,0,0,5532,5532,-230,-230,0,0,30
2525,pp1606,20151124,5532,5532,0,0,0,5605,5605,73,73,0,0,30
2526,pp1606,20151125,5605,5605,0,0,0,5639,5639,34,34,0,0,30
2527,pp1606,20151126,5639,5639,5605,5864,5605,5864,5691,225,52,6,170740,32
2528,pp1606,20151127,5864,5691,5678,5741,5678,5741,5709,50,18,32,913500,32
2529,pp1606,20151130,5741,5709,5709,5709,5518,5518,5624,-191,-85,10,281230,30
2530,pp1606,20151201,5518,5624,5903,5903,5767,5828,5833,204,209,10,291670,30
2531,pp1606,20151202,5828,5833,5906,5906,5906,5906,5906,73,73,2,59060,30
2532,pp1606,20151203,5906,5906,0,0,0,5906,5906,0,0,0,0,30
2533,pp1606,20151204,5906,5906,0,0,0,5906,5906,0,0,0,0,30
2534,pp1606,20151207,5906,5906,5640,5733,5640,5712,5652,-194,-254,82,2317600,44
2535,pp1606,20151208,5712,5652,5611,5673,5598,5598,5623,-54,-29,52,1462000,30
2536,pp1606,20151209,5598,5623,5406,5481,5406,5481,5443,-142,-180,88,2395140,30
2537,pp1606,20151210,5481,5443,0,0,0,5443,5443,0,0,0,0,30
2538,pp1606,20151211,5443,5443,5514,5514,5514,5514,5514,71,71,4,110280,30
2539,pp1606,20151214,5514,5514,5384,5574,5371,5491,5482,-23,-32,60,1644670,30
2540,pp1606,20151215,5491,5482,0,0,0,5561,5561,79,79,0,0,30
2541,pp1606,20151216,5561,5561,5585,5623,5492,5552,5584,-9,23,706,19713190,30
2542,pp1606,20151217,5552,5584,0,0,0,5615,5615,31,31,0,0,30
2543,pp1606,20151218,5615,5615,5580,5617,5545,5581,5581,-34,-34,90,2511600,30
2544,pp1606,20151221,5581,5581,5694,5694,5685,5685,5687,104,106,8,227510,34
2545,pp1606,20151222,5685,5687,5726,5776,5726,5776,5751,89,64,4,115020,30
2546,pp1606,20151223,5776,5751,0,0,0,5805,5805,54,54,0,0,30
2547,pp1606,20151224,5805,5805,0,0,0,5956,5956,151,151,0,0,30
2548,pp1606,20151225,5956,5956,5807,5949,5807,5949,5878,-7,-78,4,117560,30
2549,pp1606,20151228,5949,5878,5792,5984,5792,5815,5851,-63,-27,62,1813840,30
2550,pp1606,20151229,5815,5851,5750,5837,5750,5837,5820,-14,-31,14,407440,36
2551,pp1606,20151230,5837,5820,5883,5995,5785,5861,5889,41,69,44,1295630,36
2552,pp1606,20151231,5861,5889,5966,5984,5814,5848,5945,-41,56,220,6539900,32
2553,pp1607,20150715,7676,7676,0,0,0,7648,7648,-28,-28,0,0,0
2554,pp1607,20150716,7648,7648,0,0,0,7537,7537,-111,-111,0,0,0
2555,pp1607,20150717,7537,7537,0,0,0,7533,7533,-4,-4,0,0,0
2556,pp1607,20150720,7533,7533,0,0,0,7548,7548,15,15,0,0,0
2557,pp1607,20150721,7548,7548,0,0,0,7546,7546,-2,-2,0,0,0
2558,pp1607,20150722,7546,7546,0,0,0,7610,7610,64,64,0,0,0
2559,pp1607,20150723,7610,7610,0,0,0,7626,7626,16,16,0,0,0
2560,pp1607,20150724,7626,7626,0,0,0,7486,7486,-140,-140,0,0,0
2561,pp1607,20150727,7486,7486,0,0,0,7291,7291,-195,-195,0,0,0
2562,pp1607,20150728,7291,7291,0,0,0,7329,7329,38,38,0,0,0
2563,pp1607,20150729,7329,7329,0,0,0,7457,7457,128,128,0,0,0
2564,pp1607,20150730,7457,7457,0,0,0,7445,7445,-12,-12,0,0,0
2565,pp1607,20150731,7445,7445,0,0,0,7354,7354,-91,-91,0,0,0
2566,pp1607,20150803,7354,7354,0,0,0,7354,7354,0,0,0,0,0
2567,pp1607,20150804,7354,7354,0,0,0,7354,7354,0,0,0,0,0
2568,pp1607,20150805,7354,7354,0,0,0,7454,7454,100,100,0,0,0
2569,pp1607,20150806,7454,7454,0,0,0,7454,7454,0,0,0,0,0
2570,pp1607,20150807,7454,7454,0,0,0,7460,7460,6,6,0,0,0
2571,pp1607,20150810,7460,7460,0,0,0,7460,7460,0,0,0,0,0
2572,pp1607,20150811,7460,7460,0,0,0,7460,7460,0,0,0,0,0
2573,pp1607,20150812,7460,7460,0,0,0,7460,7460,0,0,0,0,0
2574,pp1607,20150813,7460,7460,0,0,0,7460,7460,0,0,0,0,0
2575,pp1607,20150814,7460,7460,0,0,0,7460,7460,0,0,0,0,0
2576,pp1607,20150817,7460,7460,0,0,0,7460,7460,0,0,0,0,0
2577,pp1607,20150818,7460,7460,0,0,0,7460,7460,0,0,0,0,0
2578,pp1607,20150819,7460,7460,0,0,0,7460,7460,0,0,0,0,0
2579,pp1607,20150820,7460,7460,0,0,0,7460,7460,0,0,0,0,0
2580,pp1607,20150821,7460,7460,0,0,0,7460,7460,0,0,0,0,0
2581,pp1607,20150824,7460,7460,7187,7187,7174,7174,7176,-286,-284,12,430570,12
2582,pp1607,20150825,7174,7176,7108,7108,7108,7108,7108,-68,-68,10,355400,22
2583,pp1607,20150826,7108,7108,0,0,0,7114,7114,6,6,0,0,22
2584,pp1607,20150827,7114,7114,0,0,0,7164,7164,50,50,0,0,22
2585,pp1607,20150828,7164,7164,0,0,0,7393,7393,229,229,0,0,22
2586,pp1607,20150831,7393,7393,0,0,0,7309,7309,-84,-84,0,0,22
2587,pp1607,20150901,7309,7309,0,0,0,7412,7412,103,103,0,0,22
2588,pp1607,20150902,7412,7412,0,0,0,7348,7348,-64,-64,0,0,22
2589,pp1607,20150907,7348,7348,0,0,0,7439,7439,91,91,0,0,22
2590,pp1607,20150908,7439,7439,0,0,0,7322,7322,-117,-117,0,0,22
2591,pp1607,20150909,7322,7322,0,0,0,7434,7434,112,112,0,0,22
2592,pp1607,20150910,7434,7434,0,0,0,7310,7310,-124,-124,0,0,22
2593,pp1607,20150911,7310,7310,0,0,0,7394,7394,84,84,0,0,22
2594,pp1607,20150914,7394,7394,0,0,0,7363,7363,-31,-31,0,0,22
2595,pp1607,20150915,7363,7363,0,0,0,7173,7173,-190,-190,0,0,22
2596,pp1607,20150916,7173,7173,0,0,0,7164,7164,-9,-9,0,0,22
2597,pp1607,20150917,7164,7164,0,0,0,7186,7186,22,22,0,0,22
2598,pp1607,20150918,7186,7186,0,0,0,7258,7258,72,72,0,0,22
2599,pp1607,20150921,7258,7258,0,0,0,7264,7264,6,6,0,0,22
2600,pp1607,20150922,7264,7264,0,0,0,7272,7272,8,8,0,0,22
2601,pp1607,20150923,7272,7272,0,0,0,7247,7247,-25,-25,0,0,22
2602,pp1607,20150924,7247,7247,0,0,0,7218,7218,-29,-29,0,0,22
2603,pp1607,20150925,7218,7218,0,0,0,7176,7176,-42,-42,0,0,22
2604,pp1607,20150928,7176,7176,0,0,0,7088,7088,-88,-88,0,0,22
2605,pp1607,20150929,7088,7088,0,0,0,6948,6948,-140,-140,0,0,22
2606,pp1607,20150930,6948,6948,0,0,0,6953,6953,5,5,0,0,22
2607,pp1607,20151008,6953,6953,0,0,0,7073,7073,120,120,0,0,22
2608,pp1607,20151009,7073,7073,7149,7149,7149,7149,7149,76,76,2,71490,24
2609,pp1607,20151012,7149,7149,0,0,0,7149,7149,0,0,0,0,24
2610,pp1607,20151013,7149,7149,0,0,0,7039,7039,-110,-110,0,0,24
2611,pp1607,20151014,7039,7039,0,0,0,7039,7039,0,0,0,0,24
2612,pp1607,20151015,7039,7039,0,0,0,6944,6944,-95,-95,0,0,24
2613,pp1607,20151016,6944,6944,0,0,0,6891,6891,-53,-53,0,0,24
2614,pp1607,20151019,6891,6891,0,0,0,6891,6891,0,0,0,0,24
2615,pp1607,20151020,6891,6891,0,0,0,6891,6891,0,0,0,0,24
2616,pp1607,20151021,6891,6891,0,0,0,6907,6907,16,16,0,0,24
2617,pp1607,20151022,6907,6907,0,0,0,6977,6977,70,70,0,0,24
2618,pp1607,20151023,6977,6977,0,0,0,6909,6909,-68,-68,0,0,24
2619,pp1607,20151026,6909,6909,0,0,0,6837,6837,-72,-72,0,0,24
2620,pp1607,20151027,6837,6837,0,0,0,6788,6788,-49,-49,0,0,24
2621,pp1607,20151028,6788,6788,0,0,0,6784,6784,-4,-4,0,0,24
2622,pp1607,20151029,6784,6784,0,0,0,6826,6826,42,42,0,0,24
2623,pp1607,20151030,6826,6826,0,0,0,6826,6826,0,0,0,0,24
2624,pp1607,20151102,6826,6826,0,0,0,6834,6834,8,8,0,0,24
2625,pp1607,20151103,6834,6834,6809,6809,6809,6809,6809,-25,-25,4,136180,28
2626,pp1607,20151104,6809,6809,6775,6775,6775,6775,6775,-34,-34,4,135500,32
2627,pp1607,20151105,6775,6775,0,0,0,6683,6683,-92,-92,0,0,32
2628,pp1607,20151106,6683,6683,0,0,0,6614,6614,-69,-69,0,0,32
2629,pp1607,20151109,6614,6614,0,0,0,6611,6611,-3,-3,0,0,32
2630,pp1607,20151110,6611,6611,0,0,0,6479,6479,-132,-132,0,0,32
2631,pp1607,20151111,6479,6479,0,0,0,6397,6397,-82,-82,0,0,32
2632,pp1607,20151112,6397,6397,6249,6369,6241,6353,6276,-44,-121,16,502080,24
2633,pp1607,20151113,6353,6276,0,0,0,6110,6110,-166,-166,0,0,24
2634,pp1607,20151116,6110,6110,0,0,0,5985,5985,-125,-125,0,0,24
2635,pp1607,20151117,5985,5985,0,0,0,5886,5886,-99,-99,0,0,24
2636,pp1607,20151118,5886,5886,0,0,0,5837,5837,-49,-49,0,0,24
2637,pp1607,20151119,5837,5837,0,0,0,5862,5862,25,25,0,0,24
2638,pp1607,20151120,5862,5862,0,0,0,5680,5680,-182,-182,0,0,24
2639,pp1607,20151123,5680,5680,0,0,0,5453,5453,-227,-227,0,0,24
2640,pp1607,20151124,5453,5453,0,0,0,5525,5525,72,72,0,0,24
2641,pp1607,20151125,5525,5525,0,0,0,5559,5559,34,34,0,0,24
2642,pp1607,20151126,5559,5559,0,0,0,5610,5610,51,51,0,0,24
2643,pp1607,20151127,5610,5610,5704,5704,5704,5704,5704,94,94,4,114080,24
2644,pp1607,20151130,5704,5704,5664,5664,5664,5664,5664,-40,-40,2,56640,24
2645,pp1607,20151201,5664,5664,5655,5655,5655,5655,5655,-9,-9,2,56550,24
2646,pp1607,20151202,5655,5655,0,0,0,5725,5725,70,70,0,0,24
2647,pp1607,20151203,5725,5725,5523,5702,5523,5656,5631,-69,-94,224,6307200,24
2648,pp1607,20151204,5656,5631,0,0,0,5675,5675,44,44,0,0,24
2649,pp1607,20151207,5675,5675,0,0,0,5431,5431,-244,-244,0,0,24
2650,pp1607,20151208,5431,5431,0,0,0,5404,5404,-27,-27,0,0,24
2651,pp1607,20151209,5404,5404,0,0,0,5232,5232,-172,-172,0,0,24
2652,pp1607,20151210,5232,5232,0,0,0,5232,5232,0,0,0,0,24
2653,pp1607,20151211,5232,5232,0,0,0,5300,5300,68,68,0,0,24
2654,pp1607,20151214,5300,5300,0,0,0,5270,5270,-30,-30,0,0,24
2655,pp1607,20151215,5270,5270,0,0,0,5346,5346,76,76,0,0,24
2656,pp1607,20151216,5346,5346,0,0,0,5368,5368,22,22,0,0,24
2657,pp1607,20151217,5368,5368,0,0,0,5398,5398,30,30,0,0,24
2658,pp1607,20151218,5398,5398,0,0,0,5366,5366,-32,-32,0,0,24
2659,pp1607,20151221,5366,5366,0,0,0,5467,5467,101,101,0,0,24
2660,pp1607,20151222,5467,5467,5543,5714,5543,5714,5628,247,161,4,112570,24
2661,pp1607,20151223,5714,5628,5570,5570,5570,5570,5570,-58,-58,2,55700,24
2662,pp1607,20151224,5570,5570,5570,5570,5570,5570,5570,0,0,2,55700,24
2663,pp1607,20151225,5570,5570,0,0,0,5498,5498,-72,-72,0,0,24
2664,pp1607,20151228,5498,5498,5614,5724,5614,5723,5696,225,198,16,455680,24
2665,pp1607,20151229,5723,5696,0,0,0,5666,5666,-30,-30,0,0,24
2666,pp1607,20151230,5666,5666,0,0,0,5733,5733,67,67,0,0,24
2667,pp1607,20151231,5733,5733,0,0,0,5787,5787,54,54,0,0,24
2668,pp1608,20150817,7587,7587,0,0,0,7587,7587,0,0,0,0,0
2669,pp1608,20150818,7587,7587,0,0,0,7587,7587,0,0,0,0,0
2670,pp1608,20150819,7587,7587,0,0,0,7624,7624,37,37,0,0,0
2671,pp1608,20150820,7624,7624,0,0,0,7522,7522,-102,-102,0,0,0
2672,pp1608,20150821,7522,7522,0,0,0,7605,7605,83,83,0,0,0
2673,pp1608,20150824,7605,7605,0,0,0,7316,7316,-289,-289,0,0,0
2674,pp1608,20150825,7316,7316,0,0,0,7247,7247,-69,-69,0,0,0
2675,pp1608,20150826,7247,7247,0,0,0,7253,7253,6,6,0,0,0
2676,pp1608,20150827,7253,7253,0,0,0,7304,7304,51,51,0,0,0
2677,pp1608,20150828,7304,7304,0,0,0,7538,7538,234,234,0,0,0
2678,pp1608,20150831,7538,7538,0,0,0,7453,7453,-85,-85,0,0,0
2679,pp1608,20150901,7453,7453,0,0,0,7558,7558,105,105,0,0,0
2680,pp1608,20150902,7558,7558,0,0,0,7493,7493,-65,-65,0,0,0
2681,pp1608,20150907,7493,7493,0,0,0,7586,7586,93,93,0,0,0
2682,pp1608,20150908,7586,7586,0,0,0,7467,7467,-119,-119,0,0,0
2683,pp1608,20150909,7467,7467,0,0,0,7581,7581,114,114,0,0,0
2684,pp1608,20150910,7581,7581,0,0,0,7454,7454,-127,-127,0,0,0
2685,pp1608,20150911,7454,7454,0,0,0,7540,7540,86,86,0,0,0
2686,pp1608,20150914,7540,7540,0,0,0,7509,7509,-31,-31,0,0,0
2687,pp1608,20150915,7509,7509,0,0,0,7315,7315,-194,-194,0,0,0
2688,pp1608,20150916,7315,7315,0,0,0,7305,7305,-10,-10,0,0,0
2689,pp1608,20150917,7305,7305,0,0,0,7328,7328,23,23,0,0,0
2690,pp1608,20150918,7328,7328,0,0,0,7402,7402,74,74,0,0,0
2691,pp1608,20150921,7402,7402,0,0,0,7408,7408,6,6,0,0,0
2692,pp1608,20150922,7408,7408,0,0,0,7416,7416,8,8,0,0,0
2693,pp1608,20150923,7416,7416,0,0,0,7391,7391,-25,-25,0,0,0
2694,pp1608,20150924,7391,7391,0,0,0,7361,7361,-30,-30,0,0,0
2695,pp1608,20150925,7361,7361,0,0,0,7318,7318,-43,-43,0,0,0
2696,pp1608,20150928,7318,7318,0,0,0,7318,7318,0,0,0,0,0
2697,pp1608,20150929,7318,7318,0,0,0,7174,7174,-144,-144,0,0,0
2698,pp1608,20150930,7174,7174,0,0,0,7179,7179,5,5,0,0,0
2699,pp1608,20151008,7179,7179,0,0,0,7303,7303,124,124,0,0,0
2700,pp1608,20151009,7303,7303,0,0,0,7381,7381,78,78,0,0,0
2701,pp1608,20151012,7381,7381,0,0,0,7254,7254,-127,-127,0,0,0
2702,pp1608,20151013,7254,7254,0,0,0,7142,7142,-112,-112,0,0,0
2703,pp1608,20151014,7142,7142,0,0,0,7142,7142,0,0,0,0,0
2704,pp1608,20151015,7142,7142,0,0,0,7045,7045,-97,-97,0,0,0
2705,pp1608,20151016,7045,7045,0,0,0,6991,6991,-54,-54,0,0,0
2706,pp1608,20151019,6991,6991,0,0,0,6991,6991,0,0,0,0,0
2707,pp1608,20151020,6991,6991,0,0,0,6991,6991,0,0,0,0,0
2708,pp1608,20151021,6991,6991,0,0,0,7007,7007,16,16,0,0,0
2709,pp1608,20151022,7007,7007,0,0,0,7078,7078,71,71,0,0,0
2710,pp1608,20151023,7078,7078,0,0,0,7009,7009,-69,-69,0,0,0
2711,pp1608,20151026,7009,7009,0,0,0,6936,6936,-73,-73,0,0,0
2712,pp1608,20151027,6936,6936,0,0,0,6887,6887,-49,-49,0,0,0
2713,pp1608,20151028,6887,6887,0,0,0,6883,6883,-4,-4,0,0,0
2714,pp1608,20151029,6883,6883,0,0,0,6926,6926,43,43,0,0,0
2715,pp1608,20151030,6926,6926,0,0,0,6926,6926,0,0,0,0,0
2716,pp1608,20151102,6926,6926,0,0,0,6934,6934,8,8,0,0,0
2717,pp1608,20151103,6934,6934,0,0,0,6934,6934,0,0,0,0,0
2718,pp1608,20151104,6934,6934,0,0,0,6900,6900,-34,-34,0,0,0
2719,pp1608,20151105,6900,6900,0,0,0,6807,6807,-93,-93,0,0,0
2720,pp1608,20151106,6807,6807,0,0,0,6736,6736,-71,-71,0,0,0
2721,pp1608,20151109,6736,6736,0,0,0,6733,6733,-3,-3,0,0,0
2722,pp1608,20151110,6733,6733,0,0,0,6598,6598,-135,-135,0,0,0
2723,pp1608,20151111,6598,6598,0,0,0,6515,6515,-83,-83,0,0,0
2724,pp1608,20151112,6515,6515,0,0,0,6392,6392,-123,-123,0,0,0
2725,pp1608,20151113,6392,6392,0,0,0,6223,6223,-169,-169,0,0,0
2726,pp1608,20151116,6223,6223,0,0,0,6096,6096,-127,-127,0,0,0
2727,pp1608,20151117,6096,6096,0,0,0,5995,5995,-101,-101,0,0,0
2728,pp1608,20151118,5995,5995,0,0,0,5945,5945,-50,-50,0,0,0
2729,pp1608,20151119,5945,5945,0,0,0,5971,5971,26,26,0,0,0
2730,pp1608,20151120,5971,5971,0,0,0,5786,5786,-185,-185,0,0,0
2731,pp1608,20151123,5786,5786,0,0,0,5503,5503,-283,-283,0,0,0
2732,pp1608,20151124,5503,5503,0,0,0,5576,5576,73,73,0,0,0
2733,pp1608,20151125,5576,5576,0,0,0,5610,5610,34,34,0,0,0
2734,pp1608,20151126,5610,5610,0,0,0,5661,5661,51,51,0,0,0
2735,pp1608,20151127,5661,5661,0,0,0,5755,5755,94,94,0,0,0
2736,pp1608,20151130,5755,5755,0,0,0,5715,5715,-40,-40,0,0,0
2737,pp1608,20151201,5715,5715,0,0,0,5706,5706,-9,-9,0,0,0
2738,pp1608,20151202,5706,5706,0,0,0,5777,5777,71,71,0,0,0
2739,pp1608,20151203,5777,5777,0,0,0,5683,5683,-94,-94,0,0,0
2740,pp1608,20151204,5683,5683,0,0,0,5727,5727,44,44,0,0,0
2741,pp1608,20151207,5727,5727,0,0,0,5481,5481,-246,-246,0,0,0
2742,pp1608,20151208,5481,5481,0,0,0,5453,5453,-28,-28,0,0,0
2743,pp1608,20151209,5453,5453,5197,5372,5197,5313,5291,-140,-162,90,2380990,8
2744,pp1608,20151210,5313,5291,0,0,0,5299,5299,8,8,0,0,8
2745,pp1608,20151211,5299,5299,0,0,0,5368,5368,69,69,0,0,8
2746,pp1608,20151214,5368,5368,0,0,0,5337,5337,-31,-31,0,0,8
2747,pp1608,20151215,5337,5337,5364,5364,5364,5364,5364,27,27,6,160920,6
2748,pp1608,20151216,5364,5364,0,0,0,5386,5386,22,22,0,0,6
2749,pp1608,20151217,5386,5386,0,0,0,5416,5416,30,30,0,0,6
2750,pp1608,20151218,5416,5416,0,0,0,5384,5384,-32,-32,0,0,6
2751,pp1608,20151221,5384,5384,0,0,0,5486,5486,102,102,0,0,6
2752,pp1608,20151222,5486,5486,5600,5707,5481,5481,5597,-5,111,8,223880,8
2753,pp1608,20151223,5481,5597,5562,5562,5562,5562,5562,-35,-35,2,55620,6
2754,pp1608,20151224,5562,5562,5813,5840,5285,5751,5640,189,78,72,2030610,6
2755,pp1608,20151225,5751,5640,0,0,0,5640,5640,0,0,0,0,6
2756,pp1608,20151228,5640,5640,0,0,0,5843,5843,203,203,0,0,6
2757,pp1608,20151229,5843,5843,0,0,0,5813,5813,-30,-30,0,0,6
2758,pp1608,20151230,5813,5813,0,0,0,5881,5881,68,68,0,0,6
2759,pp1608,20151231,5881,5881,0,0,0,5936,5936,55,55,0,0,6
2760,pp1609,20150917,7214,7214,7138,7138,6961,6961,7052,-253,-162,6450,227436020,4040
2761,pp1609,20150918,6961,7052,6980,7006,6932,6960,6970,-92,-82,3146,109641290,5422
2762,pp1609,20150921,6960,6970,6930,7018,6912,7008,6970,38,0,1700,59247880,5618
2763,pp1609,20150922,7008,6970,7027,7035,6964,6982,6994,12,24,1430,50010230,6016
2764,pp1609,20150923,6982,6994,7000,7019,6940,7000,6972,6,-22,1622,56545380,6564
2765,pp1609,20150924,7000,6972,6948,6995,6925,6960,6951,-12,-21,1758,61107990,7372
2766,pp1609,20150925,6960,6951,6978,6979,6873,6873,6907,-78,-44,2906,100365330,9262
2767,pp1609,20150928,6873,6907,6871,6873,6803,6813,6838,-94,-69,5898,201654070,11318
2768,pp1609,20150929,6813,6838,6770,6790,6668,6720,6709,-118,-129,11138,373640920,13404
2769,pp1609,20150930,6720,6709,6706,6762,6692,6762,6721,53,12,4734,159104960,15208
2770,pp1609,20151008,6762,6721,6880,6897,6817,6855,6836,134,115,6612,226018960,15974
2771,pp1609,20151009,6855,6836,6893,7093,6872,7067,6990,231,154,6296,220060330,16012
2772,pp1609,20151012,7067,6990,7020,7050,6980,7006,7009,16,19,8932,313054840,16996
2773,pp1609,20151013,7006,7009,6916,6938,6851,6896,6875,-113,-134,5758,197947240,17858
2774,pp1609,20151014,6896,6875,6881,6919,6830,6854,6863,-21,-12,8592,294861400,18346
2775,pp1609,20151015,6854,6863,6852,6869,6823,6830,6846,-33,-17,3188,109136480,18524
2776,pp1609,20151016,6830,6846,6840,6855,6773,6777,6800,-69,-46,3908,132885230,19792
2777,pp1609,20151019,6777,6800,6778,6800,6720,6742,6758,-58,-42,6790,229450450,21704
2778,pp1609,20151020,6742,6758,6742,6775,6705,6770,6736,12,-22,5416,182415430,21942
2779,pp1609,20151021,6770,6736,6770,6772,6723,6749,6750,13,14,2468,83300020,21824
2780,pp1609,20151022,6749,6750,6758,6846,6758,6796,6809,46,59,3224,109769970,20858
2781,pp1609,20151023,6796,6809,6796,6816,6715,6752,6761,-57,-48,4326,146257760,21728
2782,pp1609,20151026,6752,6761,6752,6752,6690,6702,6707,-59,-54,4176,140042340,22612
2783,pp1609,20151027,6702,6707,6670,6692,6650,6668,6667,-39,-40,3424,114148980,23990
2784,pp1609,20151028,6668,6667,6668,6684,6650,6680,6661,13,-6,2324,77402170,24958
2785,pp1609,20151029,6680,6661,6752,6767,6667,6670,6706,9,45,2422,81209730,25314
2786,pp1609,20151030,6670,6706,6670,6670,6615,6649,6636,-57,-70,5740,190474570,27928
2787,pp1609,20151102,6649,6636,6646,6689,6634,6662,6663,26,27,3338,111218410,28374
2788,pp1609,20151103,6662,6663,6675,6695,6638,6680,6672,17,9,12272,409419280,26698
2789,pp1609,20151104,6680,6672,6702,6775,6673,6713,6700,41,28,9682,324369190,27286
2790,pp1609,20151105,6713,6700,6678,6678,6560,6560,6609,-140,-91,8702,287559040,29562
2791,pp1609,20151106,6560,6609,6560,6560,6493,6532,6521,-77,-88,6322,206150680,30742
2792,pp1609,20151109,6532,6521,6521,6548,6480,6508,6512,-13,-9,2938,95663920,31264
2793,pp1609,20151110,6508,6512,6503,6503,6310,6341,6389,-171,-123,6658,212705800,34318
2794,pp1609,20151111,6341,6389,6346,6346,6253,6261,6285,-128,-104,9342,293609640,36530
2795,pp1609,20151112,6261,6285,6232,6246,6167,6194,6191,-91,-94,14642,453314000,41112
2796,pp1609,20151113,6194,6191,6155,6167,6066,6082,6133,-109,-58,14352,440154320,40980
2797,pp1609,20151116,6082,6133,6060,6067,5940,5940,5998,-193,-135,15256,457587540,44142
2798,pp1609,20151117,5940,5998,5958,5959,5871,5924,5914,-74,-84,16912,500142170,48470
2799,pp1609,20151118,5924,5914,5950,5950,5802,5839,5855,-75,-59,19992,585302170,51248
2800,pp1609,20151119,5839,5855,6089,6089,5770,5776,5826,-79,-29,22246,648088320,54598
2801,pp1609,20151120,5776,5826,5806,5816,5593,5593,5639,-233,-187,30276,853720930,57854
2802,pp1609,20151123,5593,5639,5535,5598,5301,5301,5351,-338,-288,43894,1174459860,64846
2803,pp1609,20151124,5301,5351,5318,5513,5261,5474,5378,123,27,53036,1426290810,68334
2804,pp1609,20151125,5474,5378,5520,5554,5356,5421,5428,43,50,44268,1201560940,74524
2805,pp1609,20151126,5421,5428,5450,5645,5402,5643,5578,215,150,52888,1475104550,75254
2806,pp1609,20151127,5643,5578,5645,5672,5508,5568,5570,-10,-8,40906,1139388670,75398
2807,pp1609,20151130,5568,5570,5560,5560,5353,5464,5420,-106,-150,35226,954784090,76912
2808,pp1609,20151201,5464,5420,5428,5635,5425,5600,5556,180,136,44644,1240294170,74988
2809,pp1609,20151202,5600,5556,5630,5687,5552,5586,5616,30,60,30008,842640140,77916
2810,pp1609,20151203,5586,5616,5505,5581,5439,5575,5505,-41,-111,34336,945262350,77600
2811,pp1609,20151204,5575,5505,5635,5635,5509,5521,5553,16,48,29542,820376170,82800
2812,pp1609,20151207,5521,5553,5443,5539,5375,5516,5480,-37,-73,26294,720477960,85630
2813,pp1609,20151208,5516,5480,5350,5410,5206,5206,5287,-274,-193,66302,1752937400,116632
2814,pp1609,20151209,5206,5287,5250,5287,5198,5259,5250,-28,-37,56924,1494337570,130080
2815,pp1609,20151210,5259,5250,5235,5300,5187,5271,5251,21,1,51548,1353538080,120804
2816,pp1609,20151211,5271,5251,5250,5289,5222,5272,5251,21,0,52598,1381199330,125502
2817,pp1609,20151214,5272,5251,5200,5296,5158,5287,5238,36,-13,74332,1946942450,127366
2818,pp1609,20151215,5287,5238,5330,5350,5260,5270,5305,32,67,54040,1433640600,123272
2819,pp1609,20151216,5270,5305,5299,5311,5253,5288,5285,-17,-20,38666,1021893190,124940
2820,pp1609,20151217,5288,5285,5260,5368,5252,5302,5317,17,32,49108,1305692770,125388
2821,pp1609,20151218,5302,5317,5275,5339,5265,5337,5299,20,-18,57096,1512993290,128574
2822,pp1609,20151221,5337,5299,5342,5495,5328,5491,5406,192,107,77952,2107358850,123794
2823,pp1609,20151222,5491,5406,5497,5575,5466,5575,5513,169,107,74544,2055105560,126986
2824,pp1609,20151223,5575,5513,5590,5612,5475,5578,5552,65,39,109316,3034681910,133496
2825,pp1609,20151224,5578,5552,5612,5739,5612,5672,5683,120,131,156744,4454590280,140464
2826,pp1609,20151225,5672,5683,5690,5699,5621,5647,5648,-36,-35,58552,1653560800,143066
2827,pp1609,20151228,5647,5648,5617,5686,5510,5515,5580,-133,-68,56630,1580032310,144284
2828,pp1609,20151229,5515,5580,5504,5600,5446,5590,5509,10,-71,80878,2228157810,144774
2829,pp1609,20151230,5590,5509,5615,5651,5570,5594,5610,85,101,100734,2825957970,160986
2830,pp1609,20151231,5594,5610,5577,5689,5570,5616,5640,6,30,96634,2725186850,160290
2831,pp1610,20151022,6736,6736,0,0,0,6794,6794,58,58,0,0,0
2832,pp1610,20151023,6794,6794,0,0,0,6747,6747,-47,-47,0,0,0
2833,pp1610,20151026,6747,6747,6809,6809,6550,6669,6643,-78,-104,66,2192470,32
2834,pp1610,20151027,6669,6643,6489,6630,6489,6610,6612,-33,-31,30,991820,32
2835,pp1610,20151028,6610,6612,0,0,0,6607,6607,-5,-5,0,0,32
2836,pp1610,20151029,6607,6607,0,0,0,6651,6651,44,44,0,0,32
2837,pp1610,20151030,6651,6651,6615,6615,6615,6615,6615,-36,-36,2,66150,32
2838,pp1610,20151102,6615,6615,6680,6728,6621,6621,6675,6,60,20,667570,40
2839,pp1610,20151103,6621,6675,6733,6733,6733,6733,6733,58,58,14,471310,44
2840,pp1610,20151104,6733,6733,0,0,0,6761,6761,28,28,0,0,44
2841,pp1610,20151105,6761,6761,6739,6739,6595,6647,6667,-114,-94,30,1000080,64
2842,pp1610,20151106,6647,6667,0,0,0,6579,6579,-88,-88,0,0,64
2843,pp1610,20151109,6579,6579,6488,6616,6488,6616,6552,37,-27,20,655200,72
2844,pp1610,20151110,6616,6552,0,0,0,6420,6420,-132,-132,0,0,72
2845,pp1610,20151111,6420,6420,6268,6389,6251,6316,6290,-104,-130,12,377430,68
2846,pp1610,20151112,6316,6290,0,0,0,6290,6290,0,0,0,0,68
2847,pp1610,20151113,6290,6290,6098,6098,6098,6098,6098,-192,-192,2,60980,66
2848,pp1610,20151116,6098,6098,0,0,0,5964,5964,-134,-134,0,0,66
2849,pp1610,20151117,5964,5964,5882,6000,5882,6000,5941,36,-23,4,118820,66
2850,pp1610,20151118,6000,5941,5840,5880,5840,5880,5860,-61,-81,4,117200,64
2851,pp1610,20151119,5880,5860,0,0,0,5850,5850,-10,-10,0,0,64
2852,pp1610,20151120,5850,5850,5850,5875,5618,5618,5835,-232,-15,18,525180,62
2853,pp1610,20151123,5618,5835,0,0,0,5602,5602,-233,-233,0,0,62
2854,pp1610,20151124,5602,5602,5315,5315,5315,5315,5315,-287,-287,2,53150,64
2855,pp1610,20151125,5315,5315,0,0,0,5364,5364,49,49,0,0,64
2856,pp1610,20151126,5364,5364,0,0,0,5578,5578,214,214,0,0,64
2857,pp1610,20151127,5578,5578,0,0,0,5571,5571,-7,-7,0,0,64
2858,pp1610,20151130,5571,5571,0,0,0,5421,5421,-150,-150,0,0,64
2859,pp1610,20151201,5421,5421,0,0,0,5557,5557,136,136,0,0,64
2860,pp1610,20151202,5557,5557,0,0,0,5617,5617,60,60,0,0,64
2861,pp1610,20151203,5617,5617,0,0,0,5506,5506,-111,-111,0,0,64
2862,pp1610,20151204,5506,5506,0,0,0,5554,5554,48,48,0,0,64
2863,pp1610,20151207,5554,5554,5575,5615,5461,5615,5550,61,-4,6,166510,66
2864,pp1610,20151208,5615,5550,5335,5344,5321,5321,5330,-229,-220,8,213210,74
2865,pp1610,20151209,5321,5330,0,0,0,5293,5293,-37,-37,0,0,74
2866,pp1610,20151210,5293,5293,0,0,0,5294,5294,1,1,0,0,74
2867,pp1610,20151211,5294,5294,0,0,0,5294,5294,0,0,0,0,74
2868,pp1610,20151214,5294,5294,0,0,0,5281,5281,-13,-13,0,0,74
2869,pp1610,20151215,5281,5281,0,0,0,5348,5348,67,67,0,0,74
2870,pp1610,20151216,5348,5348,0,0,0,5328,5328,-20,-20,0,0,74
2871,pp1610,20151217,5328,5328,5334,5386,5312,5386,5330,58,2,12,319850,64
2872,pp1610,20151218,5386,5330,0,0,0,5312,5312,-18,-18,0,0,64
2873,pp1610,20151221,5312,5312,0,0,0,5312,5312,0,0,0,0,64
2874,pp1610,20151222,5312,5312,5570,5570,5570,5570,5570,258,258,10,278500,54
2875,pp1610,20151223,5570,5570,5600,5610,5600,5600,5601,30,31,16,448100,54
2876,pp1610,20151224,5600,5601,5700,5700,5700,5700,5700,99,99,2,57000,52
2877,pp1610,20151225,5700,5700,0,0,0,5700,5700,0,0,0,0,52
2878,pp1610,20151228,5700,5700,5784,5786,5784,5786,5785,86,85,60,1735780,110
2879,pp1610,20151229,5786,5785,0,0,0,5785,5785,0,0,0,0,110
2880,pp1610,20151230,5785,5785,0,0,0,5785,5785,0,0,0,0,110
2881,pp1610,20151231,5785,5785,0,0,0,5815,5815,30,30,0,0,110
2882,pp1611,20151116,6191,6191,6224,6224,5907,5915,6094,-276,-97,146,4449270,10
2883,pp1611,20151117,5915,6094,5881,6005,5860,5860,5928,-234,-166,42,1244910,14
2884,pp1611,20151118,5860,5928,5881,5881,5881,5881,5881,-47,-47,2,58810,14
2885,pp1611,20151119,5881,5881,5840,5840,5840,5840,5840,-41,-41,2,58400,16
2886,pp1611,20151120,5840,5840,5607,5607,5607,5607,5607,-233,-233,2,56070,16
2887,pp1611,20151123,5607,5607,5384,5417,5383,5383,5390,-224,-217,10,269500,24
2888,pp1611,20151124,5383,5390,5419,5449,5419,5449,5434,59,44,4,108680,20
2889,pp1611,20151125,5449,5434,0,0,0,5434,5434,0,0,0,0,20
2890,pp1611,20151126,5434,5434,5651,5651,5651,5651,5651,217,217,2,56510,20
2891,pp1611,20151127,5651,5651,0,0,0,5651,5651,0,0,0,0,20
2892,pp1611,20151130,5651,5651,0,0,0,5499,5499,-152,-152,0,0,20
2893,pp1611,20151201,5499,5499,0,0,0,5499,5499,0,0,0,0,20
2894,pp1611,20151202,5499,5499,0,0,0,5499,5499,0,0,0,0,20
2895,pp1611,20151203,5499,5499,0,0,0,5499,5499,0,0,0,0,20
2896,pp1611,20151204,5499,5499,0,0,0,5546,5546,47,47,0,0,20
2897,pp1611,20151207,5546,5546,0,0,0,5546,5546,0,0,0,0,20
2898,pp1611,20151208,5546,5546,0,0,0,5322,5322,-224,-224,0,0,20
2899,pp1611,20151209,5322,5322,0,0,0,5322,5322,0,0,0,0,20
2900,pp1611,20151210,5322,5322,0,0,0,5322,5322,0,0,0,0,20
2901,pp1611,20151211,5322,5322,0,0,0,5322,5322,0,0,0,0,20
2902,pp1611,20151214,5322,5322,0,0,0,5322,5322,0,0,0,0,20
2903,pp1611,20151215,5322,5322,0,0,0,5322,5322,0,0,0,0,20
2904,pp1611,20151216,5322,5322,0,0,0,5322,5322,0,0,0,0,20
2905,pp1611,20151217,5322,5322,0,0,0,5322,5322,0,0,0,0,20
2906,pp1611,20151218,5322,5322,0,0,0,5322,5322,0,0,0,0,20
2907,pp1611,20151221,5322,5322,5432,5432,5432,5432,5432,110,110,2,54320,22
2908,pp1611,20151222,5432,5432,0,0,0,5500,5500,68,68,0,0,22
2909,pp1611,20151223,5500,5500,5572,5572,5572,5572,5572,72,72,2,55720,24
2910,pp1611,20151224,5572,5572,0,0,0,5600,5600,28,28,0,0,24
2911,pp1611,20151225,5600,5600,0,0,0,5600,5600,0,0,0,0,24
2912,pp1611,20151228,5600,5600,0,0,0,5600,5600,0,0,0,0,24
2913,pp1611,20151229,5600,5600,0,0,0,5600,5600,0,0,0,0,24
2914,pp1611,20151230,5600,5600,5509,5509,5508,5508,5508,-92,-92,4,110170,20
2915,pp1611,20151231,5508,5508,0,0,0,5528,5528,20,20,0,0,20
2916,pp1612,20151215,5251,5251,0,0,0,5318,5318,67,67,0,0,0
2917,pp1612,20151216,5318,5318,5411,5411,5411,5411,5411,93,93,2,54110,2
2918,pp1612,20151217,5411,5411,0,0,0,5411,5411,0,0,0,0,2
2919,pp1612,20151218,5411,5411,0,0,0,5393,5393,-18,-18,0,0,2
2920,pp1612,20151221,5393,5393,0,0,0,5393,5393,0,0,0,0,2
2921,pp1612,20151222,5393,5393,5517,5517,5517,5517,5517,124,124,2,55170,2
2922,pp1612,20151223,5517,5517,5540,5598,5540,5598,5569,81,52,4,111380,2
2923,pp1612,20151224,5598,5569,0,0,0,5667,5667,98,98,0,0,2
2924,pp1612,20151225,5667,5667,0,0,0,5667,5667,0,0,0,0,2
2925,pp1612,20151228,5667,5667,0,0,0,5751,5751,84,84,0,0,2
2926,pp1612,20151229,5751,5751,0,0,0,5678,5678,-73,-73,0,0,2
2927,pp1612,20151230,5678,5678,0,0,0,5585,5585,-93,-93,0,0,2
2928,pp1612,20151231,5585,5585,0,0,0,5614,5614,29,29,0,0,2
