   ,合约,日期,前收盘价,前结算价,开盘价,最高价,最低价,收盘价,结算价,涨跌1,涨跌2,成交量,成交金额,持仓量
1,l1501,20150105,9860,9815,9615,9780,9475,9570,9660,-245,-155,5494,265436500,2982
2,l1501,20150106,9570,9660,9515,9515,9325,9325,9420,-335,-240,1148,54071500,1834
3,l1501,20150107,9325,9420,9330,9330,9230,9250,9290,-170,-130,226,10499850,1608
4,l1501,20150108,9250,9290,9200,9300,9200,9300,9235,10,-55,32,1477650,1576
5,l1501,20150109,9300,9235,9200,9250,9065,9065,9160,-170,-75,246,11266800,1430
6,l1501,20150112,9065,9160,9080,9080,9020,9025,9040,-135,-120,678,30648300,1360
7,l1501,20150113,9025,9040,9000,9000,9000,9000,9000,-40,-40,8,360000,1352
8,l1501,20150114,9000,9000,0,0,0,9000,9000,0,0,0,0,1352
9,l1501,20150115,9000,9000,0,0,0,9000,9000,0,0,0,0,1352
10,l1501,20150116,9000,9000,8640,8640,8640,8640,9540,-360,540,14,658800,0
11,l1502,20150105,9210,9210,8955,9840,8950,9840,9245,630,35,6,277450,18
12,l1502,20150106,9840,9245,0,0,0,9245,9245,0,0,0,0,18
13,l1502,20150107,9245,9245,8920,9400,8920,9400,9020,155,-225,28,1263350,14
14,l1502,20150108,9400,9020,0,0,0,9020,9020,0,0,0,0,14
15,l1502,20150109,9020,9020,0,0,0,8950,8950,-70,-70,0,0,14
16,l1502,20150112,8950,8950,0,0,0,8950,8950,0,0,0,0,14
17,l1502,20150113,8950,8950,0,0,0,8920,8920,-30,-30,0,0,14
18,l1502,20150114,8920,8920,0,0,0,8920,8920,0,0,0,0,14
19,l1502,20150115,8920,8920,8800,8800,8790,8790,8790,-130,-130,6,263800,12
20,l1502,20150116,8790,8790,8790,8790,8790,8790,8790,0,0,4,175800,8
21,l1502,20150119,8790,8790,0,0,0,8790,8790,0,0,0,0,8
22,l1502,20150120,8790,8790,0,0,0,8790,8790,0,0,0,0,8
23,l1502,20150121,8790,8790,0,0,0,9140,9140,350,350,0,0,8
24,l1502,20150122,9140,9140,9250,9250,9250,9250,9250,110,110,4,185000,8
25,l1502,20150123,9250,9250,9000,9000,8900,8900,8950,-350,-300,4,179000,4
26,l1502,20150126,8900,8950,0,0,0,8950,8950,0,0,0,0,4
27,l1502,20150127,8950,8950,0,0,0,8950,8950,0,0,0,0,4
28,l1502,20150128,8950,8950,0,0,0,8950,8950,0,0,0,0,4
29,l1502,20150129,8950,8950,0,0,0,8950,8950,0,0,0,0,4
30,l1502,20150130,8950,8950,0,0,0,8950,8950,0,0,0,0,4
31,l1502,20150202,8950,8950,0,0,0,8415,8415,-535,-535,0,0,4
32,l1502,20150203,8415,8415,7915,7915,7915,7915,7915,-500,-500,4,158300,4
33,l1502,20150204,7915,7915,0,0,0,7915,7915,0,0,0,0,4
34,l1502,20150205,7915,7915,0,0,0,7915,7915,0,0,0,0,4
35,l1502,20150206,7915,7915,0,0,0,7915,7915,0,0,0,0,4
36,l1502,20150209,7915,7915,0,0,0,7915,7915,0,0,0,0,4
37,l1502,20150210,7915,7915,0,0,0,7915,7915,0,0,0,0,4
38,l1502,20150211,7915,7915,0,0,0,7915,7915,0,0,0,0,4
39,l1502,20150212,7915,7915,0,0,0,7915,7915,0,0,0,0,4
40,l1502,20150213,7915,7915,0,0,0,7915,7915,0,0,0,0,0
41,l1503,20150105,9050,9050,8655,8860,8535,8535,8645,-515,-405,24,1037650,20
42,l1503,20150106,8535,8645,8565,8565,8565,8565,8565,-80,-80,2,85650,18
43,l1503,20150107,8565,8565,0,0,0,8565,8565,0,0,0,0,18
44,l1503,20150108,8565,8565,0,0,0,8565,8565,0,0,0,0,18
45,l1503,20150109,8565,8565,0,0,0,8500,8500,-65,-65,0,0,18
46,l1503,20150112,8500,8500,8220,8325,8200,8205,8225,-295,-275,12,493700,20
47,l1503,20150113,8205,8225,8200,8200,8105,8105,8150,-120,-75,4,163050,22
48,l1503,20150114,8105,8150,8185,8185,8105,8105,8145,-45,-5,4,162900,26
49,l1503,20150115,8105,8145,8190,8470,8190,8470,8340,325,195,12,500450,24
50,l1503,20150116,8470,8340,8535,8590,8500,8590,8540,250,200,6,256250,20
51,l1503,20150119,8590,8540,8600,8680,8600,8680,8650,140,110,12,519150,16
52,l1503,20150120,8680,8650,8745,8745,8610,8610,8665,-40,15,12,520000,10
53,l1503,20150121,8610,8665,8990,8990,8970,8970,8980,305,315,4,179600,10
54,l1503,20150122,8970,8980,8885,8885,8885,8885,8885,-95,-95,2,88850,10
55,l1503,20150123,8885,8885,8840,8840,8840,8840,8840,-45,-45,2,88400,8
56,l1503,20150126,8840,8840,0,0,0,8840,8840,0,0,0,0,8
57,l1503,20150127,8840,8840,0,0,0,8840,8840,0,0,0,0,8
58,l1503,20150128,8840,8840,0,0,0,8840,8840,0,0,0,0,8
59,l1503,20150129,8840,8840,0,0,0,8840,8840,0,0,0,0,8
60,l1503,20150130,8840,8840,0,0,0,8840,8840,0,0,0,0,8
61,l1503,20150202,8840,8840,0,0,0,8840,8840,0,0,0,0,8
62,l1503,20150203,8840,8840,8940,8940,8940,8940,8940,100,100,2,89400,8
63,l1503,20150204,8940,8940,9155,9155,9155,9155,9155,215,215,2,91550,6
64,l1503,20150205,9155,9155,0,0,0,9150,9150,-5,-5,0,0,6
65,l1503,20150206,9150,9150,9150,9150,9150,9150,9150,0,0,2,91500,6
66,l1503,20150209,9150,9150,8970,8970,8940,8940,8955,-210,-195,4,179100,8
67,l1503,20150210,8940,8955,0,0,0,8955,8955,0,0,0,0,8
68,l1503,20150211,8955,8955,0,0,0,8955,8955,0,0,0,0,8
69,l1503,20150212,8955,8955,0,0,0,8955,8955,0,0,0,0,8
70,l1503,20150213,8955,8955,0,0,0,8955,8955,0,0,0,0,8
71,l1503,20150216,8955,8955,0,0,0,9100,9100,145,145,0,0,8
72,l1503,20150217,9100,9100,0,0,0,9100,9100,0,0,0,0,8
73,l1503,20150225,9100,9100,0,0,0,9100,9100,0,0,0,0,8
74,l1503,20150226,9100,9100,8980,8980,8980,8980,8980,-120,-120,22,987800,8
75,l1503,20150227,8980,8980,8625,9295,8625,9295,9085,315,105,22,999500,14
76,l1503,20150302,9295,9085,9300,9480,9300,9480,9395,395,310,18,845800,32
77,l1503,20150303,9480,9395,0,0,0,9395,9395,0,0,0,0,32
78,l1503,20150304,9395,9395,0,0,0,9395,9395,0,0,0,0,32
79,l1503,20150305,9395,9395,0,0,0,9395,9395,0,0,0,0,32
80,l1503,20150306,9395,9395,0,0,0,9395,9395,0,0,0,0,32
81,l1503,20150309,9395,9395,0,0,0,9395,9395,0,0,0,0,32
82,l1503,20150310,9395,9395,0,0,0,9395,9395,0,0,0,0,32
83,l1503,20150311,9395,9395,0,0,0,9395,9395,0,0,0,0,32
84,l1503,20150312,9395,9395,0,0,0,9395,9395,0,0,0,0,32
85,l1503,20150313,9395,9395,0,0,0,9395,9395,0,0,0,0,0
86,l1504,20150105,8845,8845,8620,8650,8570,8650,8610,-195,-235,6,258400,76
87,l1504,20150106,8650,8610,0,0,0,8650,8650,40,40,0,0,76
88,l1504,20150107,8650,8650,0,0,0,8440,8440,-210,-210,0,0,76
89,l1504,20150108,8440,8440,0,0,0,8510,8510,70,70,0,0,76
90,l1504,20150109,8510,8510,8460,8460,8420,8440,8440,-70,-70,8,337700,76
91,l1504,20150112,8440,8440,8250,8300,8250,8300,8270,-140,-170,10,413500,76
92,l1504,20150113,8300,8270,8280,8280,8280,8280,8280,10,10,2,82800,76
93,l1504,20150114,8280,8280,8280,8435,8280,8325,8330,45,50,18,749900,66
94,l1504,20150115,8325,8330,8490,8490,8450,8450,8465,120,135,40,1693650,36
95,l1504,20150116,8450,8465,8495,8495,8495,8495,8495,30,30,2,84950,36
96,l1504,20150119,8495,8495,8645,8645,8520,8630,8600,135,105,38,1634050,32
97,l1504,20150120,8630,8600,0,0,0,8550,8550,-50,-50,0,0,32
98,l1504,20150121,8550,8550,0,0,0,8550,8550,0,0,0,0,32
99,l1504,20150122,8550,8550,8550,8745,8535,8535,8605,-15,55,8,344300,30
100,l1504,20150123,8535,8605,8555,8555,8480,8480,8515,-125,-90,8,340750,30
101,l1504,20150126,8480,8515,8405,8430,8360,8360,8395,-155,-120,8,335800,24
102,l1504,20150127,8360,8395,0,0,0,8395,8395,0,0,0,0,24
103,l1504,20150128,8395,8395,8385,8465,8385,8465,8425,70,30,4,168500,24
104,l1504,20150129,8465,8425,0,0,0,8425,8425,0,0,0,0,24
105,l1504,20150130,8425,8425,0,0,0,8425,8425,0,0,0,0,24
106,l1504,20150202,8425,8425,8550,8550,8550,8550,8550,125,125,4,171000,22
107,l1504,20150203,8550,8550,8680,8680,8680,8680,8680,130,130,2,86800,20
108,l1504,20150204,8680,8680,8835,8835,8835,8835,8835,155,155,4,176700,18
109,l1504,20150205,8835,8835,0,0,0,8720,8720,-115,-115,0,0,18
110,l1504,20150206,8720,8720,8935,8935,8935,8935,8935,215,215,2,89350,16
111,l1504,20150209,8935,8935,8890,8890,8890,8890,8890,-45,-45,6,266700,16
112,l1504,20150210,8890,8890,9030,9030,8870,8870,8975,-20,85,6,269300,14
113,l1504,20150211,8870,8975,0,0,0,8975,8975,0,0,0,0,14
114,l1504,20150212,8975,8975,0,0,0,8975,8975,0,0,0,0,14
115,l1504,20150213,8975,8975,9150,9150,9150,9150,9150,175,175,4,183000,18
116,l1504,20150216,9150,9150,0,0,0,9150,9150,0,0,0,0,18
117,l1504,20150217,9150,9150,0,0,0,9150,9150,0,0,0,0,18
118,l1504,20150225,9150,9150,9295,9295,9145,9145,9245,-5,95,12,554700,16
119,l1504,20150226,9145,9245,9480,9480,9480,9480,9480,235,235,2,94800,16
120,l1504,20150227,9480,9480,9445,9445,9445,9445,9445,-35,-35,2,94450,18
121,l1504,20150302,9445,9445,9545,9545,9545,9545,9545,100,100,2,95450,20
122,l1504,20150303,9545,9545,0,0,0,9545,9545,0,0,0,0,20
123,l1504,20150304,9545,9545,9295,9585,9290,9470,9435,-75,-110,20,943950,20
124,l1504,20150305,9470,9435,9460,9460,9290,9290,9370,-145,-65,6,281150,18
125,l1504,20150306,9290,9370,9350,9350,9350,9350,9350,-20,-20,2,93500,16
126,l1504,20150309,9350,9350,9260,9260,9260,9260,9260,-90,-90,2,92600,14
127,l1504,20150310,9260,9260,0,0,0,9260,9260,0,0,0,0,14
128,l1504,20150311,9260,9260,0,0,0,9230,9230,-30,-30,0,0,14
129,l1504,20150312,9230,9230,0,0,0,9235,9235,5,5,0,0,14
130,l1504,20150313,9235,9235,0,0,0,9235,9235,0,0,0,0,14
131,l1504,20150316,9235,9235,0,0,0,9235,9235,0,0,0,0,14
132,l1504,20150317,9235,9235,0,0,0,9270,9270,35,35,0,0,14
133,l1504,20150318,9270,9270,9465,9465,9465,9465,9465,195,195,2,94650,14
134,l1504,20150319,9465,9465,0,0,0,9465,9465,0,0,0,0,14
135,l1504,20150320,9465,9465,0,0,0,9465,9465,0,0,0,0,14
136,l1504,20150323,9465,9465,0,0,0,9465,9465,0,0,0,0,14
137,l1504,20150324,9465,9465,0,0,0,9465,9465,0,0,0,0,14
138,l1504,20150325,9465,9465,9630,9630,9565,9565,9605,100,140,6,288250,16
139,l1504,20150326,9565,9605,0,0,0,9605,9605,0,0,0,0,16
140,l1504,20150327,9605,9605,0,0,0,9605,9605,0,0,0,0,16
141,l1504,20150330,9605,9605,9980,9980,9915,9915,9965,310,360,10,498350,8
142,l1504,20150331,9915,9965,10360,10360,10360,10360,10360,395,395,2,103600,8
143,l1504,20150401,10360,10360,10980,10980,10980,10980,10980,620,620,4,219600,6
144,l1504,20150402,10980,10980,0,0,0,10980,10980,0,0,0,0,6
145,l1504,20150403,10980,10980,0,0,0,10980,10980,0,0,0,0,6
146,l1504,20150407,10980,10980,0,0,0,10980,10980,0,0,0,0,6
147,l1504,20150408,10980,10980,0,0,0,10980,10980,0,0,0,0,6
148,l1504,20150409,10980,10980,11635,11635,11635,11635,11635,655,655,4,232700,2
149,l1504,20150410,11635,11635,0,0,0,11635,11635,0,0,0,0,2
150,l1504,20150413,11635,11635,0,0,0,11700,11700,65,65,0,0,2
151,l1504,20150414,11700,11700,11900,11900,11900,11900,11900,200,200,2,119000,0
152,l1504,20150415,11900,11900,0,0,0,11425,11425,-475,-475,0,0,0
153,l1505,20150105,8585,8495,8540,8540,8265,8330,8385,-165,-110,779082,32667938650,402742
154,l1505,20150106,8330,8385,8300,8500,8225,8445,8350,60,-35,1168312,48785514450,506026
155,l1505,20150107,8445,8350,8380,8475,8285,8380,8375,30,25,1345648,56369424650,543988
156,l1505,20150108,8380,8375,8445,8460,8285,8290,8360,-85,-15,938734,39254741300,521644
157,l1505,20150109,8290,8360,8300,8315,8055,8095,8160,-265,-200,1701760,69467523100,558858
158,l1505,20150112,8095,8160,8055,8095,7945,8030,8025,-130,-135,1125148,45149431550,550808
159,l1505,20150113,8030,8025,7950,8055,7920,8005,8000,-20,-25,1059444,42380677950,548806
160,l1505,20150114,8005,8000,8025,8150,8025,8125,8085,125,85,1379548,55793479000,591678
161,l1505,20150115,8125,8085,8230,8365,8170,8360,8270,275,185,1444956,59766308100,601982
162,l1505,20150116,8360,8270,8300,8385,8250,8340,8315,70,45,1044956,43452373900,576324
163,l1505,20150119,8340,8315,8400,8510,8350,8490,8425,175,110,992862,41839569350,585118
164,l1505,20150120,8490,8425,8455,8465,8305,8345,8365,-80,-60,805830,33722212500,585556
165,l1505,20150121,8345,8365,8330,8490,8300,8450,8415,85,50,945896,39809997500,595038
166,l1505,20150122,8450,8415,8500,8545,8365,8400,8450,-15,35,1106476,46765270900,619714
167,l1505,20150123,8400,8450,8400,8410,8305,8360,8355,-90,-95,743546,31062563450,620920
168,l1505,20150126,8360,8355,8300,8320,8110,8135,8190,-220,-165,902156,36944368100,593982
169,l1505,20150127,8135,8190,8185,8245,8160,8190,8205,0,15,621704,25507981000,565850
170,l1505,20150128,8190,8205,8220,8270,8150,8270,8210,65,5,615710,25281182100,567848
171,l1505,20150129,8270,8210,8205,8310,8200,8295,8260,85,50,611108,25253149600,588744
172,l1505,20150130,8295,8260,8305,8315,8165,8165,8220,-95,-40,621016,25524196250,585274
173,l1505,20150202,8165,8220,8300,8420,8260,8375,8345,155,125,887414,37038360550,611610
174,l1505,20150203,8375,8345,8435,8635,8435,8630,8510,285,165,1135554,48327744650,616988
175,l1505,20150204,8630,8510,8730,8850,8610,8615,8725,105,215,1392350,60766944250,536306
176,l1505,20150205,8615,8725,8485,8580,8480,8545,8535,-180,-190,732686,31281477300,565020
177,l1505,20150206,8545,8535,8650,8860,8635,8850,8750,315,215,1311966,57431261500,555284
178,l1505,20150209,8850,8750,8800,8820,8715,8805,8765,55,15,833018,36514923650,556174
179,l1505,20150210,8805,8765,8765,8880,8755,8860,8825,95,60,825678,36434013200,594322
180,l1505,20150211,8860,8825,8810,8945,8795,8910,8875,85,50,878898,39016676700,634858
181,l1505,20150212,8910,8875,8890,8955,8845,8945,8895,70,20,754240,33554041450,618950
182,l1505,20150213,8945,8895,9000,9205,8990,9155,9100,260,205,1326618,60364111900,572348
183,l1505,20150216,9155,9100,9175,9245,9120,9225,9180,125,80,668340,30687508250,503252
184,l1505,20150217,9225,9180,9230,9310,9155,9270,9215,90,35,482938,22263077350,457040
185,l1505,20150225,9270,9215,9015,9285,9015,9250,9200,35,-15,579678,26670222900,468912
186,l1505,20150226,9250,9200,9340,9500,9285,9490,9380,290,180,806708,37846591850,570006
187,l1505,20150227,9490,9380,9430,9455,9330,9405,9400,25,20,827950,38915649800,504824
188,l1505,20150302,9405,9400,9560,9710,9470,9645,9590,245,190,1266814,60773443850,514240
189,l1505,20150303,9645,9590,9700,9715,9490,9515,9560,-75,-30,1163208,55618912500,442638
190,l1505,20150304,9515,9560,9525,9595,9435,9540,9515,-20,-45,952588,45324451150,449146
191,l1505,20150305,9540,9515,9440,9510,9285,9370,9405,-145,-110,1178868,55452340100,403184
192,l1505,20150306,9370,9405,9380,9380,9275,9350,9325,-55,-80,600714,28021176750,420522
193,l1505,20150309,9350,9325,9275,9340,9160,9310,9235,-15,-90,882212,40758161450,400038
194,l1505,20150310,9310,9235,9305,9365,9260,9305,9310,70,75,900402,41914482500,381598
195,l1505,20150311,9305,9310,9250,9285,9120,9125,9225,-185,-85,891356,41127142350,366864
196,l1505,20150312,9125,9225,9130,9490,9130,9485,9310,260,85,1229520,57240650950,352868
197,l1505,20150313,9485,9310,9450,9465,9340,9425,9410,115,100,761066,35808936700,334830
198,l1505,20150316,9425,9410,9275,9370,9185,9325,9280,-85,-130,778730,36151766700,308044
199,l1505,20150317,9325,9280,9330,9480,9310,9465,9405,185,125,858800,40395963100,304606
200,l1505,20150318,9465,9405,9405,9465,9225,9240,9350,-165,-55,945792,44221909250,283500
201,l1505,20150319,9240,9350,9380,9500,9310,9350,9410,0,60,645056,30354054100,276536
202,l1505,20150320,9350,9410,9365,9435,9355,9400,9395,-10,-15,311300,14625173350,271456
203,l1505,20150323,9400,9395,9480,9770,9445,9770,9680,375,285,495460,23989702450,292486
204,l1505,20150324,9770,9680,9850,9970,9805,9890,9880,210,200,460612,22765202100,250958
205,l1505,20150325,9890,9880,9840,9930,9820,9845,9865,-35,-15,272292,13436748650,256542
206,l1505,20150326,9845,9865,9950,10030,9870,10005,9965,140,100,310880,15490129700,241754
207,l1505,20150327,10005,9965,9985,10005,9840,9985,9925,20,-40,243816,12104149600,229470
208,l1505,20150330,9985,9925,9885,10020,9865,10015,9925,90,0,211122,10479393950,224814
209,l1505,20150331,10015,9925,10045,10115,10015,10020,10065,95,140,220364,11091866400,214056
210,l1505,20150401,10020,10065,9985,10150,9915,10145,10050,80,-15,196376,9869090600,205256
211,l1505,20150402,10145,10050,10250,10370,10190,10300,10290,250,240,240562,12379854700,196420
212,l1505,20150403,10300,10290,10280,10280,9960,10090,10120,-200,-170,339560,17185718400,187836
213,l1505,20150407,10090,10120,10205,10245,10045,10060,10120,-60,0,163862,8294754250,169192
214,l1505,20150408,10060,10120,10165,10320,10090,10235,10210,115,90,241846,12348539450,128622
215,l1505,20150409,10235,10210,10105,10185,10025,10105,10110,-105,-100,127700,6458018450,110840
216,l1505,20150410,10105,10110,10115,10145,9900,9930,10000,-180,-110,136376,6821914800,98532
217,l1505,20150413,9930,10000,9850,10020,9850,9965,9935,-35,-65,96440,4792796900,85362
218,l1505,20150414,9965,9935,9970,9995,9790,9820,9895,-115,-40,88500,4380688850,65422
219,l1505,20150415,9820,9895,9855,9870,9700,9760,9790,-135,-105,55840,2733583650,58714
220,l1505,20150416,9760,9790,9820,10070,9820,9950,9945,160,155,89266,4440761650,51810
221,l1505,20150417,9950,9945,9960,10095,9900,10020,10025,75,80,43760,2193621350,47618
222,l1505,20150420,10020,10025,10045,10145,10025,10110,10100,85,75,35640,1800019700,45802
223,l1505,20150421,10110,10100,10100,10200,10100,10155,10165,55,65,39766,2021469000,40360
224,l1505,20150422,10155,10165,10105,10170,10035,10060,10105,-105,-60,35052,1771751950,34260
225,l1505,20150423,10060,10105,10105,10235,10070,10200,10165,95,60,26732,1358969600,30900
226,l1505,20150424,10200,10165,10240,10400,10240,10390,10320,225,155,23628,1219678500,26026
227,l1505,20150427,10390,10320,10450,10715,10350,10700,10565,380,245,19400,1025171650,17292
228,l1505,20150428,10700,10565,10675,10730,10510,10595,10635,30,70,4012,213338450,14578
229,l1505,20150429,10595,10635,10580,10625,10460,10495,10540,-140,-95,8064,425118900,10396
230,l1505,20150430,10495,10540,10600,10935,10550,10895,10795,355,255,8846,477647900,8202
231,l1505,20150504,10895,10795,10720,11005,10720,10835,10915,40,120,2148,117241600,7238
232,l1505,20150505,10835,10915,10815,10815,10700,10770,10765,-145,-150,386,20781600,7168
233,l1505,20150506,10770,10765,10690,10730,10550,10550,10690,-215,-75,1412,75495300,5972
234,l1505,20150507,10550,10690,10545,10600,10545,10550,10555,-140,-135,62,3272800,5956
235,l1505,20150508,10550,10555,10120,10500,10120,10370,10300,-185,-255,62,3194450,5952
236,l1505,20150511,10370,10300,0,0,0,10300,10300,0,0,0,0,5952
237,l1505,20150512,10300,10300,10200,10200,10150,10150,10190,-150,-110,12,611500,5940
238,l1505,20150513,10150,10190,10080,10100,10030,10050,10035,-140,-155,172,8634300,5918
239,l1505,20150514,10050,10035,10635,10635,10150,10150,10180,115,145,32,1628850,5886
240,l1505,20150515,10150,10180,10140,10140,9800,10090,10750,-90,570,2920,156554150,0
241,l1506,20150105,8460,8435,8370,8370,8250,8250,8310,-185,-125,40,1662000,56
242,l1506,20150106,8250,8310,8170,8400,8170,8340,8330,30,20,108,4499900,68
243,l1506,20150107,8340,8330,8325,8330,8325,8330,8325,0,-5,4,166550,70
244,l1506,20150108,8330,8325,8345,8365,8270,8295,8310,-30,-15,28,1163800,74
245,l1506,20150109,8295,8310,8295,8295,8055,8100,8110,-210,-200,58,2352850,112
246,l1506,20150112,8100,8110,7975,7975,7950,7950,7950,-160,-160,16,636250,128
247,l1506,20150113,7950,7950,7930,8050,7930,8050,7985,100,35,58,2316850,126
248,l1506,20150114,8050,7985,8175,8175,8060,8095,8105,110,120,42,1702150,122
249,l1506,20150115,8095,8105,8235,8300,8180,8285,8220,180,115,118,4850400,118
250,l1506,20150116,8285,8220,8225,8330,8215,8330,8265,110,45,250,10333350,122
251,l1506,20150119,8330,8265,8350,8490,8345,8490,8360,225,95,112,4683900,194
252,l1506,20150120,8490,8360,8325,8335,8315,8330,8325,-30,-35,38,1582650,190
253,l1506,20150121,8330,8325,8360,8400,8360,8365,8375,40,50,6,251250,190
254,l1506,20150122,8365,8375,8515,8560,8365,8370,8470,-5,95,70,2964600,184
255,l1506,20150123,8370,8470,8315,8315,8315,8315,8315,-155,-155,2,83150,182
256,l1506,20150126,8315,8315,8190,8205,8180,8180,8195,-135,-120,72,2950850,136
257,l1506,20150127,8180,8195,0,0,0,8195,8195,0,0,0,0,136
258,l1506,20150128,8195,8195,8195,8260,8015,8245,8175,50,-20,64,2616600,134
259,l1506,20150129,8245,8175,8190,8265,8190,8255,8235,80,60,16,658900,132
260,l1506,20150130,8255,8235,0,0,0,8205,8205,-30,-30,0,0,132
261,l1506,20150202,8205,8205,8405,8405,8335,8335,8370,130,165,4,167400,130
262,l1506,20150203,8335,8370,8480,8480,8480,8480,8480,110,110,40,1696000,130
263,l1506,20150204,8480,8480,8580,8580,8580,8580,8580,100,100,200,8580000,300
264,l1506,20150205,8580,8580,8560,8560,8490,8490,8555,-90,-25,216,9240050,138
265,l1506,20150206,8490,8555,8725,8770,8625,8720,8705,165,150,30,1306000,132
266,l1506,20150209,8720,8705,8770,8845,8700,8845,8765,140,60,50,2191700,132
267,l1506,20150210,8845,8765,8945,8945,8815,8880,8880,115,115,92,4084800,130
268,l1506,20150211,8880,8880,8850,8900,8850,8885,8880,5,0,48,2132000,150
269,l1506,20150212,8885,8880,8840,8895,8805,8895,8835,15,-45,62,2739500,150
270,l1506,20150213,8895,8835,9090,9180,9090,9180,9105,345,270,24,1092600,140
271,l1506,20150216,9180,9105,9160,9165,9080,9130,9130,25,25,8,365350,138
272,l1506,20150217,9130,9130,0,0,0,9160,9160,30,30,0,0,138
273,l1506,20150225,9160,9160,0,0,0,9160,9160,0,0,0,0,138
274,l1506,20150226,9160,9160,9265,9265,9265,9265,9265,105,105,4,185300,142
275,l1506,20150227,9265,9265,9440,9445,9325,9350,9395,85,130,38,1785800,154
276,l1506,20150302,9350,9395,9490,9555,9450,9470,9495,75,100,34,1614250,146
277,l1506,20150303,9470,9495,9565,9565,9560,9560,9560,65,65,4,191250,146
278,l1506,20150304,9560,9560,9430,9435,9430,9435,9430,-125,-130,12,565900,142
279,l1506,20150305,9435,9430,0,0,0,9430,9430,0,0,0,0,142
280,l1506,20150306,9430,9430,9355,9355,9215,9290,9275,-140,-155,128,5936950,142
281,l1506,20150309,9290,9275,0,0,0,9275,9275,0,0,0,0,142
282,l1506,20150310,9275,9275,0,0,0,9275,9275,0,0,0,0,142
283,l1506,20150311,9275,9275,9185,9185,9180,9180,9180,-95,-95,4,183650,140
284,l1506,20150312,9180,9180,0,0,0,9180,9180,0,0,0,0,140
285,l1506,20150313,9180,9180,9335,9420,9315,9420,9345,240,165,14,654200,136
286,l1506,20150316,9420,9345,9150,9205,9150,9205,9175,-140,-170,6,275350,134
287,l1506,20150317,9205,9175,9350,9430,9335,9430,9375,255,200,64,3000150,136
288,l1506,20150318,9430,9375,9345,9345,9155,9155,9280,-220,-95,6,278450,136
289,l1506,20150319,9155,9280,9330,9465,9245,9245,9395,-35,115,570,26781200,310
290,l1506,20150320,9245,9395,9325,9345,9325,9345,9335,-50,-60,6,280150,304
291,l1506,20150323,9345,9335,9665,9700,9530,9650,9620,315,285,950,45707400,272
292,l1506,20150324,9650,9620,9775,9905,9700,9700,9795,80,175,242,11852300,236
293,l1506,20150325,9700,9795,0,0,0,9785,9785,-10,-10,0,0,236
294,l1506,20150326,9785,9785,9780,9780,9780,9780,9780,-5,-5,4,195600,236
295,l1506,20150327,9780,9780,9860,9860,9860,9860,9860,80,80,4,197200,236
296,l1506,20150330,9860,9860,9900,9960,9855,9895,9895,35,35,16,791600,236
297,l1506,20150331,9895,9895,9875,9980,9870,9905,9925,10,30,24,1191550,228
298,l1506,20150401,9905,9925,9980,9980,9980,9980,9980,55,55,6,299400,228
299,l1506,20150402,9980,9980,10140,10145,10125,10145,10135,165,155,16,810950,226
300,l1506,20150403,10145,10135,10010,10010,10010,10010,10010,-125,-125,12,600600,230
301,l1506,20150407,10010,10010,9930,9950,9870,9870,9915,-140,-95,16,793300,228
302,l1506,20150408,9870,9915,10030,10030,9890,10010,9935,95,20,20,993550,224
303,l1506,20150409,10010,9935,0,0,0,9935,9935,0,0,0,0,224
304,l1506,20150410,9935,9935,9895,9895,9720,9720,9805,-215,-130,10,490350,222
305,l1506,20150413,9720,9805,9755,9755,9755,9755,9755,-50,-50,20,975500,206
306,l1506,20150414,9755,9755,0,0,0,9665,9665,-90,-90,0,0,206
307,l1506,20150415,9665,9665,9675,9705,9585,9650,9635,-15,-30,22,1059950,204
308,l1506,20150416,9650,9635,9690,9830,9690,9830,9745,195,110,10,487400,200
309,l1506,20150417,9830,9745,9775,9845,9775,9795,9790,50,45,16,783300,194
310,l1506,20150420,9795,9790,9805,9925,9805,9885,9885,95,95,20,988750,186
311,l1506,20150421,9885,9885,0,0,0,9885,9885,0,0,0,0,186
312,l1506,20150422,9885,9885,0,0,0,9885,9885,0,0,0,0,186
313,l1506,20150423,9885,9885,10045,10050,10045,10050,10045,165,160,4,200950,186
314,l1506,20150424,10050,10045,0,0,0,10115,10115,70,70,0,0,186
315,l1506,20150427,10115,10115,10475,10510,10475,10510,10490,395,375,22,1154000,192
316,l1506,20150428,10510,10490,10625,10905,10570,10880,10770,390,280,142,7647250,128
317,l1506,20150429,10880,10770,10710,10710,10705,10705,10705,-65,-65,6,321250,122
318,l1506,20150430,10705,10705,10915,10915,10815,10815,10865,110,160,4,217300,124
319,l1506,20150504,10815,10865,10920,10920,10920,10920,10920,55,55,8,436800,124
320,l1506,20150505,10920,10920,0,0,0,10920,10920,0,0,0,0,124
321,l1506,20150506,10920,10920,10905,10905,10760,10820,10855,-100,-65,10,542950,122
322,l1506,20150507,10820,10855,10700,10700,10620,10620,10675,-235,-180,10,533900,118
323,l1506,20150508,10620,10675,0,0,0,10420,10420,-255,-255,0,0,118
324,l1506,20150511,10420,10420,10765,10765,10445,10445,10510,25,90,16,840900,112
325,l1506,20150512,10445,10510,10405,10405,10405,10405,10405,-105,-105,4,208100,112
326,l1506,20150513,10405,10405,10385,10430,10270,10270,10365,-135,-40,14,725600,114
327,l1506,20150514,10270,10365,10530,10530,10415,10415,10470,50,105,4,209450,114
328,l1506,20150515,10415,10470,10300,10500,10300,10500,10430,30,-40,6,313000,112
329,l1506,20150518,10500,10430,10290,10300,10290,10300,10290,-130,-140,30,1544000,112
330,l1506,20150519,10300,10290,10300,10300,10095,10095,10165,-195,-125,6,304950,112
331,l1506,20150520,10095,10165,9995,9995,9995,9995,9995,-170,-170,2,99950,112
332,l1506,20150521,9995,9995,10100,10100,9805,9940,9985,-55,-10,28,1397950,116
333,l1506,20150522,9940,9985,9755,10300,9755,10290,10240,305,255,22,1126700,112
334,l1506,20150525,10290,10240,0,0,0,10250,10250,10,10,0,0,112
335,l1506,20150526,10250,10250,10295,10300,10200,10200,10270,-50,20,12,616450,112
336,l1506,20150527,10200,10270,9900,10150,9900,9900,9980,-370,-290,40,1996000,104
337,l1506,20150528,9900,9980,0,0,0,9980,9980,0,0,0,0,104
338,l1506,20150529,9980,9980,9590,9980,9590,9650,9750,-330,-230,16,780200,94
339,l1506,20150601,9650,9750,0,0,0,9750,9750,0,0,0,0,94
340,l1506,20150602,9750,9750,0,0,0,9750,9750,0,0,0,0,94
341,l1506,20150603,9750,9750,0,0,0,9700,9700,-50,-50,0,0,94
342,l1506,20150604,9700,9700,0,0,0,9700,9700,0,0,0,0,94
343,l1506,20150605,9700,9700,0,0,0,9700,9700,0,0,0,0,94
344,l1506,20150608,9700,9700,0,0,0,9700,9700,0,0,0,0,94
345,l1506,20150609,9700,9700,0,0,0,9700,9700,0,0,0,0,94
346,l1506,20150610,9700,9700,0,0,0,9700,9700,0,0,0,0,94
347,l1506,20150611,9700,9700,0,0,0,9700,9700,0,0,0,0,94
348,l1506,20150612,9700,9700,0,0,0,9700,9700,0,0,0,0,0
349,l1507,20150105,8495,8495,0,0,0,8370,8370,-125,-125,0,0,2
350,l1507,20150106,8370,8370,8325,8325,8055,8055,8255,-315,-115,200,8256000,12
351,l1507,20150107,8055,8255,8340,8340,8340,8340,8340,85,85,4,166800,12
352,l1507,20150108,8340,8340,0,0,0,8325,8325,-15,-15,0,0,12
353,l1507,20150109,8325,8325,8160,8160,8065,8065,8085,-260,-240,80,3235600,50
354,l1507,20150112,8065,8085,8005,8020,8005,8020,8005,-65,-80,86,3442600,130
355,l1507,20150113,8020,8005,8030,8035,8030,8035,8030,30,25,10,401650,130
356,l1507,20150114,8035,8030,8070,8155,8050,8110,8065,80,35,56,2259150,170
357,l1507,20150115,8110,8065,0,0,0,8175,8175,110,110,0,0,170
358,l1507,20150116,8175,8175,8310,8355,8310,8355,8325,180,150,46,1915350,186
359,l1507,20150119,8355,8325,0,0,0,8405,8405,80,80,0,0,186
360,l1507,20150120,8405,8405,0,0,0,8405,8405,0,0,0,0,186
361,l1507,20150121,8405,8405,0,0,0,8410,8410,5,5,0,0,186
362,l1507,20150122,8410,8410,0,0,0,8410,8410,0,0,0,0,186
363,l1507,20150123,8410,8410,0,0,0,8410,8410,0,0,0,0,186
364,l1507,20150126,8410,8410,0,0,0,8230,8230,-180,-180,0,0,186
365,l1507,20150127,8230,8230,0,0,0,8230,8230,0,0,0,0,186
366,l1507,20150128,8230,8230,0,0,0,8230,8230,0,0,0,0,186
367,l1507,20150129,8230,8230,0,0,0,8230,8230,0,0,0,0,186
368,l1507,20150130,8230,8230,0,0,0,8230,8230,0,0,0,0,186
369,l1507,20150202,8230,8230,0,0,0,8315,8315,85,85,0,0,186
370,l1507,20150203,8315,8315,0,0,0,8420,8420,105,105,0,0,186
371,l1507,20150204,8420,8420,0,0,0,8515,8515,95,95,0,0,186
372,l1507,20150205,8515,8515,0,0,0,8515,8515,0,0,0,0,186
373,l1507,20150206,8515,8515,8765,8830,8765,8830,8795,315,280,4,175950,186
374,l1507,20150209,8830,8795,0,0,0,8795,8795,0,0,0,0,186
375,l1507,20150210,8795,8795,0,0,0,8795,8795,0,0,0,0,186
376,l1507,20150211,8795,8795,8850,8855,8840,8855,8845,60,50,52,2300750,188
377,l1507,20150212,8855,8845,8865,8875,8865,8875,8870,30,25,6,266100,188
378,l1507,20150213,8875,8870,0,0,0,8870,8870,0,0,0,0,188
379,l1507,20150216,8870,8870,0,0,0,8890,8890,20,20,0,0,188
380,l1507,20150217,8890,8890,0,0,0,8890,8890,0,0,0,0,188
381,l1507,20150225,8890,8890,0,0,0,8890,8890,0,0,0,0,188
382,l1507,20150226,8890,8890,9240,9240,9240,9240,9240,350,350,4,184800,188
383,l1507,20150227,9240,9240,9370,9370,9310,9310,9325,70,85,20,932850,188
384,l1507,20150302,9310,9325,9535,9535,9535,9535,9535,210,210,4,190700,188
385,l1507,20150303,9535,9535,0,0,0,9480,9480,-55,-55,0,0,188
386,l1507,20150304,9480,9480,0,0,0,9480,9480,0,0,0,0,188
387,l1507,20150305,9480,9480,9435,9460,9335,9335,9410,-145,-70,6,282300,188
388,l1507,20150306,9335,9410,9270,9270,9270,9270,9270,-140,-140,2,92700,186
389,l1507,20150309,9270,9270,0,0,0,9270,9270,0,0,0,0,186
390,l1507,20150310,9270,9270,9255,9255,9255,9255,9255,-15,-15,6,277650,186
391,l1507,20150311,9255,9255,9270,9270,9270,9270,9270,15,15,6,278100,186
392,l1507,20150312,9270,9270,0,0,0,9355,9355,85,85,0,0,186
393,l1507,20150313,9355,9355,9435,9435,9435,9435,9435,80,80,2,94350,186
394,l1507,20150316,9435,9435,0,0,0,9265,9265,-170,-170,0,0,186
395,l1507,20150317,9265,9265,0,0,0,9465,9465,200,200,0,0,186
396,l1507,20150318,9465,9465,0,0,0,9465,9465,0,0,0,0,186
397,l1507,20150319,9465,9465,0,0,0,9465,9465,0,0,0,0,186
398,l1507,20150320,9465,9465,9435,9435,9300,9300,9365,-165,-100,4,187350,186
399,l1507,20150323,9300,9365,9635,9705,9635,9685,9675,320,310,6,290250,188
400,l1507,20150324,9685,9675,9810,9810,9810,9810,9810,135,135,2,98100,190
401,l1507,20150325,9810,9810,0,0,0,9810,9810,0,0,0,0,190
402,l1507,20150326,9810,9810,0,0,0,9810,9810,0,0,0,0,190
403,l1507,20150327,9810,9810,9815,9815,9815,9815,9815,5,5,4,196300,190
404,l1507,20150330,9815,9815,9980,9980,9980,9980,9980,165,165,2,99800,190
405,l1507,20150331,9980,9980,9955,10050,9945,9990,9995,10,15,28,1399900,186
406,l1507,20150401,9990,9995,0,0,0,10050,10050,55,55,0,0,186
407,l1507,20150402,10050,10050,10140,10140,10140,10140,10140,90,90,2,101400,186
408,l1507,20150403,10140,10140,10120,10120,9755,9755,9900,-385,-240,32,1584250,186
409,l1507,20150407,9755,9900,10075,10075,10010,10010,10065,110,165,20,1006850,186
410,l1507,20150408,10010,10065,10145,10220,10080,10080,10145,15,80,14,710250,186
411,l1507,20150409,10080,10145,0,0,0,10100,10100,-45,-45,0,0,186
412,l1507,20150410,10100,10100,9915,9915,9820,9820,9850,-280,-250,6,295550,186
413,l1507,20150413,9820,9850,9780,9780,9780,9780,9780,-70,-70,2,97800,186
414,l1507,20150414,9780,9780,9720,9720,9720,9720,9720,-60,-60,2,97200,186
415,l1507,20150415,9720,9720,9820,9820,9705,9715,9755,-5,35,46,2243750,190
416,l1507,20150416,9715,9755,10075,10100,9960,9960,10035,205,280,16,803100,190
417,l1507,20150417,9960,10035,0,0,0,10035,10035,0,0,0,0,190
418,l1507,20150420,10035,10035,0,0,0,10035,10035,0,0,0,0,190
419,l1507,20150421,10035,10035,0,0,0,10035,10035,0,0,0,0,190
420,l1507,20150422,10035,10035,10055,10130,10020,10130,10100,95,65,16,808250,186
421,l1507,20150423,10130,10100,10225,10225,10175,10180,10190,80,90,6,305800,186
422,l1507,20150424,10180,10190,10395,10485,10395,10485,10440,295,250,4,208800,186
423,l1507,20150427,10485,10440,10715,10785,10715,10735,10735,295,295,30,1610950,188
424,l1507,20150428,10735,10735,10835,10990,10780,10780,10890,45,155,196,10673300,184
425,l1507,20150429,10780,10890,10805,10805,10670,10730,10725,-160,-165,22,1180050,184
426,l1507,20150430,10730,10725,10920,10920,10860,10860,10880,135,155,6,326450,186
427,l1507,20150504,10860,10880,0,0,0,10880,10880,0,0,0,0,186
428,l1507,20150505,10880,10880,0,0,0,10880,10880,0,0,0,0,186
429,l1507,20150506,10880,10880,10810,10810,10650,10650,10730,-230,-150,4,214600,184
430,l1507,20150507,10650,10730,10440,10690,10440,10690,10615,-40,-115,34,1805250,184
431,l1507,20150508,10690,10615,10510,10510,10435,10435,10485,-180,-130,8,419550,184
432,l1507,20150511,10435,10485,10495,10495,10315,10315,10390,-170,-95,16,831400,186
433,l1507,20150512,10315,10390,0,0,0,10390,10390,0,0,0,0,186
434,l1507,20150513,10390,10390,9985,9985,9985,9985,9985,-405,-405,2,99850,186
435,l1507,20150514,9985,9985,10235,10250,10210,10250,10240,265,255,18,921850,186
436,l1507,20150515,10250,10240,0,0,0,10205,10205,-35,-35,0,0,186
437,l1507,20150518,10205,10205,9945,9945,9945,9945,9945,-260,-260,2,99450,186
438,l1507,20150519,9945,9945,10065,10065,10065,10065,10065,120,120,6,301950,184
439,l1507,20150520,10065,10065,10000,10000,9975,10000,9995,-65,-70,10,499750,184
440,l1507,20150521,10000,9995,10125,10125,10120,10125,10120,130,125,28,1417400,186
441,l1507,20150522,10125,10120,0,0,0,10120,10120,0,0,0,0,186
442,l1507,20150525,10120,10120,0,0,0,10120,10120,0,0,0,0,186
443,l1507,20150526,10120,10120,10295,10295,10065,10185,10210,65,90,42,2144800,184
444,l1507,20150527,10185,10210,10140,10140,10140,10140,10140,-70,-70,2,101400,186
445,l1507,20150528,10140,10140,10130,10130,9910,9910,9955,-230,-185,14,696900,192
446,l1507,20150529,9910,9955,0,0,0,9730,9730,-225,-225,0,0,192
447,l1507,20150601,9730,9730,0,0,0,9730,9730,0,0,0,0,192
448,l1507,20150602,9730,9730,0,0,0,9730,9730,0,0,0,0,192
449,l1507,20150603,9730,9730,9900,9900,9575,9575,9860,-155,130,140,6904650,200
450,l1507,20150604,9575,9860,9605,9835,9575,9575,9670,-285,-190,6,290150,202
451,l1507,20150605,9575,9670,0,0,0,9670,9670,0,0,0,0,202
452,l1507,20150608,9670,9670,0,0,0,9670,9670,0,0,0,0,202
453,l1507,20150609,9670,9670,9390,9615,9390,9615,9500,-55,-170,4,190050,200
454,l1507,20150610,9615,9500,0,0,0,9500,9500,0,0,0,0,200
455,l1507,20150611,9500,9500,0,0,0,9500,9500,0,0,0,0,200
456,l1507,20150612,9500,9500,9860,9860,9860,9860,9860,360,360,10,493000,196
457,l1507,20150615,9860,9860,0,0,0,9785,9785,-75,-75,0,0,196
458,l1507,20150616,9785,9785,0,0,0,9785,9785,0,0,0,0,196
459,l1507,20150617,9785,9785,0,0,0,9785,9785,0,0,0,0,196
460,l1507,20150618,9785,9785,0,0,0,9785,9785,0,0,0,0,196
461,l1507,20150619,9785,9785,9405,9450,9405,9450,9415,-335,-370,8,376650,190
462,l1507,20150623,9450,9415,0,0,0,9415,9415,0,0,0,0,190
463,l1507,20150624,9415,9415,0,0,0,9415,9415,0,0,0,0,190
464,l1507,20150625,9415,9415,9425,9790,9335,9790,9565,375,150,32,1530900,206
465,l1507,20150626,9790,9565,0,0,0,9600,9600,35,35,0,0,206
466,l1507,20150629,9600,9600,9495,9980,9385,9505,9705,-95,105,12,582400,210
467,l1507,20150630,9505,9705,10080,10080,9380,9900,9780,195,75,58,2836800,206
468,l1507,20150701,9900,9780,0,0,0,9780,9780,0,0,0,0,206
469,l1507,20150702,9780,9780,0,0,0,9780,9780,0,0,0,0,206
470,l1507,20150703,9780,9780,0,0,0,9780,9780,0,0,0,0,206
471,l1507,20150706,9780,9780,0,0,0,9780,9780,0,0,0,0,206
472,l1507,20150707,9780,9780,0,0,0,9780,9780,0,0,0,0,206
473,l1507,20150708,9780,9780,0,0,0,9780,9780,0,0,0,0,206
474,l1507,20150709,9780,9780,0,0,0,9780,9780,0,0,0,0,206
475,l1507,20150710,9780,9780,0,0,0,9780,9780,0,0,0,0,206
476,l1507,20150713,9780,9780,9575,9575,9575,9575,9575,-205,-205,4,191500,206
477,l1507,20150714,9575,9575,0,0,0,9575,9575,0,0,0,0,0
478,l1508,20150105,8400,8395,8220,8220,8220,8220,8220,-175,-175,2,82200,210
479,l1508,20150106,8220,8220,0,0,0,8220,8220,0,0,0,0,210
480,l1508,20150107,8220,8220,0,0,0,8220,8220,0,0,0,0,210
481,l1508,20150108,8220,8220,8220,8250,8115,8115,8170,-105,-50,20,817350,214
482,l1508,20150109,8115,8170,0,0,0,8060,8060,-110,-110,0,0,214
483,l1508,20150112,8060,8060,7975,7975,7960,7960,7960,-100,-100,42,1671750,256
484,l1508,20150113,7960,7960,0,0,0,7980,7980,20,20,0,0,256
485,l1508,20150114,7980,7980,7975,7975,7975,7975,7975,-5,-5,40,1595000,288
486,l1508,20150115,7975,7975,8235,8235,8235,8235,8235,260,260,2,82350,290
487,l1508,20150116,8235,8235,8215,8270,8215,8270,8245,35,10,28,1154850,314
488,l1508,20150119,8270,8245,0,0,0,8245,8245,0,0,0,0,314
489,l1508,20150120,8245,8245,8260,8260,8260,8260,8260,15,15,2,82600,312
490,l1508,20150121,8260,8260,8325,8365,8325,8365,8345,105,85,4,166900,308
491,l1508,20150122,8365,8345,8415,8415,8415,8415,8415,70,70,2,84150,306
492,l1508,20150123,8415,8415,0,0,0,8345,8345,-70,-70,0,0,306
493,l1508,20150126,8345,8345,0,0,0,8140,8140,-205,-205,0,0,306
494,l1508,20150127,8140,8140,8215,8215,8215,8215,8215,75,75,2,82150,308
495,l1508,20150128,8215,8215,0,0,0,8215,8215,0,0,0,0,308
496,l1508,20150129,8215,8215,0,0,0,8215,8215,0,0,0,0,308
497,l1508,20150130,8215,8215,0,0,0,8150,8150,-65,-65,0,0,308
498,l1508,20150202,8150,8150,8275,8275,8275,8275,8275,125,125,2,82750,306
499,l1508,20150203,8275,8275,8410,8410,8410,8410,8410,135,135,2,84100,304
500,l1508,20150204,8410,8410,8645,8645,8645,8645,8645,235,235,2,86450,304
501,l1508,20150205,8645,8645,0,0,0,8620,8620,-25,-25,0,0,304
502,l1508,20150206,8620,8620,8780,8780,8780,8780,8780,160,160,6,263400,304
503,l1508,20150209,8780,8780,0,0,0,8780,8780,0,0,0,0,304
504,l1508,20150210,8780,8780,0,0,0,8780,8780,0,0,0,0,304
505,l1508,20150211,8780,8780,8800,8865,8800,8825,8830,45,50,18,794750,312
506,l1508,20150212,8825,8830,8775,8855,8775,8855,8790,25,-40,14,615350,312
507,l1508,20150213,8855,8790,0,0,0,8790,8790,0,0,0,0,312
508,l1508,20150216,8790,8790,9095,9115,9020,9020,9050,230,260,14,633500,306
509,l1508,20150217,9020,9050,9050,9050,9050,9050,9050,0,0,2,90500,306
510,l1508,20150225,9050,9050,8960,8985,8960,8985,8965,-65,-85,6,269050,306
511,l1508,20150226,8985,8965,9140,9205,9140,9205,9170,240,205,4,183450,308
512,l1508,20150227,9205,9170,0,0,0,9250,9250,80,80,0,0,308
513,l1508,20150302,9250,9250,9340,9340,9340,9340,9340,90,90,2,93400,308
514,l1508,20150303,9340,9340,9275,9275,9275,9275,9275,-65,-65,2,92750,306
515,l1508,20150304,9275,9275,0,0,0,9150,9150,-125,-125,0,0,306
516,l1508,20150305,9150,9150,0,0,0,9085,9085,-65,-65,0,0,306
517,l1508,20150306,9085,9085,9105,9115,9105,9115,9110,30,25,4,182200,304
518,l1508,20150309,9115,9110,8980,8980,8980,8980,8980,-130,-130,2,89800,306
519,l1508,20150310,8980,8980,9070,9070,9070,9070,9070,90,90,2,90700,306
520,l1508,20150311,9070,9070,0,0,0,9070,9070,0,0,0,0,306
521,l1508,20150312,9070,9070,9315,9315,9255,9255,9275,185,205,26,1205850,316
522,l1508,20150313,9255,9275,0,0,0,9275,9275,0,0,0,0,316
523,l1508,20150316,9275,9275,9040,9220,9040,9220,9130,-55,-145,4,182600,316
524,l1508,20150317,9220,9130,9240,9290,9240,9290,9265,160,135,4,185300,314
525,l1508,20150318,9290,9265,9185,9255,9185,9255,9220,-10,-45,16,737600,314
526,l1508,20150319,9255,9220,0,0,0,9105,9105,-115,-115,0,0,314
527,l1508,20150320,9105,9105,0,0,0,9105,9105,0,0,0,0,314
528,l1508,20150323,9105,9105,9395,9435,9395,9435,9405,330,300,6,282250,312
529,l1508,20150324,9435,9405,9630,9700,9630,9700,9665,295,260,4,193300,310
530,l1508,20150325,9700,9665,9700,9750,9700,9710,9720,45,55,8,388950,306
531,l1508,20150326,9710,9720,9715,9810,9715,9805,9755,85,35,40,1951450,272
532,l1508,20150327,9805,9755,0,0,0,9755,9755,0,0,0,0,272
533,l1508,20150330,9755,9755,0,0,0,9755,9755,0,0,0,0,272
534,l1508,20150331,9755,9755,9845,9880,9815,9880,9855,125,100,60,2956750,234
535,l1508,20150401,9880,9855,9605,9900,9605,9900,9710,45,-145,154,7478950,210
536,l1508,20150402,9900,9710,9970,10000,9970,10000,9990,290,280,36,1798350,178
537,l1508,20150403,10000,9990,0,0,0,9755,9755,-235,-235,0,0,178
538,l1508,20150407,9755,9755,0,0,0,9710,9710,-45,-45,0,0,178
539,l1508,20150408,9710,9710,9720,9785,9720,9785,9755,75,45,44,2146550,142
540,l1508,20150409,9785,9755,9535,9660,9480,9600,9570,-155,-185,24,1148500,140
541,l1508,20150410,9600,9570,9635,9635,9550,9590,9580,20,10,10,479000,140
542,l1508,20150413,9590,9580,0,0,0,9580,9580,0,0,0,0,140
543,l1508,20150414,9580,9580,0,0,0,9580,9580,0,0,0,0,140
544,l1508,20150415,9580,9580,0,0,0,9580,9580,0,0,0,0,140
545,l1508,20150416,9580,9580,9650,9660,9650,9660,9655,80,75,16,772550,126
546,l1508,20150417,9660,9655,9685,9685,9685,9685,9685,30,30,20,968500,128
547,l1508,20150420,9685,9685,9750,9975,9750,9895,9915,210,230,32,1586800,126
548,l1508,20150421,9895,9915,0,0,0,9955,9955,40,40,0,0,126
549,l1508,20150422,9955,9955,9865,9935,9865,9900,9900,-55,-55,6,297000,128
550,l1508,20150423,9900,9900,0,0,0,9955,9955,55,55,0,0,128
551,l1508,20150424,9955,9955,10085,10230,10085,10210,10165,255,210,12,610150,124
552,l1508,20150427,10210,10165,0,0,0,10450,10450,285,285,0,0,124
553,l1508,20150428,10450,10450,10515,10600,10490,10490,10550,40,100,42,2215700,124
554,l1508,20150429,10490,10550,10425,10490,10425,10490,10455,-60,-95,4,209150,124
555,l1508,20150430,10490,10455,0,0,0,10455,10455,0,0,0,0,124
556,l1508,20150504,10455,10455,0,0,0,10455,10455,0,0,0,0,124
557,l1508,20150505,10455,10455,10355,10465,10355,10465,10410,10,-45,4,208200,124
558,l1508,20150506,10465,10410,10435,10435,10325,10325,10365,-85,-45,6,311050,126
559,l1508,20150507,10325,10365,0,0,0,10255,10255,-110,-110,0,0,126
560,l1508,20150508,10255,10255,0,0,0,10130,10130,-125,-125,0,0,126
561,l1508,20150511,10130,10130,0,0,0,10130,10130,0,0,0,0,126
562,l1508,20150512,10130,10130,0,0,0,10130,10130,0,0,0,0,126
563,l1508,20150513,10130,10130,0,0,0,10130,10130,0,0,0,0,126
564,l1508,20150514,10130,10130,0,0,0,10385,10385,255,255,0,0,126
565,l1508,20150515,10385,10385,0,0,0,10385,10385,0,0,0,0,126
566,l1508,20150518,10385,10385,9970,9970,9970,9970,9970,-415,-415,10,498500,130
567,l1508,20150519,9970,9970,9830,9830,9780,9780,9805,-190,-165,4,196100,130
568,l1508,20150520,9780,9805,9740,9740,9740,9740,9740,-65,-65,4,194800,126
569,l1508,20150521,9740,9740,9740,10020,9740,10020,9905,280,165,6,297200,124
570,l1508,20150522,10020,9905,0,0,0,10155,10155,250,250,0,0,124
571,l1508,20150525,10155,10155,9910,10035,9910,10035,9980,-120,-175,8,399250,124
572,l1508,20150526,10035,9980,0,0,0,10065,10065,85,85,0,0,124
573,l1508,20150527,10065,10065,0,0,0,10000,10000,-65,-65,0,0,124
574,l1508,20150528,10000,10000,9840,9840,9840,9840,9840,-160,-160,2,98400,124
575,l1508,20150529,9840,9840,9810,9925,9780,9855,9860,15,20,14,690250,124
576,l1508,20150601,9855,9860,0,0,0,9860,9860,0,0,0,0,124
577,l1508,20150602,9860,9860,0,0,0,9860,9860,0,0,0,0,124
578,l1508,20150603,9860,9860,9850,9870,9820,9840,9845,-20,-15,24,1181700,126
579,l1508,20150604,9840,9845,9725,9750,9705,9705,9715,-140,-130,20,971800,132
580,l1508,20150605,9705,9715,0,0,0,9715,9715,0,0,0,0,132
581,l1508,20150608,9715,9715,9710,9710,9635,9635,9685,-80,-30,8,387550,130
582,l1508,20150609,9635,9685,9580,9645,9580,9645,9610,-40,-75,4,192250,128
583,l1508,20150610,9645,9610,9645,9810,9645,9810,9755,200,145,8,390200,124
584,l1508,20150611,9810,9755,0,0,0,9755,9755,0,0,0,0,124
585,l1508,20150612,9755,9755,9830,9830,9830,9830,9830,75,75,2,98300,124
586,l1508,20150615,9830,9830,9930,9930,9925,9930,9925,100,95,18,893500,120
587,l1508,20150616,9930,9925,10095,10210,9830,9830,10005,-95,80,82,4103700,122
588,l1508,20150617,9830,10005,0,0,0,10005,10005,0,0,0,0,122
589,l1508,20150618,10005,10005,0,0,0,10005,10005,0,0,0,0,122
590,l1508,20150619,10005,10005,0,0,0,9630,9630,-375,-375,0,0,122
591,l1508,20150623,9630,9630,9750,9750,9750,9750,9750,120,120,2,97500,120
592,l1508,20150624,9750,9750,0,0,0,9985,9985,235,235,0,0,120
593,l1508,20150625,9985,9985,0,0,0,10140,10140,155,155,0,0,120
594,l1508,20150626,10140,10140,0,0,0,10140,10140,0,0,0,0,120
595,l1508,20150629,10140,10140,9960,9960,9930,9930,9945,-210,-195,12,596900,124
596,l1508,20150630,9930,9945,10065,10065,9870,9870,9935,-75,-10,8,397500,124
597,l1508,20150701,9870,9935,9975,9975,9975,9975,9975,40,40,6,299250,128
598,l1508,20150702,9975,9975,0,0,0,9975,9975,0,0,0,0,128
599,l1508,20150703,9975,9975,0,0,0,9975,9975,0,0,0,0,128
600,l1508,20150706,9975,9975,9875,9875,9875,9875,9875,-100,-100,2,98750,128
601,l1508,20150707,9875,9875,0,0,0,9875,9875,0,0,0,0,128
602,l1508,20150708,9875,9875,0,0,0,9480,9480,-395,-395,0,0,128
603,l1508,20150709,9480,9480,0,0,0,9480,9480,0,0,0,0,128
604,l1508,20150710,9480,9480,9145,9145,9145,9145,9145,-335,-335,2,91450,128
605,l1508,20150713,9145,9145,0,0,0,8955,8955,-190,-190,0,0,128
606,l1508,20150714,8955,8955,9310,9310,9235,9305,9290,350,335,10,464650,130
607,l1508,20150715,9305,9290,9455,9485,9455,9485,9470,195,180,4,189400,128
608,l1508,20150716,9485,9470,9255,9255,9095,9095,9175,-375,-295,4,183500,128
609,l1508,20150717,9095,9175,0,0,0,9175,9175,0,0,0,0,128
610,l1508,20150720,9175,9175,0,0,0,9175,9175,0,0,0,0,128
611,l1508,20150721,9175,9175,0,0,0,9175,9175,0,0,0,0,128
612,l1508,20150722,9175,9175,0,0,0,9175,9175,0,0,0,0,128
613,l1508,20150723,9175,9175,0,0,0,9175,9175,0,0,0,0,128
614,l1508,20150724,9175,9175,0,0,0,9175,9175,0,0,0,0,128
615,l1508,20150727,9175,9175,9175,9175,9175,9175,9175,0,0,6,275250,126
616,l1508,20150728,9175,9175,8810,8810,8810,8810,8810,-365,-365,2,88100,124
617,l1508,20150729,8810,8810,9160,9160,8630,8630,8895,-180,85,4,177900,124
618,l1508,20150730,8630,8895,8900,8900,8900,8900,8900,5,5,28,1246000,124
619,l1508,20150731,8900,8900,9040,9040,8600,8620,8895,-280,-5,18,800850,114
620,l1508,20150803,8620,8895,0,0,0,8895,8895,0,0,0,0,114
621,l1508,20150804,8895,8895,0,0,0,8895,8895,0,0,0,0,114
622,l1508,20150805,8895,8895,0,0,0,8895,8895,0,0,0,0,114
623,l1508,20150806,8895,8895,0,0,0,8895,8895,0,0,0,0,114
624,l1508,20150807,8895,8895,0,0,0,8895,8895,0,0,0,0,114
625,l1508,20150810,8895,8895,0,0,0,8895,8895,0,0,0,0,114
626,l1508,20150811,8895,8895,0,0,0,8895,8895,0,0,0,0,114
627,l1508,20150812,8895,8895,0,0,0,8895,8895,0,0,0,0,114
628,l1508,20150813,8895,8895,9200,9200,9200,9200,9200,305,305,6,276000,108
629,l1508,20150814,9200,9200,9425,9750,9200,9750,9345,550,145,12,565250,0
630,l1509,20150105,8330,8265,8280,8300,8005,8035,8105,-230,-160,86720,3516089300,155594
631,l1509,20150106,8035,8105,8000,8175,7950,8145,8050,40,-55,120874,4867109650,166508
632,l1509,20150107,8145,8050,8090,8130,7985,8045,8050,-5,0,122030,4913131600,189910
633,l1509,20150108,8045,8050,8060,8110,7990,7995,8040,-55,-10,107244,4313429100,186786
634,l1509,20150109,7995,8040,8015,8035,7850,7905,7935,-135,-105,210676,8361504500,169332
635,l1509,20150112,7905,7935,7880,7905,7750,7830,7820,-105,-115,155528,6084250700,181590
636,l1509,20150113,7830,7820,7740,7810,7735,7765,7770,-55,-50,108010,4198843850,188926
637,l1509,20150114,7765,7770,7820,7870,7765,7840,7820,70,50,134558,5264162000,182698
638,l1509,20150115,7840,7820,7920,8035,7855,8030,7965,210,145,147620,5880552450,164302
639,l1509,20150116,8030,7965,7970,8060,7945,8030,8000,65,35,107328,4293352700,161234
640,l1509,20150119,8030,8000,8055,8190,8045,8165,8105,165,105,116780,4735268750,171884
641,l1509,20150120,8165,8105,8125,8140,8025,8085,8075,-20,-30,98614,3983264750,176952
642,l1509,20150121,8085,8075,8040,8220,8040,8175,8150,100,75,102518,4177666950,183452
643,l1509,20150122,8175,8150,8240,8260,8120,8145,8190,-5,40,92960,3808279850,194788
644,l1509,20150123,8145,8190,8100,8145,8065,8105,8100,-85,-90,77838,3154243250,199190
645,l1509,20150126,8105,8100,8060,8080,7870,7895,7945,-205,-155,107716,4279107400,217688
646,l1509,20150127,7895,7945,7925,7990,7905,7940,7945,-5,0,64770,2574477400,223552
647,l1509,20150128,7940,7945,7940,8005,7915,8000,7960,55,15,66762,2658330600,227710
648,l1509,20150129,8000,7960,7940,8045,7935,8030,8000,70,40,65440,2617843300,216642
649,l1509,20150130,8030,8000,8035,8045,7925,7925,7970,-75,-30,63200,2518696000,221092
650,l1509,20150202,7925,7970,8050,8125,8010,8085,8065,115,95,87142,3514462450,214738
651,l1509,20150203,8085,8065,8170,8290,8130,8285,8190,220,125,149620,6129795850,208654
652,l1509,20150204,8285,8190,8400,8515,8330,8350,8430,160,240,183322,7729183550,187772
653,l1509,20150205,8350,8430,8260,8330,8210,8285,8280,-145,-150,77732,3218856150,190464
654,l1509,20150206,8285,8280,8370,8610,8365,8610,8530,330,250,242614,10351787550,229858
655,l1509,20150209,8610,8530,8560,8640,8500,8630,8575,100,45,227648,9764759600,233200
656,l1509,20150210,8630,8575,8630,8680,8575,8630,8620,55,45,171462,7391516450,223718
657,l1509,20150211,8630,8620,8580,8750,8570,8720,8670,100,50,183416,7952792950,233032
658,l1509,20150212,8720,8670,8735,8760,8650,8755,8705,85,35,127844,5565852250,238466
659,l1509,20150213,8755,8705,8815,8995,8795,8925,8905,220,200,237416,10574422000,229000
660,l1509,20150216,8925,8905,8950,9030,8840,8955,8910,50,5,192698,8588408950,215668
661,l1509,20150217,8955,8910,8960,8985,8820,8940,8890,30,-20,123836,5507040900,217260
662,l1509,20150225,8940,8890,8850,8935,8730,8880,8835,-10,-55,149488,6605489500,200750
663,l1509,20150226,8880,8835,8950,9130,8920,9120,9015,285,180,206938,9328071500,191238
664,l1509,20150227,9120,9015,9050,9110,9010,9085,9055,70,40,185818,8417145850,207188
665,l1509,20150302,9085,9055,9160,9300,9120,9215,9210,160,155,240022,11055132750,202444
666,l1509,20150303,9215,9210,9220,9270,9040,9060,9115,-150,-95,245390,11184074100,221644
667,l1509,20150304,9060,9115,9060,9165,9030,9110,9095,-5,-20,191962,8734093650,224232
668,l1509,20150305,9110,9095,9055,9100,8905,8970,9015,-125,-80,203112,9157075650,219562
669,l1509,20150306,8970,9015,8950,8975,8885,8910,8925,-105,-90,107420,4796009800,224014
670,l1509,20150309,8910,8925,8850,8940,8750,8885,8830,-40,-95,231566,10225483250,244304
671,l1509,20150310,8885,8830,8900,8930,8800,8825,8865,-5,35,175526,7783603150,250660
672,l1509,20150311,8825,8865,8790,8920,8770,8795,8850,-70,-15,313436,13876728300,237340
673,l1509,20150312,8795,8850,8820,9150,8810,9140,9005,290,155,514586,23181885350,272064
674,l1509,20150313,9140,9005,9085,9170,9030,9100,9100,95,95,359948,16377767200,298916
675,l1509,20150316,9100,9100,8970,9045,8810,9015,8950,-85,-150,462010,20683122500,287644
676,l1509,20150317,9015,8950,9020,9145,8980,9135,9080,185,130,564970,25663393650,325824
677,l1509,20150318,9135,9080,9070,9125,8840,8845,8990,-235,-90,694364,31225474300,325258
678,l1509,20150319,8845,8990,8990,9080,8855,8890,8955,-100,-35,711632,31879851150,338418
679,l1509,20150320,8890,8955,8955,9010,8855,8895,8930,-60,-25,729456,32570866000,349612
680,l1509,20150323,8895,8930,9030,9285,9025,9285,9235,355,305,966652,44646296450,376988
681,l1509,20150324,9285,9235,9495,9615,9440,9565,9515,330,280,1191982,56710532000,413824
682,l1509,20150325,9565,9515,9545,9635,9495,9525,9555,10,40,1106536,52880155950,441416
683,l1509,20150326,9525,9555,9680,9720,9550,9675,9635,120,80,1127056,54317359300,451592
684,l1509,20150327,9675,9635,9625,9685,9510,9675,9600,40,-35,949380,45578153950,471492
685,l1509,20150330,9675,9600,9590,9715,9555,9715,9625,115,25,904790,43556163700,498938
686,l1509,20150331,9715,9625,9740,9805,9650,9650,9730,25,105,1184812,57663586400,481116
687,l1509,20150401,9650,9730,9620,9785,9555,9775,9675,45,-55,981790,47494590200,491932
688,l1509,20150402,9775,9675,9900,9935,9805,9875,9860,200,185,1002908,49462049950,484498
689,l1509,20150403,9875,9860,9850,9850,9470,9515,9635,-345,-225,1429202,68857093350,481258
690,l1509,20150407,9515,9635,9645,9675,9480,9515,9570,-120,-65,951034,45513613800,488366
691,l1509,20150408,9515,9570,9550,9680,9455,9580,9575,10,5,1348240,64562765050,454404
692,l1509,20150409,9580,9575,9480,9530,9380,9460,9450,-115,-125,1008978,47698158550,465456
693,l1509,20150410,9460,9450,9450,9505,9360,9430,9435,-20,-15,756874,35714462850,460646
694,l1509,20150413,9430,9435,9460,9565,9395,9465,9460,30,25,790776,37417973950,441744
695,l1509,20150414,9465,9460,9470,9520,9355,9390,9435,-70,-25,1052610,49673052050,435012
696,l1509,20150415,9390,9435,9450,9460,9325,9385,9390,-50,-45,715116,33592358350,421006
697,l1509,20150416,9385,9390,9480,9760,9455,9645,9630,255,240,1304228,62825619200,389250
698,l1509,20150417,9645,9630,9660,9780,9630,9665,9690,35,60,795356,38549800600,376424
699,l1509,20150420,9665,9690,9730,9845,9705,9810,9790,120,100,755154,36970239650,370004
700,l1509,20150421,9810,9790,9855,9910,9810,9870,9855,80,65,766316,37779032000,386228
701,l1509,20150422,9870,9855,9810,9840,9705,9715,9765,-140,-90,677438,33080601650,375214
702,l1509,20150423,9715,9765,9720,9950,9720,9880,9855,115,90,1147078,56545452450,431750
703,l1509,20150424,9880,9855,9980,10100,9955,10095,10025,240,170,1118568,56091438350,491872
704,l1509,20150427,10095,10025,10120,10400,10050,10370,10265,345,240,1255114,64444237900,510500
705,l1509,20150428,10370,10265,10365,10385,10220,10280,10280,15,15,665514,34215311700,458658
706,l1509,20150429,10280,10280,10290,10305,10055,10115,10180,-165,-100,937934,47746120300,407502
707,l1509,20150430,10115,10180,10190,10330,10160,10290,10260,110,80,716452,36755894900,398828
708,l1509,20150504,10290,10260,10310,10385,10175,10235,10280,-25,20,799930,41131461100,407198
709,l1509,20150505,10235,10280,10230,10245,10130,10165,10180,-115,-100,694146,35348079700,420352
710,l1509,20150506,10165,10180,10280,10310,9970,10005,10130,-175,-50,1283080,64992657950,420798
711,l1509,20150507,10005,10130,9910,9955,9795,9805,9890,-325,-240,818468,40486960250,399034
712,l1509,20150508,9805,9890,9720,9810,9690,9745,9755,-145,-135,745540,36373107250,371868
713,l1509,20150511,9745,9755,9805,9830,9670,9680,9715,-75,-40,577998,28084146900,399728
714,l1509,20150512,9680,9715,9655,9710,9580,9605,9645,-110,-70,912250,44002735800,422060
715,l1509,20150513,9605,9645,9700,9780,9630,9680,9700,35,55,804682,39030204850,430178
716,l1509,20150514,9680,9700,9600,9730,9550,9725,9635,25,-65,844182,40676960550,454968
717,l1509,20150515,9725,9635,9705,9740,9615,9630,9675,-5,40,821274,39738149250,469096
718,l1509,20150518,9630,9675,9620,9655,9460,9460,9530,-215,-145,838540,39964542050,492282
719,l1509,20150519,9460,9530,9425,9455,9310,9315,9395,-215,-135,886224,41645911300,509174
720,l1509,20150520,9315,9395,9190,9385,9165,9365,9270,-30,-125,1067326,49482688300,471952
721,l1509,20150521,9365,9270,9370,9595,9315,9510,9475,240,205,1173148,55583249300,468306
722,l1509,20150522,9510,9475,9620,9645,9495,9640,9565,165,90,1003380,48006598400,478932
723,l1509,20150525,9640,9565,9575,9610,9500,9560,9555,-5,-10,847984,40525080400,481730
724,l1509,20150526,9560,9555,9655,9700,9370,9400,9545,-155,-10,1236368,59024133500,521240
725,l1509,20150527,9400,9545,9365,9430,9330,9410,9370,-135,-175,730382,34234732700,487576
726,l1509,20150528,9410,9370,9430,9440,9250,9345,9335,-25,-35,881822,41165972000,506958
727,l1509,20150529,9345,9335,9385,9400,9310,9355,9355,20,20,513858,24037733600,497372
728,l1509,20150601,9355,9355,9480,9485,9305,9380,9380,25,25,679014,31855654650,497792
729,l1509,20150602,9380,9380,9395,9430,9265,9415,9340,35,-40,730604,34130277400,509860
730,l1509,20150603,9415,9340,9470,9480,9355,9430,9410,90,70,812408,38243300200,521582
731,l1509,20150604,9430,9410,9380,9535,9320,9465,9410,55,0,940012,44232183050,516910
732,l1509,20150605,9465,9410,9410,9500,9390,9455,9435,45,25,741334,34986569350,510202
733,l1509,20150608,9455,9435,9475,9485,9315,9350,9385,-85,-50,568616,26685151350,518206
734,l1509,20150609,9350,9385,9340,9390,9305,9355,9350,-30,-35,377540,17650559300,521486
735,l1509,20150610,9355,9350,9430,9640,9410,9635,9525,285,175,882290,42031526150,541152
736,l1509,20150611,9635,9525,9590,9755,9580,9700,9670,175,145,963926,46624928800,535260
737,l1509,20150612,9700,9670,9650,9685,9555,9585,9615,-85,-55,762826,36680026100,486596
738,l1509,20150615,9585,9615,9580,9735,9565,9725,9620,110,5,605660,29136429950,513566
739,l1509,20150616,9725,9620,9745,9855,9620,9690,9755,70,135,934930,45611165800,483880
740,l1509,20150617,9690,9755,9655,9700,9500,9505,9590,-250,-165,834782,40045111150,495688
741,l1509,20150618,9505,9590,9510,9555,9445,9500,9510,-90,-80,555652,26424801950,464584
742,l1509,20150619,9500,9510,9520,9675,9520,9570,9595,60,85,831752,39914351150,484886
743,l1509,20150623,9570,9595,9590,9625,9445,9565,9530,-30,-65,588038,28032056850,481886
744,l1509,20150624,9565,9530,9600,9715,9575,9685,9645,155,115,705944,34045295500,496784
745,l1509,20150625,9685,9645,9655,9700,9625,9685,9660,40,15,435574,21048672000,508190
746,l1509,20150626,9685,9660,9685,9920,9680,9870,9830,210,170,1059966,52111344350,580046
747,l1509,20150629,9870,9830,9865,9885,9510,9785,9710,-45,-120,1275490,61927127100,546538
748,l1509,20150630,9785,9710,9730,9875,9665,9855,9775,145,65,987974,48302154950,554654
749,l1509,20150701,9855,9775,9865,9995,9835,9915,9915,140,140,785576,38950762000,537446
750,l1509,20150702,9915,9915,9850,9915,9810,9915,9855,0,-60,619352,30520518550,536312
751,l1509,20150703,9915,9855,9880,9960,9800,9900,9890,45,35,1018180,50362797350,478530
752,l1509,20150706,9900,9890,9820,9850,9555,9635,9710,-255,-180,1157054,56188288750,460958
753,l1509,20150707,9635,9710,9515,9560,9325,9325,9450,-385,-260,917928,43386675300,465556
754,l1509,20150708,9325,9450,9055,9180,8885,8885,8990,-565,-460,791374,35582840750,411950
755,l1509,20150709,8885,8990,9135,9610,9110,9515,9385,525,395,1070770,50257576950,343690
756,l1509,20150710,9515,9385,9535,9755,9465,9550,9590,165,205,856314,41077371750,344544
757,l1509,20150713,9550,9590,9515,9560,9390,9480,9465,-110,-125,621488,29424529950,380462
758,l1509,20150714,9480,9465,9500,9630,9425,9445,9530,-20,65,650584,31013936650,362940
759,l1509,20150715,9445,9530,9570,9605,9450,9485,9520,-45,-10,585200,27864620450,361984
760,l1509,20150716,9485,9520,9420,9425,9265,9315,9320,-205,-200,693942,32344451100,358580
761,l1509,20150717,9315,9320,9285,9345,9220,9290,9290,-30,-30,500810,23267291600,365276
762,l1509,20150720,9290,9290,9295,9370,9210,9330,9285,40,-5,521088,24192824600,360372
763,l1509,20150721,9330,9285,9305,9315,9195,9270,9245,-15,-40,503300,23269304400,372848
764,l1509,20150722,9270,9245,9270,9410,9240,9400,9330,155,85,749768,34979275350,370268
765,l1509,20150723,9400,9330,9340,9425,9320,9365,9370,35,40,560050,26239942450,354426
766,l1509,20150724,9365,9370,9325,9330,9100,9110,9200,-260,-170,761236,35023632950,328746
767,l1509,20150727,9110,9200,9090,9100,8835,8835,8895,-365,-305,683066,30388482500,314136
768,l1509,20150728,8835,8895,8600,8860,8600,8860,8755,-35,-140,742356,32497929950,277636
769,l1509,20150729,8860,8755,8920,9075,8910,8965,8990,210,235,606616,27278907250,278838
770,l1509,20150730,8965,8990,9050,9120,8905,8920,9025,-70,35,460166,20771617300,268898
771,l1509,20150731,8920,9025,8885,8940,8850,8910,8890,-115,-135,340486,15141794850,266040
772,l1509,20150803,8910,8890,8805,8885,8610,8750,8730,-140,-160,571302,24943408850,279472
773,l1509,20150804,8750,8730,8685,8740,8590,8730,8655,0,-75,657084,28442058150,249694
774,l1509,20150805,8730,8655,8750,8895,8685,8890,8785,235,130,332474,14606716350,212156
775,l1509,20150806,8890,8785,8840,8920,8740,8820,8800,35,15,292402,12870580350,167486
776,l1509,20150807,8820,8800,8800,8915,8730,8905,8830,105,30,222814,9840352750,143530
777,l1509,20150810,8905,8830,8835,8970,8800,8965,8865,135,35,121670,5394862200,129490
778,l1509,20150811,8965,8865,9045,9215,9020,9215,9155,350,290,170406,7803744750,101596
779,l1509,20150812,9215,9155,9200,9300,9120,9300,9225,145,70,120944,5579315600,83814
780,l1509,20150813,9300,9225,9300,9330,9185,9295,9250,70,25,83770,3875672900,70694
781,l1509,20150814,9295,9250,9220,9310,9210,9270,9260,20,10,50636,2345500800,66148
782,l1509,20150817,9270,9260,9220,9260,9070,9115,9160,-145,-100,69628,3189629350,55036
783,l1509,20150818,9115,9160,9100,9120,8935,8980,9010,-180,-150,60750,2737074450,43418
784,l1509,20150819,8980,9010,9015,9055,8955,8990,9005,-20,-5,35916,1617182150,40184
785,l1509,20150820,8990,9005,8925,8925,8815,8895,8850,-110,-155,29542,1307592900,35296
786,l1509,20150821,8895,8850,8900,8925,8825,8865,8865,15,15,25596,1134612500,30850
787,l1509,20150824,8865,8865,8720,8720,8550,8580,8645,-285,-220,35868,1550447050,23352
788,l1509,20150825,8580,8645,8545,8820,8465,8750,8685,105,40,25270,1097493250,15416
789,l1509,20150826,8750,8685,8880,8880,8650,8755,8750,70,65,3100,135690150,13856
790,l1509,20150827,8755,8750,8770,8900,8770,8865,8820,115,70,4114,181503550,11880
791,l1509,20150828,8865,8820,9090,9150,8980,9120,9105,300,285,7948,361941850,11252
792,l1509,20150831,9120,9105,9095,9180,9060,9125,9120,20,15,3902,177937300,9298
793,l1509,20150901,9125,9120,9025,9200,9025,9100,9155,-20,35,376,17220200,9116
794,l1509,20150902,9100,9155,9155,9155,9080,9155,9135,0,-20,534,24402150,8830
795,l1509,20150907,9155,9135,9100,9100,8995,9015,9010,-120,-125,290,13065150,8588
796,l1509,20150908,9015,9010,9075,9080,8900,8950,9030,-60,20,104,4696800,8588
797,l1509,20150909,8950,9030,9050,9050,9000,9000,9005,-30,-25,80,3603000,8568
798,l1509,20150910,9000,9005,8570,8830,8570,8830,8695,-175,-310,244,10609900,8568
799,l1509,20150911,8830,8695,8210,8885,8210,8885,8840,190,145,68,3006600,8568
800,l1509,20150914,8885,8840,0,0,0,8840,8840,0,0,0,0,8568
801,l1509,20150915,8840,8840,8800,8800,8800,8800,8800,-40,-40,12,528000,8568
802,l1509,20150916,8800,8800,8820,8820,8820,8820,9030,20,230,1376,62113800,0
803,l1510,20150105,8205,8205,0,0,0,8050,8050,-155,-155,0,0,26
804,l1510,20150106,8050,8050,8085,8085,8085,8085,8085,35,35,6,242550,26
805,l1510,20150107,8085,8085,0,0,0,8085,8085,0,0,0,0,26
806,l1510,20150108,8085,8085,0,0,0,8055,8055,-30,-30,0,0,26
807,l1510,20150109,8055,8055,0,0,0,7955,7955,-100,-100,0,0,26
808,l1510,20150112,7955,7955,0,0,0,7880,7880,-75,-75,0,0,26
809,l1510,20150113,7880,7880,0,0,0,7870,7870,-10,-10,0,0,26
810,l1510,20150114,7870,7870,0,0,0,7870,7870,0,0,0,0,26
811,l1510,20150115,7870,7870,0,0,0,7955,7955,85,85,0,0,26
812,l1510,20150116,7955,7955,0,0,0,7985,7985,30,30,0,0,26
813,l1510,20150119,7985,7985,8065,8085,8065,8085,8070,100,85,8,322800,24
814,l1510,20150120,8085,8070,8065,8065,8065,8065,8065,-5,-5,2,80650,22
815,l1510,20150121,8065,8065,0,0,0,8135,8135,70,70,0,0,22
816,l1510,20150122,8135,8135,8120,8120,8120,8120,8120,-15,-15,2,81200,20
817,l1510,20150123,8120,8120,0,0,0,8035,8035,-85,-85,0,0,20
818,l1510,20150126,8035,8035,0,0,0,7885,7885,-150,-150,0,0,20
819,l1510,20150127,7885,7885,0,0,0,7885,7885,0,0,0,0,20
820,l1510,20150128,7885,7885,0,0,0,7895,7895,10,10,0,0,20
821,l1510,20150129,7895,7895,0,0,0,7930,7930,35,35,0,0,20
822,l1510,20150130,7930,7930,7915,7965,7915,7950,7940,20,10,14,555900,16
823,l1510,20150202,7950,7940,7960,7960,7960,7960,7960,20,20,2,79600,16
824,l1510,20150203,7960,7960,0,0,0,8080,8080,120,120,0,0,16
825,l1510,20150204,8080,8080,0,0,0,8315,8315,235,235,0,0,16
826,l1510,20150205,8315,8315,0,0,0,8315,8315,0,0,0,0,16
827,l1510,20150206,8315,8315,8435,8525,8435,8525,8480,210,165,4,169600,16
828,l1510,20150209,8525,8480,0,0,0,8520,8520,40,40,0,0,16
829,l1510,20150210,8520,8520,0,0,0,8520,8520,0,0,0,0,16
830,l1510,20150211,8520,8520,0,0,0,8565,8565,45,45,0,0,16
831,l1510,20150212,8565,8565,0,0,0,8565,8565,0,0,0,0,16
832,l1510,20150213,8565,8565,0,0,0,8760,8760,195,195,0,0,16
833,l1510,20150216,8760,8760,0,0,0,8760,8760,0,0,0,0,16
834,l1510,20150217,8760,8760,0,0,0,8760,8760,0,0,0,0,16
835,l1510,20150225,8760,8760,0,0,0,8760,8760,0,0,0,0,16
836,l1510,20150226,8760,8760,0,0,0,8760,8760,0,0,0,0,16
837,l1510,20150227,8760,8760,0,0,0,8975,8975,215,215,0,0,16
838,l1510,20150302,8975,8975,0,0,0,8975,8975,0,0,0,0,16
839,l1510,20150303,8975,8975,9115,9115,9085,9105,9100,130,125,8,364100,18
840,l1510,20150304,9105,9100,0,0,0,9100,9100,0,0,0,0,18
841,l1510,20150305,9100,9100,9035,9035,8930,8930,9005,-170,-95,14,630500,16
842,l1510,20150306,8930,9005,0,0,0,9005,9005,0,0,0,0,16
843,l1510,20150309,9005,9005,0,0,0,8880,8880,-125,-125,0,0,16
844,l1510,20150310,8880,8880,0,0,0,8825,8825,-55,-55,0,0,16
845,l1510,20150311,8825,8825,8835,8835,8835,8835,8835,10,10,2,88350,16
846,l1510,20150312,8835,8835,0,0,0,8985,8985,150,150,0,0,16
847,l1510,20150313,8985,8985,0,0,0,9075,9075,90,90,0,0,16
848,l1510,20150316,9075,9075,8950,8950,8905,8935,8910,-140,-165,50,2227600,58
849,l1510,20150317,8935,8910,9020,9090,8960,8960,9065,50,155,50,2266800,64
850,l1510,20150318,8960,9065,0,0,0,8885,8885,-180,-180,0,0,64
851,l1510,20150319,8885,8885,8810,8860,8790,8790,8830,-95,-55,8,353200,66
852,l1510,20150320,8790,8830,8860,8860,8855,8855,8855,25,25,44,1948150,104
853,l1510,20150323,8855,8855,9130,9130,9105,9105,9115,250,260,40,1823500,104
854,l1510,20150324,9105,9115,9400,9400,9400,9400,9400,285,285,20,940000,104
855,l1510,20150325,9400,9400,0,0,0,9400,9400,0,0,0,0,104
856,l1510,20150326,9400,9400,0,0,0,9475,9475,75,75,0,0,104
857,l1510,20150327,9475,9475,9465,9585,9465,9560,9550,85,75,80,3821300,102
858,l1510,20150330,9560,9550,0,0,0,9550,9550,0,0,0,0,102
859,l1510,20150331,9550,9550,0,0,0,9650,9650,100,100,0,0,102
860,l1510,20150401,9650,9650,9485,9675,9485,9675,9575,25,-75,176,8429550,114
861,l1510,20150402,9675,9575,9815,9890,9815,9890,9850,315,275,4,197050,114
862,l1510,20150403,9890,9850,0,0,0,9630,9630,-220,-220,0,0,114
863,l1510,20150407,9630,9630,9425,9500,9425,9500,9460,-130,-170,4,189250,112
864,l1510,20150408,9500,9460,9600,9600,9420,9600,9495,140,35,80,3799000,116
865,l1510,20150409,9600,9495,9420,9420,9415,9415,9415,-80,-80,6,282550,112
866,l1510,20150410,9415,9415,9350,9350,9350,9350,9350,-65,-65,4,187000,112
867,l1510,20150413,9350,9350,0,0,0,9350,9350,0,0,0,0,112
868,l1510,20150414,9350,9350,0,0,0,9350,9350,0,0,0,0,112
869,l1510,20150415,9350,9350,9365,9365,9365,9365,9365,15,15,2,93650,110
870,l1510,20150416,9365,9365,0,0,0,9600,9600,235,235,0,0,110
871,l1510,20150417,9600,9600,0,0,0,9655,9655,55,55,0,0,110
872,l1510,20150420,9655,9655,0,0,0,9725,9725,70,70,0,0,110
873,l1510,20150421,9725,9725,0,0,0,9785,9785,60,60,0,0,110
874,l1510,20150422,9785,9785,9750,9815,9675,9685,9725,-100,-60,18,875500,110
875,l1510,20150423,9685,9725,0,0,0,9810,9810,85,85,0,0,110
876,l1510,20150424,9810,9810,9995,10000,9710,9975,9905,165,95,86,4261150,126
877,l1510,20150427,9975,9905,10270,10290,10230,10260,10265,355,360,14,718550,124
878,l1510,20150428,10260,10265,10220,10220,10200,10200,10210,-65,-55,4,204200,120
879,l1510,20150429,10200,10210,10100,10100,10100,10100,10100,-110,-110,10,505000,110
880,l1510,20150430,10100,10100,10250,10250,10250,10250,10250,150,150,2,102500,112
881,l1510,20150504,10250,10250,10215,10280,10110,10140,10200,-110,-50,20,1020200,112
882,l1510,20150505,10140,10200,10205,10205,10205,10205,10205,5,5,2,102050,110
883,l1510,20150506,10205,10205,10160,10160,9975,9990,10010,-215,-195,22,1101250,116
884,l1510,20150507,9990,10010,9800,9800,9800,9800,9800,-210,-210,2,98000,116
885,l1510,20150508,9800,9800,0,0,0,9800,9800,0,0,0,0,116
886,l1510,20150511,9800,9800,0,0,0,9760,9760,-40,-40,0,0,116
887,l1510,20150512,9760,9760,0,0,0,9760,9760,0,0,0,0,116
888,l1510,20150513,9760,9760,9695,9695,9690,9690,9690,-70,-70,4,193850,116
889,l1510,20150514,9690,9690,9595,9595,9595,9595,9595,-95,-95,2,95950,114
890,l1510,20150515,9595,9595,9685,9685,9570,9570,9605,-25,10,16,768750,112
891,l1510,20150518,9570,9605,0,0,0,9605,9605,0,0,0,0,112
892,l1510,20150519,9605,9605,9420,9420,9420,9420,9420,-185,-185,10,471000,108
893,l1510,20150520,9420,9420,9235,9250,9235,9250,9240,-170,-180,16,739400,110
894,l1510,20150521,9250,9240,9435,9600,9320,9600,9515,360,275,42,1998850,142
895,l1510,20150522,9600,9515,9495,9570,9475,9475,9495,-40,-20,36,1709900,118
896,l1510,20150525,9475,9495,9525,9525,9525,9525,9525,30,30,8,381000,116
897,l1510,20150526,9525,9525,9410,9410,9410,9410,9410,-115,-115,4,188200,118
898,l1510,20150527,9410,9410,9340,9400,9340,9390,9380,-20,-30,28,1313800,130
899,l1510,20150528,9390,9380,9295,9295,9295,9295,9295,-85,-85,4,185900,126
900,l1510,20150529,9295,9295,0,0,0,9310,9310,15,15,0,0,126
901,l1510,20150601,9310,9310,0,0,0,9330,9330,20,20,0,0,126
902,l1510,20150602,9330,9330,9340,9340,9340,9340,9340,10,10,4,186800,126
903,l1510,20150603,9340,9340,9410,9410,9410,9410,9410,70,70,16,752800,110
904,l1510,20150604,9410,9410,0,0,0,9410,9410,0,0,0,0,110
905,l1510,20150605,9410,9410,9480,9480,9315,9420,9415,10,5,28,1318650,110
906,l1510,20150608,9420,9415,9405,9405,9325,9325,9380,-90,-35,44,2063650,124
907,l1510,20150609,9325,9380,0,0,0,9380,9380,0,0,0,0,124
908,l1510,20150610,9380,9380,9385,9585,9385,9585,9445,205,65,38,1795300,106
909,l1510,20150611,9585,9445,9620,9710,9590,9710,9620,265,175,46,2212650,140
910,l1510,20150612,9710,9620,0,0,0,9570,9570,-50,-50,0,0,140
911,l1510,20150615,9570,9570,9600,9600,9600,9600,9600,30,30,22,1056000,160
912,l1510,20150616,9600,9600,9765,9805,9660,9710,9755,110,155,88,4292900,160
913,l1510,20150617,9710,9755,9590,9605,9590,9605,9595,-150,-160,4,191950,160
914,l1510,20150618,9605,9595,0,0,0,9515,9515,-80,-80,0,0,160
915,l1510,20150619,9515,9515,9625,9645,9625,9645,9635,130,120,4,192700,160
916,l1510,20150623,9645,9635,0,0,0,9635,9635,0,0,0,0,160
917,l1510,20150624,9635,9635,9660,9660,9600,9650,9630,15,-5,24,1155900,160
918,l1510,20150625,9650,9630,0,0,0,9630,9630,0,0,0,0,160
919,l1510,20150626,9630,9630,9730,9885,9730,9830,9835,200,205,98,4820000,134
920,l1510,20150629,9830,9835,9745,9745,9745,9745,9745,-90,-90,4,194900,138
921,l1510,20150630,9745,9745,9695,9845,9695,9770,9770,25,25,26,1270450,132
922,l1510,20150701,9770,9770,9895,9895,9760,9880,9840,110,70,12,590600,132
923,l1510,20150702,9880,9840,0,0,0,9785,9785,-55,-55,0,0,132
924,l1510,20150703,9785,9785,9735,9735,9735,9735,9735,-50,-50,4,194700,130
925,l1510,20150706,9735,9735,9580,9580,9550,9550,9565,-185,-170,4,191300,128
926,l1510,20150707,9550,9565,9195,9195,9195,9195,9195,-370,-370,2,91950,128
927,l1510,20150708,9195,9195,8865,9075,8830,8830,8940,-365,-255,106,4739850,126
928,l1510,20150709,8830,8940,9260,9295,9170,9290,9265,350,325,44,2039350,150
929,l1510,20150710,9290,9265,9620,9620,9620,9620,9620,355,355,2,96200,148
930,l1510,20150713,9620,9620,0,0,0,9620,9620,0,0,0,0,148
931,l1510,20150714,9620,9620,0,0,0,9620,9620,0,0,0,0,148
932,l1510,20150715,9620,9620,9490,9490,9315,9315,9430,-305,-190,6,282950,144
933,l1510,20150716,9315,9430,9155,9185,9085,9085,9170,-345,-260,76,3485000,140
934,l1510,20150717,9085,9170,0,0,0,9170,9170,0,0,0,0,140
935,l1510,20150720,9170,9170,0,0,0,9170,9170,0,0,0,0,140
936,l1510,20150721,9170,9170,0,0,0,9170,9170,0,0,0,0,140
937,l1510,20150722,9170,9170,9085,9085,9085,9085,9085,-85,-85,2,90850,140
938,l1510,20150723,9085,9085,9285,9350,9065,9065,9195,-20,110,84,3862050,138
939,l1510,20150724,9065,9195,0,0,0,9180,9180,-15,-15,0,0,138
940,l1510,20150727,9180,9180,8820,8820,8815,8815,8815,-365,-365,82,3614450,104
941,l1510,20150728,8815,8815,8650,8855,8645,8845,8755,30,-60,32,1401000,88
942,l1510,20150729,8845,8755,9055,9055,9015,9015,9050,260,295,16,724000,74
943,l1510,20150730,9015,9050,9055,9085,9055,9085,9075,35,25,8,363100,74
944,l1510,20150731,9085,9075,0,0,0,9075,9075,0,0,0,0,74
945,l1510,20150803,9075,9075,8715,8715,8715,8715,8715,-360,-360,12,522900,74
946,l1510,20150804,8715,8715,8585,8775,8585,8680,8680,-35,-35,6,260400,72
947,l1510,20150805,8680,8680,8820,8820,8820,8820,8820,140,140,2,88200,70
948,l1510,20150806,8820,8820,0,0,0,8835,8835,15,15,0,0,70
949,l1510,20150807,8835,8835,8855,8855,8855,8855,8855,20,20,2,88550,68
950,l1510,20150810,8855,8855,0,0,0,8890,8890,35,35,0,0,68
951,l1510,20150811,8890,8890,9170,9190,8980,8980,9155,90,265,214,9800350,104
952,l1510,20150812,8980,9155,9175,9175,9175,9175,9175,20,20,6,275250,98
953,l1510,20150813,9175,9175,8935,8935,8935,8935,8935,-240,-240,2,89350,98
954,l1510,20150814,8935,8935,9160,9160,9160,9160,9160,225,225,6,274800,92
955,l1510,20150817,9160,9160,8800,9090,8800,9090,8945,-70,-215,4,178900,92
956,l1510,20150818,9090,8945,8775,8775,8775,8775,8775,-170,-170,2,87750,92
957,l1510,20150819,8775,8775,8800,8860,8600,8700,8765,-75,-10,44,1928300,64
958,l1510,20150820,8700,8765,0,0,0,8615,8615,-150,-150,0,0,64
959,l1510,20150821,8615,8615,0,0,0,8625,8625,10,10,0,0,64
960,l1510,20150824,8625,8625,8345,8345,8345,8345,8345,-280,-280,10,417250,54
961,l1510,20150825,8345,8345,8435,8435,8435,8435,8435,90,90,36,1518300,18
962,l1510,20150826,8435,8435,0,0,0,8495,8495,60,60,0,0,18
963,l1510,20150827,8495,8495,0,0,0,8560,8560,65,65,0,0,18
964,l1510,20150828,8560,8560,0,0,0,8835,8835,275,275,0,0,18
965,l1510,20150831,8835,8835,9185,9185,9180,9180,9180,345,345,4,183650,18
966,l1510,20150901,9180,9180,0,0,0,9180,9180,0,0,0,0,18
967,l1510,20150902,9180,9180,9150,9150,9150,9150,9150,-30,-30,2,91500,18
968,l1510,20150907,9150,9150,0,0,0,9025,9025,-125,-125,0,0,18
969,l1510,20150908,9025,9025,0,0,0,8800,8800,-225,-225,0,0,18
970,l1510,20150909,8800,8800,0,0,0,8800,8800,0,0,0,0,18
971,l1510,20150910,8800,8800,0,0,0,8500,8500,-300,-300,0,0,18
972,l1510,20150911,8500,8500,0,0,0,8640,8640,140,140,0,0,18
973,l1510,20150914,8640,8640,0,0,0,8640,8640,0,0,0,0,18
974,l1510,20150915,8640,8640,0,0,0,8605,8605,-35,-35,0,0,18
975,l1510,20150916,8605,8605,0,0,0,8825,8825,220,220,0,0,18
976,l1510,20150917,8825,8825,0,0,0,8825,8825,0,0,0,0,18
977,l1510,20150918,8825,8825,8485,9165,8485,9165,8825,340,0,8,353000,18
978,l1510,20150921,9165,8825,8480,8995,8480,8605,8760,-220,-65,28,1226700,18
979,l1510,20150922,8605,8760,0,0,0,8760,8760,0,0,0,0,18
980,l1510,20150923,8760,8760,8760,8760,8760,8760,8760,0,0,2,87600,18
981,l1510,20150924,8760,8760,0,0,0,8760,8760,0,0,0,0,18
982,l1510,20150925,8760,8760,8600,8680,8600,8680,8640,-80,-120,4,172800,16
983,l1510,20150928,8680,8640,8315,8315,8315,8315,8315,-325,-325,4,166300,12
984,l1510,20150929,8315,8315,0,0,0,8315,8315,0,0,0,0,12
985,l1510,20150930,8315,8315,8805,8805,8805,8805,8805,490,490,14,616350,14
986,l1510,20151008,8805,8805,0,0,0,8805,8805,0,0,0,0,14
987,l1510,20151009,8805,8805,0,0,0,8805,8805,0,0,0,0,14
988,l1510,20151012,8805,8805,0,0,0,8805,8805,0,0,0,0,14
989,l1510,20151013,8805,8805,0,0,0,8805,8805,0,0,0,0,14
990,l1510,20151014,8805,8805,8800,8800,8800,8800,8800,-5,-5,2,88000,12
991,l1510,20151015,8800,8800,0,0,0,8800,8800,0,0,0,0,12
992,l1510,20151016,8800,8800,0,0,0,8800,8800,0,0,0,0,12
993,l1510,20151019,8800,8800,0,0,0,8800,8800,0,0,0,0,12
994,l1510,20151020,8800,8800,0,0,0,8800,8800,0,0,0,0,12
995,l1510,20151021,8800,8800,0,0,0,8800,8800,0,0,0,0,0
996,l1511,20150105,8335,8610,8135,8135,8030,8055,8105,-555,-505,14,567600,30
997,l1511,20150106,8055,8105,8105,8105,8085,8105,8095,0,-10,6,242950,30
998,l1511,20150107,8105,8095,8060,8060,8060,8060,8060,-35,-35,2,80600,32
999,l1511,20150108,8060,8060,8000,8000,7990,8000,7995,-60,-65,6,239900,36
1000,l1511,20150109,8000,7995,7915,7915,7915,7915,7915,-80,-80,2,79150,34
1001,l1511,20150112,7915,7915,7850,7850,7850,7850,7850,-65,-65,12,471000,46
1002,l1511,20150113,7850,7850,0,0,0,7850,7850,0,0,0,0,46
1003,l1511,20150114,7850,7850,7855,7855,7855,7855,7855,5,5,2,78550,48
1004,l1511,20150115,7855,7855,7945,7970,7945,7970,7955,115,100,6,238650,46
1005,l1511,20150116,7970,7955,8020,8020,8020,8020,8020,65,65,4,160400,46
1006,l1511,20150119,8020,8020,8145,8145,8135,8135,8140,115,120,4,162800,46
1007,l1511,20150120,8135,8140,8130,8130,8130,8130,8130,-10,-10,2,81300,48
1008,l1511,20150121,8130,8130,8090,8150,8090,8150,8120,20,-10,4,162400,44
1009,l1511,20150122,8150,8120,0,0,0,8120,8120,0,0,0,0,44
1010,l1511,20150123,8120,8120,0,0,0,8120,8120,0,0,0,0,44
1011,l1511,20150126,8120,8120,8155,8155,8155,8155,8155,35,35,2,81550,44
1012,l1511,20150127,8155,8155,0,0,0,7980,7980,-175,-175,0,0,44
1013,l1511,20150128,7980,7980,8025,8025,8025,8025,8025,45,45,2,80250,44
1014,l1511,20150129,8025,8025,0,0,0,8025,8025,0,0,0,0,44
1015,l1511,20150130,8025,8025,0,0,0,8015,8015,-10,-10,0,0,44
1016,l1511,20150202,8015,8015,0,0,0,8020,8020,5,5,0,0,44
1017,l1511,20150203,8020,8020,8215,8215,8215,8215,8215,195,195,4,164300,44
1018,l1511,20150204,8215,8215,8450,8450,8450,8450,8450,235,235,2,84500,42
1019,l1511,20150205,8450,8450,0,0,0,8450,8450,0,0,0,0,42
1020,l1511,20150206,8450,8450,8340,8610,8340,8610,8490,160,40,16,679250,34
1021,l1511,20150209,8610,8490,0,0,0,8560,8560,70,70,0,0,34
1022,l1511,20150210,8560,8560,8620,8620,8620,8620,8620,60,60,2,86200,34
1023,l1511,20150211,8620,8620,8630,8660,8630,8660,8645,40,25,4,172900,30
1024,l1511,20150212,8660,8645,0,0,0,8695,8695,50,50,0,0,30
1025,l1511,20150213,8695,8695,8900,9010,8900,9000,8985,305,290,42,1887000,66
1026,l1511,20150216,9000,8985,0,0,0,8985,8985,0,0,0,0,66
1027,l1511,20150217,8985,8985,8955,8955,8950,8950,8950,-35,-35,8,358150,68
1028,l1511,20150225,8950,8950,0,0,0,8895,8895,-55,-55,0,0,68
1029,l1511,20150226,8895,8895,8925,9015,8925,9015,8970,120,75,4,179400,68
1030,l1511,20150227,9015,8970,9050,9050,9050,9050,9050,80,80,2,90500,66
1031,l1511,20150302,9050,9050,9165,9175,9105,9175,9140,125,90,42,1920050,48
1032,l1511,20150303,9175,9140,9115,9115,9015,9015,9080,-125,-60,24,1090100,42
1033,l1511,20150304,9015,9080,0,0,0,9080,9080,0,0,0,0,42
1034,l1511,20150305,9080,9080,0,0,0,8990,8990,-90,-90,0,0,42
1035,l1511,20150306,8990,8990,0,0,0,8905,8905,-85,-85,0,0,42
1036,l1511,20150309,8905,8905,0,0,0,8815,8815,-90,-90,0,0,42
1037,l1511,20150310,8815,8815,0,0,0,8845,8845,30,30,0,0,42
1038,l1511,20150311,8845,8845,0,0,0,8855,8855,10,10,0,0,42
1039,l1511,20150312,8855,8855,0,0,0,9010,9010,155,155,0,0,42
1040,l1511,20150313,9010,9010,9130,9130,9130,9130,9130,120,120,2,91300,42
1041,l1511,20150316,9130,9130,8975,8975,8915,8915,8945,-215,-185,4,178900,44
1042,l1511,20150317,8915,8945,9060,9060,9060,9060,9060,115,115,4,181200,46
1043,l1511,20150318,9060,9060,0,0,0,8975,8975,-85,-85,0,0,46
1044,l1511,20150319,8975,8975,0,0,0,8920,8920,-55,-55,0,0,46
1045,l1511,20150320,8920,8920,0,0,0,8945,8945,25,25,0,0,46
1046,l1511,20150323,8945,8945,9205,9205,9205,9205,9205,260,260,2,92050,48
1047,l1511,20150324,9205,9205,0,0,0,9490,9490,285,285,0,0,48
1048,l1511,20150325,9490,9490,9415,9520,9415,9490,9480,0,-10,10,474100,44
1049,l1511,20150326,9490,9480,9550,9575,9550,9575,9560,95,80,4,191250,46
1050,l1511,20150327,9575,9560,9580,9580,9580,9580,9580,20,20,4,191600,44
1051,l1511,20150330,9580,9580,0,0,0,9580,9580,0,0,0,0,44
1052,l1511,20150331,9580,9580,9700,9715,9700,9715,9705,135,125,4,194150,44
1053,l1511,20150401,9715,9705,9720,9720,9720,9720,9720,15,15,2,97200,44
1054,l1511,20150402,9720,9720,9805,9810,9765,9810,9790,90,70,8,391600,44
1055,l1511,20150403,9810,9790,0,0,0,9535,9535,-255,-255,0,0,44
1056,l1511,20150407,9535,9535,9600,9600,9515,9515,9565,-20,30,24,1148150,62
1057,l1511,20150408,9515,9565,9465,9560,9465,9560,9510,-5,-55,4,190250,62
1058,l1511,20150409,9560,9510,0,0,0,9510,9510,0,0,0,0,62
1059,l1511,20150410,9510,9510,0,0,0,9510,9510,0,0,0,0,62
1060,l1511,20150413,9510,9510,9490,9490,9435,9435,9460,-75,-50,4,189250,62
1061,l1511,20150414,9435,9460,9395,9395,9395,9395,9395,-65,-65,2,93950,60
1062,l1511,20150415,9395,9395,0,0,0,9385,9385,-10,-10,0,0,60
1063,l1511,20150416,9385,9385,9630,9645,9545,9640,9605,255,220,42,2017800,48
1064,l1511,20150417,9640,9605,0,0,0,9605,9605,0,0,0,0,48
1065,l1511,20150420,9605,9605,0,0,0,9605,9605,0,0,0,0,48
1066,l1511,20150421,9605,9605,9710,9780,9710,9780,9740,175,135,6,292300,46
1067,l1511,20150422,9780,9740,0,0,0,9685,9685,-55,-55,0,0,46
1068,l1511,20150423,9685,9685,9735,9850,9735,9850,9815,165,130,10,490800,40
1069,l1511,20150424,9850,9815,9940,9975,9940,9975,9955,160,140,4,199150,40
1070,l1511,20150427,9975,9955,0,0,0,10315,10315,360,360,0,0,40
1071,l1511,20150428,10315,10315,0,0,0,10260,10260,-55,-55,0,0,40
1072,l1511,20150429,10260,10260,0,0,0,10150,10150,-110,-110,0,0,40
1073,l1511,20150430,10150,10150,10245,10245,10245,10245,10245,95,95,2,102450,42
1074,l1511,20150504,10245,10245,10335,10335,10195,10195,10295,-50,50,8,411800,44
1075,l1511,20150505,10195,10295,0,0,0,10140,10140,-155,-155,0,0,44
1076,l1511,20150506,10140,10140,10250,10250,10090,10090,10170,-50,30,4,203400,48
1077,l1511,20150507,10090,10170,9770,9770,9770,9770,9770,-400,-400,2,97700,48
1078,l1511,20150508,9770,9770,0,0,0,9770,9770,0,0,0,0,48
1079,l1511,20150511,9770,9770,0,0,0,9730,9730,-40,-40,0,0,48
1080,l1511,20150512,9730,9730,0,0,0,9660,9660,-70,-70,0,0,48
1081,l1511,20150513,9660,9660,0,0,0,9595,9595,-65,-65,0,0,48
1082,l1511,20150514,9595,9595,0,0,0,9505,9505,-90,-90,0,0,48
1083,l1511,20150515,9505,9505,0,0,0,9510,9510,5,5,0,0,48
1084,l1511,20150518,9510,9510,0,0,0,9370,9370,-140,-140,0,0,48
1085,l1511,20150519,9370,9370,0,0,0,9190,9190,-180,-180,0,0,48
1086,l1511,20150520,9190,9190,0,0,0,9015,9015,-175,-175,0,0,48
1087,l1511,20150521,9015,9015,0,0,0,9280,9280,265,265,0,0,48
1088,l1511,20150522,9280,9280,0,0,0,9265,9265,-15,-15,0,0,48
1089,l1511,20150525,9265,9265,0,0,0,9290,9290,25,25,0,0,48
1090,l1511,20150526,9290,9290,9625,9625,9625,9625,9625,335,335,2,96250,48
1091,l1511,20150527,9625,9625,0,0,0,9595,9595,-30,-30,0,0,48
1092,l1511,20150528,9595,9595,0,0,0,9510,9510,-85,-85,0,0,48
1093,l1511,20150529,9510,9510,9275,9380,9275,9380,9325,-130,-185,4,186550,46
1094,l1511,20150601,9380,9325,9195,9415,9195,9415,9305,90,-20,4,186100,48
1095,l1511,20150602,9415,9305,9390,9390,9390,9390,9390,85,85,2,93900,48
1096,l1511,20150603,9390,9390,0,0,0,9460,9460,70,70,0,0,48
1097,l1511,20150604,9460,9460,0,0,0,9460,9460,0,0,0,0,48
1098,l1511,20150605,9460,9460,0,0,0,9465,9465,5,5,0,0,48
1099,l1511,20150608,9465,9465,0,0,0,9430,9430,-35,-35,0,0,48
1100,l1511,20150609,9430,9430,0,0,0,9430,9430,0,0,0,0,48
1101,l1511,20150610,9430,9430,0,0,0,9495,9495,65,65,0,0,48
1102,l1511,20150611,9495,9495,0,0,0,9670,9670,175,175,0,0,48
1103,l1511,20150612,9670,9670,0,0,0,9615,9615,-55,-55,0,0,48
1104,l1511,20150615,9615,9615,0,0,0,9615,9615,0,0,0,0,48
1105,l1511,20150616,9615,9615,0,0,0,9615,9615,0,0,0,0,48
1106,l1511,20150617,9615,9615,0,0,0,9460,9460,-155,-155,0,0,48
1107,l1511,20150618,9460,9460,0,0,0,9385,9385,-75,-75,0,0,48
1108,l1511,20150619,9385,9385,0,0,0,9500,9500,115,115,0,0,48
1109,l1511,20150623,9500,9500,0,0,0,9500,9500,0,0,0,0,48
1110,l1511,20150624,9500,9500,9650,9650,9650,9650,9650,150,150,2,96500,48
1111,l1511,20150625,9650,9650,0,0,0,9650,9650,0,0,0,0,48
1112,l1511,20150626,9650,9650,9695,9810,9695,9810,9735,160,85,6,292050,44
1113,l1511,20150629,9810,9735,0,0,0,9735,9735,0,0,0,0,44
1114,l1511,20150630,9735,9735,0,0,0,9755,9755,20,20,0,0,44
1115,l1511,20150701,9755,9755,9850,9865,9695,9865,9820,110,65,10,491200,44
1116,l1511,20150702,9865,9820,0,0,0,9765,9765,-55,-55,0,0,44
1117,l1511,20150703,9765,9765,9780,9890,9680,9810,9815,45,50,60,2944700,46
1118,l1511,20150706,9810,9815,0,0,0,9790,9790,-25,-25,0,0,46
1119,l1511,20150707,9790,9790,9555,9555,9430,9430,9535,-360,-255,14,667600,40
1120,l1511,20150708,9430,9535,0,0,0,9275,9275,-260,-260,0,0,40
1121,l1511,20150709,9275,9275,9515,9515,9515,9515,9515,240,240,2,95150,40
1122,l1511,20150710,9515,9515,0,0,0,9515,9515,0,0,0,0,40
1123,l1511,20150713,9515,9515,0,0,0,9515,9515,0,0,0,0,40
1124,l1511,20150714,9515,9515,0,0,0,9515,9515,0,0,0,0,40
1125,l1511,20150715,9515,9515,0,0,0,9515,9515,0,0,0,0,40
1126,l1511,20150716,9515,9515,0,0,0,9515,9515,0,0,0,0,40
1127,l1511,20150717,9515,9515,9220,9220,9220,9220,9220,-295,-295,2,92200,40
1128,l1511,20150720,9220,9220,0,0,0,9220,9220,0,0,0,0,40
1129,l1511,20150721,9220,9220,0,0,0,9220,9220,0,0,0,0,40
1130,l1511,20150722,9220,9220,0,0,0,9220,9220,0,0,0,0,40
1131,l1511,20150723,9220,9220,9210,9210,8950,9205,9120,-15,-100,36,1641850,54
1132,l1511,20150724,9205,9120,9175,9175,8950,8950,9060,-170,-60,418,18945750,40
1133,l1511,20150727,8950,9060,8705,8705,8705,8705,8705,-355,-355,4,174100,40
1134,l1511,20150728,8705,8705,0,0,0,8705,8705,0,0,0,0,40
1135,l1511,20150729,8705,8705,0,0,0,8995,8995,290,290,0,0,40
1136,l1511,20150730,8995,8995,8890,8890,8890,8890,8890,-105,-105,2,88900,40
1137,l1511,20150731,8890,8890,0,0,0,8760,8760,-130,-130,0,0,40
1138,l1511,20150803,8760,8760,8855,8855,8855,8855,8855,95,95,2,88550,40
1139,l1511,20150804,8855,8855,0,0,0,8855,8855,0,0,0,0,40
1140,l1511,20150805,8855,8855,0,0,0,8995,8995,140,140,0,0,40
1141,l1511,20150806,8995,8995,0,0,0,9010,9010,15,15,0,0,40
1142,l1511,20150807,9010,9010,0,0,0,9030,9030,20,20,0,0,40
1143,l1511,20150810,9030,9030,8895,8895,8895,8895,8895,-135,-135,2,88950,40
1144,l1511,20150811,8895,8895,9250,9250,9250,9250,9250,355,355,2,92500,40
1145,l1511,20150812,9250,9250,0,0,0,9250,9250,0,0,0,0,40
1146,l1511,20150813,9250,9250,0,0,0,9250,9250,0,0,0,0,40
1147,l1511,20150814,9250,9250,0,0,0,9480,9480,230,230,0,0,40
1148,l1511,20150817,9480,9480,9110,9110,9110,9110,9110,-370,-370,2,91100,38
1149,l1511,20150818,9110,9110,8880,8880,8880,8880,8880,-230,-230,2,88800,36
1150,l1511,20150819,8880,8880,0,0,0,8870,8870,-10,-10,0,0,36
1151,l1511,20150820,8870,8870,0,0,0,8800,8800,-70,-70,0,0,36
1152,l1511,20150821,8800,8800,0,0,0,8800,8800,0,0,0,0,36
1153,l1511,20150824,8800,8800,8455,8455,8455,8455,8455,-345,-345,2,84550,36
1154,l1511,20150825,8455,8455,0,0,0,8455,8455,0,0,0,0,36
1155,l1511,20150826,8455,8455,0,0,0,8515,8515,60,60,0,0,36
1156,l1511,20150827,8515,8515,8580,8600,8580,8600,8590,85,75,4,171800,32
1157,l1511,20150828,8600,8590,8835,8835,8835,8835,8835,245,245,2,88350,30
1158,l1511,20150831,8835,8835,8715,8715,8715,8715,8715,-120,-120,20,871500,30
1159,l1511,20150901,8715,8715,0,0,0,8715,8715,0,0,0,0,30
1160,l1511,20150902,8715,8715,0,0,0,8690,8690,-25,-25,0,0,30
1161,l1511,20150907,8690,8690,8740,8740,8740,8740,8740,50,50,2,87400,28
1162,l1511,20150908,8740,8740,0,0,0,8755,8755,15,15,0,0,28
1163,l1511,20150909,8755,8755,8595,9080,8595,9080,8835,325,80,4,176750,28
1164,l1511,20150910,9080,8835,8665,8665,8665,8665,8665,-170,-170,2,86650,26
1165,l1511,20150911,8665,8665,0,0,0,8665,8665,0,0,0,0,26
1166,l1511,20150914,8665,8665,0,0,0,8665,8665,0,0,0,0,26
1167,l1511,20150915,8665,8665,8500,8520,8500,8520,8510,-145,-155,4,170200,24
1168,l1511,20150916,8520,8510,0,0,0,8510,8510,0,0,0,0,24
1169,l1511,20150917,8510,8510,8675,8675,8515,8515,8595,5,85,4,171900,22
1170,l1511,20150918,8515,8595,0,0,0,8595,8595,0,0,0,0,22
1171,l1511,20150921,8595,8595,0,0,0,8535,8535,-60,-60,0,0,22
1172,l1511,20150922,8535,8535,0,0,0,8535,8535,0,0,0,0,22
1173,l1511,20150923,8535,8535,0,0,0,8535,8535,0,0,0,0,22
1174,l1511,20150924,8535,8535,0,0,0,8535,8535,0,0,0,0,22
1175,l1511,20150925,8535,8535,0,0,0,8535,8535,0,0,0,0,22
1176,l1511,20150928,8535,8535,0,0,0,8215,8215,-320,-320,0,0,22
1177,l1511,20150929,8215,8215,8085,8085,7895,7895,7990,-320,-225,4,159800,20
1178,l1511,20150930,7895,7990,0,0,0,8460,8460,470,470,0,0,20
1179,l1511,20151008,8460,8460,0,0,0,8460,8460,0,0,0,0,20
1180,l1511,20151009,8460,8460,0,0,0,8460,8460,0,0,0,0,20
1181,l1511,20151012,8460,8460,0,0,0,8460,8460,0,0,0,0,20
1182,l1511,20151013,8460,8460,0,0,0,8460,8460,0,0,0,0,20
1183,l1511,20151014,8460,8460,0,0,0,8460,8460,0,0,0,0,20
1184,l1511,20151015,8460,8460,0,0,0,8460,8460,0,0,0,0,20
1185,l1511,20151016,8460,8460,0,0,0,8460,8460,0,0,0,0,20
1186,l1511,20151019,8460,8460,0,0,0,8460,8460,0,0,0,0,20
1187,l1511,20151020,8460,8460,0,0,0,8460,8460,0,0,0,0,20
1188,l1511,20151021,8460,8460,0,0,0,8460,8460,0,0,0,0,20
1189,l1511,20151022,8460,8460,0,0,0,8460,8460,0,0,0,0,20
1190,l1511,20151023,8460,8460,8480,8580,8480,8580,8530,120,70,4,170600,20
1191,l1511,20151026,8580,8530,0,0,0,8530,8530,0,0,0,0,20
1192,l1511,20151027,8530,8530,0,0,0,8530,8530,0,0,0,0,20
1193,l1511,20151028,8530,8530,8450,8450,8450,8450,8450,-80,-80,2,84500,18
1194,l1511,20151029,8450,8450,0,0,0,8450,8450,0,0,0,0,18
1195,l1511,20151030,8450,8450,8400,8400,8400,8400,8400,-50,-50,2,84000,16
1196,l1511,20151102,8400,8400,8400,8895,8400,8895,8770,495,370,16,701700,12
1197,l1511,20151103,8895,8770,0,0,0,8770,8770,0,0,0,0,12
1198,l1511,20151104,8770,8770,8700,8700,8700,8700,8700,-70,-70,12,522000,12
1199,l1511,20151105,8700,8700,0,0,0,8700,8700,0,0,0,0,12
1200,l1511,20151106,8700,8700,0,0,0,8700,8700,0,0,0,0,12
1201,l1511,20151109,8700,8700,8700,8700,8700,8700,8700,0,0,2,87000,14
1202,l1511,20151110,8700,8700,0,0,0,8700,8700,0,0,0,0,14
1203,l1511,20151111,8700,8700,0,0,0,8600,8600,-100,-100,0,0,14
1204,l1511,20151112,8600,8600,0,0,0,8600,8600,0,0,0,0,14
1205,l1511,20151113,8600,8600,0,0,0,8735,8735,135,135,0,0,0
1206,l1512,20150105,8250,8245,0,0,0,8080,8080,-165,-165,0,0,14
1207,l1512,20150106,8080,8080,0,0,0,8075,8075,-5,-5,0,0,14
1208,l1512,20150107,8075,8075,8075,8075,8075,8075,8075,0,0,2,80750,16
1209,l1512,20150108,8075,8075,0,0,0,8010,8010,-65,-65,0,0,16
1210,l1512,20150109,8010,8010,7790,7850,7790,7850,7820,-160,-190,4,156400,16
1211,l1512,20150112,7850,7820,7800,7800,7800,7800,7800,-20,-20,2,78000,18
1212,l1512,20150113,7800,7800,0,0,0,7800,7800,0,0,0,0,18
1213,l1512,20150114,7800,7800,0,0,0,7800,7800,0,0,0,0,18
1214,l1512,20150115,7800,7800,0,0,0,7900,7900,100,100,0,0,18
1215,l1512,20150116,7900,7900,0,0,0,7900,7900,0,0,0,0,18
1216,l1512,20150119,7900,7900,0,0,0,8015,8015,115,115,0,0,18
1217,l1512,20150120,8015,8015,0,0,0,8010,8010,-5,-5,0,0,18
1218,l1512,20150121,8010,8010,0,0,0,8005,8005,-5,-5,0,0,18
1219,l1512,20150122,8005,8005,0,0,0,7995,7995,-10,-10,0,0,18
1220,l1512,20150123,7995,7995,0,0,0,7910,7910,-85,-85,0,0,18
1221,l1512,20150126,7910,7910,0,0,0,7910,7910,0,0,0,0,18
1222,l1512,20150127,7910,7910,0,0,0,7910,7910,0,0,0,0,18
1223,l1512,20150128,7910,7910,0,0,0,7950,7950,40,40,0,0,18
1224,l1512,20150129,7950,7950,0,0,0,7985,7985,35,35,0,0,18
1225,l1512,20150130,7985,7985,0,0,0,7995,7995,10,10,0,0,18
1226,l1512,20150202,7995,7995,0,0,0,8015,8015,20,20,0,0,18
1227,l1512,20150203,8015,8015,0,0,0,8205,8205,190,190,0,0,18
1228,l1512,20150204,8205,8205,0,0,0,8435,8435,230,230,0,0,18
1229,l1512,20150205,8435,8435,0,0,0,8285,8285,-150,-150,0,0,18
1230,l1512,20150206,8285,8285,0,0,0,8320,8320,35,35,0,0,18
1231,l1512,20150209,8320,8320,0,0,0,8360,8360,40,40,0,0,18
1232,l1512,20150210,8360,8360,0,0,0,8415,8415,55,55,0,0,18
1233,l1512,20150211,8415,8415,8650,8650,8650,8650,8650,235,235,2,86500,16
1234,l1512,20150212,8650,8650,0,0,0,8680,8680,30,30,0,0,16
1235,l1512,20150213,8680,8680,0,0,0,8965,8965,285,285,0,0,16
1236,l1512,20150216,8965,8965,0,0,0,8970,8970,5,5,0,0,16
1237,l1512,20150217,8970,8970,8875,8875,8875,8875,8875,-95,-95,2,88750,18
1238,l1512,20150225,8875,8875,0,0,0,8825,8825,-50,-50,0,0,18
1239,l1512,20150226,8825,8825,8865,8900,8840,8900,8865,75,40,6,266050,20
1240,l1512,20150227,8900,8865,0,0,0,8900,8900,35,35,0,0,20
1241,l1512,20150302,8900,8900,9135,9135,9135,9135,9135,235,235,2,91350,18
1242,l1512,20150303,9135,9135,0,0,0,9080,9080,-55,-55,0,0,18
1243,l1512,20150304,9080,9080,0,0,0,9065,9065,-15,-15,0,0,18
1244,l1512,20150305,9065,9065,0,0,0,8975,8975,-90,-90,0,0,18
1245,l1512,20150306,8975,8975,0,0,0,8890,8890,-85,-85,0,0,18
1246,l1512,20150309,8890,8890,0,0,0,8800,8800,-90,-90,0,0,18
1247,l1512,20150310,8800,8800,0,0,0,8830,8830,30,30,0,0,18
1248,l1512,20150311,8830,8830,0,0,0,8840,8840,10,10,0,0,18
1249,l1512,20150312,8840,8840,0,0,0,8990,8990,150,150,0,0,18
1250,l1512,20150313,8990,8990,9060,9060,9060,9060,9060,70,70,2,90600,18
1251,l1512,20150316,9060,9060,0,0,0,8880,8880,-180,-180,0,0,18
1252,l1512,20150317,8880,8880,0,0,0,8990,8990,110,110,0,0,18
1253,l1512,20150318,8990,8990,0,0,0,8905,8905,-85,-85,0,0,18
1254,l1512,20150319,8905,8905,0,0,0,8850,8850,-55,-55,0,0,18
1255,l1512,20150320,8850,8850,0,0,0,8875,8875,25,25,0,0,18
1256,l1512,20150323,8875,8875,8905,9100,8905,9100,8965,225,90,52,2330900,38
1257,l1512,20150324,9100,8965,9200,9295,9200,9220,9225,255,260,10,461450,30
1258,l1512,20150325,9220,9225,0,0,0,9225,9225,0,0,0,0,30
1259,l1512,20150326,9225,9225,0,0,0,9355,9355,130,130,0,0,30
1260,l1512,20150327,9355,9355,0,0,0,9355,9355,0,0,0,0,30
1261,l1512,20150330,9355,9355,0,0,0,9425,9425,70,70,0,0,30
1262,l1512,20150331,9425,9425,0,0,0,9545,9545,120,120,0,0,30
1263,l1512,20150401,9545,9545,0,0,0,9545,9545,0,0,0,0,30
1264,l1512,20150402,9545,9545,0,0,0,9605,9605,60,60,0,0,30
1265,l1512,20150403,9605,9605,0,0,0,9390,9390,-215,-215,0,0,30
1266,l1512,20150407,9390,9390,0,0,0,9390,9390,0,0,0,0,30
1267,l1512,20150408,9390,9390,0,0,0,9390,9390,0,0,0,0,30
1268,l1512,20150409,9390,9390,0,0,0,9370,9370,-20,-20,0,0,30
1269,l1512,20150410,9370,9370,0,0,0,9370,9370,0,0,0,0,30
1270,l1512,20150413,9370,9370,0,0,0,9370,9370,0,0,0,0,30
1271,l1512,20150414,9370,9370,0,0,0,9345,9345,-25,-25,0,0,30
1272,l1512,20150415,9345,9345,0,0,0,9230,9230,-115,-115,0,0,30
1273,l1512,20150416,9230,9230,9240,9240,9240,9240,9240,10,10,2,92400,30
1274,l1512,20150417,9240,9240,9530,9530,9530,9530,9530,290,290,2,95300,28
1275,l1512,20150420,9530,9530,9575,9590,9575,9590,9580,60,50,6,287400,30
1276,l1512,20150421,9590,9580,9605,9605,9605,9605,9605,25,25,2,96050,28
1277,l1512,20150422,9605,9605,0,0,0,9550,9550,-55,-55,0,0,28
1278,l1512,20150423,9550,9550,0,0,0,9675,9675,125,125,0,0,28
1279,l1512,20150424,9675,9675,0,0,0,9810,9810,135,135,0,0,28
1280,l1512,20150427,9810,9810,0,0,0,10165,10165,355,355,0,0,28
1281,l1512,20150428,10165,10165,9925,9925,9925,9925,9925,-240,-240,6,297750,22
1282,l1512,20150429,9925,9925,9830,9860,9800,9860,9830,-65,-95,22,1081550,6
1283,l1512,20150430,9860,9830,0,0,0,9920,9920,90,90,0,0,6
1284,l1512,20150504,9920,9920,0,0,0,9965,9965,45,45,0,0,6
1285,l1512,20150505,9965,9965,0,0,0,9965,9965,0,0,0,0,6
1286,l1512,20150506,9965,9965,9960,9960,9840,9840,9900,-125,-65,4,198000,6
1287,l1512,20150507,9840,9900,0,0,0,9515,9515,-385,-385,0,0,6
1288,l1512,20150508,9515,9515,9500,9500,9500,9500,9500,-15,-15,2,95000,6
1289,l1512,20150511,9500,9500,9500,9505,9470,9470,9490,-30,-10,6,284750,12
1290,l1512,20150512,9470,9490,0,0,0,9425,9425,-65,-65,0,0,12
1291,l1512,20150513,9425,9425,0,0,0,9360,9360,-65,-65,0,0,12
1292,l1512,20150514,9360,9360,0,0,0,9270,9270,-90,-90,0,0,12
1293,l1512,20150515,9270,9270,0,0,0,9275,9275,5,5,0,0,12
1294,l1512,20150518,9275,9275,0,0,0,9140,9140,-135,-135,0,0,12
1295,l1512,20150519,9140,9140,9245,9245,9245,9245,9245,105,105,2,92450,14
1296,l1512,20150520,9245,9245,9245,9245,9235,9235,9235,-10,-10,6,277150,20
1297,l1512,20150521,9235,9235,0,0,0,9505,9505,270,270,0,0,20
1298,l1512,20150522,9505,9505,0,0,0,9490,9490,-15,-15,0,0,20
1299,l1512,20150525,9490,9490,0,0,0,9515,9515,25,25,0,0,20
1300,l1512,20150526,9515,9515,0,0,0,9855,9855,340,340,0,0,20
1301,l1512,20150527,9855,9855,0,0,0,9465,9465,-390,-390,0,0,20
1302,l1512,20150528,9465,9465,0,0,0,9380,9380,-85,-85,0,0,20
1303,l1512,20150529,9380,9380,0,0,0,9200,9200,-180,-180,0,0,20
1304,l1512,20150601,9200,9200,0,0,0,9185,9185,-15,-15,0,0,20
1305,l1512,20150602,9185,9185,0,0,0,9265,9265,80,80,0,0,20
1306,l1512,20150603,9265,9265,9325,9325,9260,9260,9300,-5,35,6,279000,22
1307,l1512,20150604,9260,9300,0,0,0,9300,9300,0,0,0,0,22
1308,l1512,20150605,9300,9300,0,0,0,9300,9300,0,0,0,0,22
1309,l1512,20150608,9300,9300,0,0,0,9270,9270,-30,-30,0,0,22
1310,l1512,20150609,9270,9270,0,0,0,9240,9240,-30,-30,0,0,22
1311,l1512,20150610,9240,9240,9460,9460,9460,9460,9460,220,220,2,94600,24
1312,l1512,20150611,9460,9460,0,0,0,9635,9635,175,175,0,0,24
1313,l1512,20150612,9635,9635,0,0,0,9585,9585,-50,-50,0,0,24
1314,l1512,20150615,9585,9585,0,0,0,9615,9615,30,30,0,0,24
1315,l1512,20150616,9615,9615,0,0,0,9770,9770,155,155,0,0,24
1316,l1512,20150617,9770,9770,0,0,0,9610,9610,-160,-160,0,0,24
1317,l1512,20150618,9610,9610,0,0,0,9530,9530,-80,-80,0,0,24
1318,l1512,20150619,9530,9530,0,0,0,9650,9650,120,120,0,0,24
1319,l1512,20150623,9650,9650,0,0,0,9585,9585,-65,-65,0,0,24
1320,l1512,20150624,9585,9585,0,0,0,9735,9735,150,150,0,0,24
1321,l1512,20150625,9735,9735,0,0,0,9750,9750,15,15,0,0,24
1322,l1512,20150626,9750,9750,0,0,0,9835,9835,85,85,0,0,24
1323,l1512,20150629,9835,9835,9525,9525,9460,9490,9495,-345,-340,20,949800,20
1324,l1512,20150630,9490,9495,0,0,0,9515,9515,20,20,0,0,20
1325,l1512,20150701,9515,9515,9700,9700,9700,9700,9700,185,185,2,97000,22
1326,l1512,20150702,9700,9700,0,0,0,9645,9645,-55,-55,0,0,22
1327,l1512,20150703,9645,9645,9675,9675,9675,9675,9675,30,30,2,96750,22
1328,l1512,20150706,9675,9675,9405,9405,9405,9405,9405,-270,-270,4,188100,20
1329,l1512,20150707,9405,9405,9290,9290,9290,9290,9290,-115,-115,2,92900,22
1330,l1512,20150708,9290,9290,0,0,0,8920,8920,-370,-370,0,0,22
1331,l1512,20150709,8920,8920,0,0,0,9150,9150,230,230,0,0,22
1332,l1512,20150710,9150,9150,9370,9370,9370,9370,9370,220,220,2,93700,22
1333,l1512,20150713,9370,9370,0,0,0,9250,9250,-120,-120,0,0,22
1334,l1512,20150714,9250,9250,0,0,0,9310,9310,60,60,0,0,22
1335,l1512,20150715,9310,9310,0,0,0,9130,9130,-180,-180,0,0,22
1336,l1512,20150716,9130,9130,0,0,0,8880,8880,-250,-250,0,0,22
1337,l1512,20150717,8880,8880,0,0,0,8605,8605,-275,-275,0,0,22
1338,l1512,20150720,8605,8605,0,0,0,8605,8605,0,0,0,0,22
1339,l1512,20150721,8605,8605,0,0,0,8570,8570,-35,-35,0,0,22
1340,l1512,20150722,8570,8570,0,0,0,8910,8910,340,340,0,0,22
1341,l1512,20150723,8910,8910,0,0,0,8815,8815,-95,-95,0,0,22
1342,l1512,20150724,8815,8815,0,0,0,8760,8760,-55,-55,0,0,22
1343,l1512,20150727,8760,8760,0,0,0,8420,8420,-340,-340,0,0,22
1344,l1512,20150728,8420,8420,8690,8690,8690,8690,8690,270,270,2,86900,20
1345,l1512,20150729,8690,8690,0,0,0,8980,8980,290,290,0,0,20
1346,l1512,20150730,8980,8980,0,0,0,8880,8880,-100,-100,0,0,20
1347,l1512,20150731,8880,8880,0,0,0,8750,8750,-130,-130,0,0,20
1348,l1512,20150803,8750,8750,0,0,0,8840,8840,90,90,0,0,20
1349,l1512,20150804,8840,8840,8495,8495,8495,8495,8495,-345,-345,4,169900,20
1350,l1512,20150805,8495,8495,0,0,0,8630,8630,135,135,0,0,20
1351,l1512,20150806,8630,8630,0,0,0,8640,8640,10,10,0,0,20
1352,l1512,20150807,8640,8640,0,0,0,8655,8655,15,15,0,0,20
1353,l1512,20150810,8655,8655,0,0,0,8680,8680,25,25,0,0,20
1354,l1512,20150811,8680,8680,8940,8955,8915,8915,8935,235,255,10,446950,14
1355,l1512,20150812,8915,8935,8950,9060,8760,9045,8910,110,-25,614,27360650,250
1356,l1512,20150813,9045,8910,8985,8985,8985,8985,8985,75,75,2,89850,248
1357,l1512,20150814,8985,8985,8950,9005,8950,9005,8975,20,-10,8,359100,244
1358,l1512,20150817,9005,8975,0,0,0,8625,8625,-350,-350,0,0,244
1359,l1512,20150818,8625,8625,8745,8745,8680,8680,8715,55,90,14,610100,234
1360,l1512,20150819,8680,8715,0,0,0,8710,8710,-5,-5,0,0,234
1361,l1512,20150820,8710,8710,8530,8570,8465,8485,8510,-225,-200,28,1191700,224
1362,l1512,20150821,8485,8510,0,0,0,8520,8520,10,10,0,0,224
1363,l1512,20150824,8520,8520,8320,8320,8320,8320,8320,-200,-200,12,499200,212
1364,l1512,20150825,8320,8320,8290,8415,8290,8415,8345,95,25,18,751200,194
1365,l1512,20150826,8415,8345,8410,8425,8410,8425,8410,80,65,10,420650,186
1366,l1512,20150827,8425,8410,8565,8585,8565,8585,8575,175,165,12,514500,174
1367,l1512,20150828,8585,8575,0,0,0,8815,8815,240,240,0,0,174
1368,l1512,20150831,8815,8815,8665,8750,8590,8700,8685,-115,-130,70,3041150,148
1369,l1512,20150901,8700,8685,0,0,0,8715,8715,30,30,0,0,148
1370,l1512,20150902,8715,8715,8660,8695,8585,8680,8655,-35,-60,24,1038700,128
1371,l1512,20150907,8680,8655,8680,8785,8680,8785,8725,130,70,20,872600,120
1372,l1512,20150908,8785,8725,8590,8675,8475,8605,8540,-120,-185,502,21444700,66
1373,l1512,20150909,8605,8540,8795,8865,8205,8780,8705,240,165,652,28385800,46
1374,l1512,20150910,8780,8705,8750,8790,8750,8790,8770,85,65,4,175400,44
1375,l1512,20150911,8790,8770,8830,8835,8830,8835,8830,65,60,4,176650,44
1376,l1512,20150914,8835,8830,8755,8755,8620,8620,8675,-210,-155,74,3210600,44
1377,l1512,20150915,8620,8675,0,0,0,8520,8520,-155,-155,0,0,44
1378,l1512,20150916,8520,8520,8715,8765,8705,8765,8720,245,200,28,1221200,40
1379,l1512,20150917,8765,8720,8780,8780,8780,8780,8780,60,60,2,87800,40
1380,l1512,20150918,8780,8780,0,0,0,8780,8780,0,0,0,0,40
1381,l1512,20150921,8780,8780,0,0,0,8720,8720,-60,-60,0,0,40
1382,l1512,20150922,8720,8720,0,0,0,8720,8720,0,0,0,0,40
1383,l1512,20150923,8720,8720,0,0,0,8720,8720,0,0,0,0,40
1384,l1512,20150924,8720,8720,8645,8645,8645,8645,8645,-75,-75,2,86450,38
1385,l1512,20150925,8645,8645,8600,8600,8430,8430,8460,-215,-185,10,423200,40
1386,l1512,20150928,8430,8460,8480,8480,8480,8480,8480,20,20,2,84800,40
1387,l1512,20150929,8480,8480,0,0,0,8250,8250,-230,-230,0,0,40
1388,l1512,20150930,8250,8250,8230,8290,8230,8290,8240,40,-10,12,494400,44
1389,l1512,20151008,8290,8240,0,0,0,8450,8450,210,210,0,0,44
1390,l1512,20151009,8450,8450,8785,8785,8500,8755,8690,305,240,10,434700,42
1391,l1512,20151012,8755,8690,0,0,0,8690,8690,0,0,0,0,42
1392,l1512,20151013,8690,8690,0,0,0,8690,8690,0,0,0,0,42
1393,l1512,20151014,8690,8690,8860,8860,8600,8830,8730,140,40,10,436650,36
1394,l1512,20151015,8830,8730,0,0,0,8730,8730,0,0,0,0,36
1395,l1512,20151016,8730,8730,0,0,0,8730,8730,0,0,0,0,36
1396,l1512,20151019,8730,8730,0,0,0,8730,8730,0,0,0,0,36
1397,l1512,20151020,8730,8730,8395,8600,8385,8450,8455,-280,-275,14,592150,38
1398,l1512,20151021,8450,8455,0,0,0,8455,8455,0,0,0,0,38
1399,l1512,20151022,8455,8455,0,0,0,8455,8455,0,0,0,0,38
1400,l1512,20151023,8455,8455,0,0,0,8455,8455,0,0,0,0,38
1401,l1512,20151026,8455,8455,8300,8545,8300,8545,8420,90,-35,8,336900,34
1402,l1512,20151027,8545,8420,0,0,0,8420,8420,0,0,0,0,34
1403,l1512,20151028,8420,8420,0,0,0,8420,8420,0,0,0,0,34
1404,l1512,20151029,8420,8420,0,0,0,8420,8420,0,0,0,0,34
1405,l1512,20151030,8420,8420,8445,8445,8445,8445,8445,25,25,6,253350,28
1406,l1512,20151102,8445,8445,0,0,0,8445,8445,0,0,0,0,28
1407,l1512,20151103,8445,8445,0,0,0,8445,8445,0,0,0,0,28
1408,l1512,20151104,8445,8445,0,0,0,8445,8445,0,0,0,0,28
1409,l1512,20151105,8445,8445,8300,8410,8300,8410,8355,-35,-90,8,334200,22
1410,l1512,20151106,8410,8355,0,0,0,8355,8355,0,0,0,0,22
1411,l1512,20151109,8355,8355,0,0,0,8355,8355,0,0,0,0,22
1412,l1512,20151110,8355,8355,0,0,0,8355,8355,0,0,0,0,22
1413,l1512,20151111,8355,8355,0,0,0,8355,8355,0,0,0,0,22
1414,l1512,20151112,8355,8355,0,0,0,8355,8355,0,0,0,0,22
1415,l1512,20151113,8355,8355,0,0,0,8355,8355,0,0,0,0,22
1416,l1512,20151116,8355,8355,0,0,0,8355,8355,0,0,0,0,22
1417,l1512,20151117,8355,8355,0,0,0,8355,8355,0,0,0,0,22
1418,l1512,20151118,8355,8355,0,0,0,8355,8355,0,0,0,0,22
1419,l1512,20151119,8355,8355,0,0,0,8355,8355,0,0,0,0,22
1420,l1512,20151120,8355,8355,8050,8050,8050,8050,8050,-305,-305,12,483000,18
1421,l1512,20151123,8050,8050,7570,7570,7570,7570,7570,-480,-480,4,151400,14
1422,l1512,20151124,7570,7570,7600,7950,7600,7950,7785,380,215,12,467300,14
1423,l1512,20151125,7950,7785,7920,8095,7690,7980,7880,195,95,34,1340300,14
1424,l1512,20151126,7980,7880,0,0,0,7880,7880,0,0,0,0,14
1425,l1512,20151127,7880,7880,0,0,0,7880,7880,0,0,0,0,14
1426,l1512,20151130,7880,7880,0,0,0,7880,7880,0,0,0,0,14
1427,l1512,20151201,7880,7880,0,0,0,7880,7880,0,0,0,0,14
1428,l1512,20151202,7880,7880,0,0,0,7880,7880,0,0,0,0,14
1429,l1512,20151203,7880,7880,0,0,0,7880,7880,0,0,0,0,14
1430,l1512,20151204,7880,7880,0,0,0,7880,7880,0,0,0,0,14
1431,l1512,20151207,7880,7880,0,0,0,7880,7880,0,0,0,0,14
1432,l1512,20151208,7880,7880,0,0,0,7880,7880,0,0,0,0,14
1433,l1512,20151209,7880,7880,0,0,0,7880,7880,0,0,0,0,14
1434,l1512,20151210,7880,7880,0,0,0,7880,7880,0,0,0,0,14
1435,l1512,20151211,7880,7880,0,0,0,8000,8000,120,120,0,0,14
1436,l1512,20151214,8000,8000,0,0,0,8000,8000,0,0,0,0,0
1437,l1601,20150119,7965,7965,8145,8145,7870,7945,7935,-20,-30,908,36040850,628
1438,l1601,20150120,7945,7935,7940,7940,7850,7885,7885,-50,-50,868,34222650,1270
1439,l1601,20150121,7885,7885,7900,8030,7870,7990,7975,105,90,1778,70932900,2256
1440,l1601,20150122,7990,7975,8000,8070,7935,7960,7995,-15,20,1332,53268950,2970
1441,l1601,20150123,7960,7995,7950,7950,7870,7910,7910,-85,-85,956,37814200,3454
1442,l1601,20150126,7910,7910,7875,7875,7695,7710,7745,-200,-165,1360,52687550,4184
1443,l1601,20150127,7710,7745,7740,7795,7720,7755,7760,10,15,1246,48364200,4586
1444,l1601,20150128,7755,7760,7775,7815,7740,7815,7785,55,25,1150,44774450,5096
1445,l1601,20150129,7815,7785,7765,7840,7760,7820,7805,35,20,924,36064500,4968
1446,l1601,20150130,7820,7805,7830,7850,7745,7745,7795,-60,-10,1058,41258450,5260
1447,l1601,20150202,7745,7795,7900,7925,7840,7890,7885,95,90,1600,63083450,5798
1448,l1601,20150203,7890,7885,7930,8080,7930,8080,8000,195,115,3608,144402650,6512
1449,l1601,20150204,8080,8000,8120,8315,8120,8150,8230,150,230,3354,138058150,6774
1450,l1601,20150205,8150,8230,8080,8120,8020,8085,8080,-145,-150,1662,67179250,6874
1451,l1601,20150206,8085,8080,8205,8400,8170,8400,8345,320,265,7810,326064950,6978
1452,l1601,20150209,8400,8345,8420,8485,8305,8475,8390,130,45,6464,271242200,9894
1453,l1601,20150210,8475,8390,8410,8525,8410,8455,8470,65,80,3790,160553550,10106
1454,l1601,20150211,8455,8470,8420,8570,8400,8550,8505,80,35,3784,160956250,10472
1455,l1601,20150212,8550,8505,8555,8590,8475,8575,8530,70,25,3290,140326700,10756
1456,l1601,20150213,8575,8530,8620,8810,8610,8760,8730,230,200,4304,187963950,9952
1457,l1601,20150216,8760,8730,8780,8845,8670,8775,8740,45,10,1860,81284900,10074
1458,l1601,20150217,8775,8740,8770,8800,8655,8720,8700,-20,-40,2960,128800400,10446
1459,l1601,20150225,8720,8700,8580,8710,8515,8670,8610,-30,-90,2066,88968100,10018
1460,l1601,20150226,8670,8610,8730,8915,8720,8905,8805,295,195,3934,173231300,10330
1461,l1601,20150227,8905,8805,8850,8880,8775,8850,8830,45,25,6526,288223550,10654
1462,l1601,20150302,8850,8830,8930,9070,8915,9005,8990,175,160,4612,207350000,11028
1463,l1601,20150303,9005,8990,9020,9055,8820,8840,8895,-150,-95,4834,214999000,12414
1464,l1601,20150304,8840,8895,8890,8945,8820,8900,8890,5,-5,3798,168893050,12372
1465,l1601,20150305,8900,8890,8540,8880,8540,8765,8795,-125,-95,4982,219205750,12444
1466,l1601,20150306,8765,8795,8750,8760,8675,8695,8720,-100,-75,3184,138822500,12672
1467,l1601,20150309,8695,8720,8675,8710,8500,8675,8610,-45,-110,7500,323016850,13570
1468,l1601,20150310,8675,8610,8680,8710,8585,8605,8660,-5,50,5704,247005250,12606
1469,l1601,20150311,8605,8660,8585,8690,8555,8585,8630,-75,-30,3870,167000700,13444
1470,l1601,20150312,8585,8630,8600,8925,8600,8915,8790,285,160,6356,279498600,13440
1471,l1601,20150313,8915,8790,8920,8930,8800,8860,8860,70,70,4358,193101050,12928
1472,l1601,20150316,8860,8860,8780,8780,8580,8765,8700,-95,-160,5610,244143350,14222
1473,l1601,20150317,8765,8700,8765,8865,8720,8825,8810,125,110,10628,468183800,17514
1474,l1601,20150318,8825,8810,8770,8810,8545,8560,8655,-250,-155,10366,448836250,19016
1475,l1601,20150319,8560,8655,8600,8760,8520,8550,8635,-105,-20,14366,620474100,18806
1476,l1601,20150320,8550,8635,8570,8635,8500,8550,8570,-85,-65,7544,323438600,19896
1477,l1601,20150323,8550,8570,8600,8910,8600,8910,8850,340,280,19154,847636400,21974
1478,l1601,20150324,8910,8850,9055,9200,9010,9130,9075,280,225,17246,782753350,25444
1479,l1601,20150325,9130,9075,9105,9170,9060,9065,9110,-10,35,10456,476288350,26456
1480,l1601,20150326,9065,9110,9150,9255,9110,9240,9190,130,80,11092,509677400,27876
1481,l1601,20150327,9240,9190,9240,9245,9110,9230,9175,40,-15,7388,339106850,27666
1482,l1601,20150330,9230,9175,9150,9305,9130,9295,9220,120,45,12520,577249000,24312
1483,l1601,20150331,9295,9220,9310,9395,9295,9295,9350,75,130,10646,497908400,23770
1484,l1601,20150401,9295,9350,9295,9405,9205,9390,9305,40,-45,7810,363401950,23210
1485,l1601,20150402,9390,9305,9450,9540,9425,9480,9490,175,185,11534,547377400,20708
1486,l1601,20150403,9480,9490,9440,9445,9115,9130,9260,-360,-230,11092,513818700,20704
1487,l1601,20150407,9130,9260,9250,9300,9125,9140,9200,-120,-60,9038,415883400,20804
1488,l1601,20150408,9140,9200,9200,9290,9105,9195,9210,-5,10,10732,494403600,21738
1489,l1601,20150409,9195,9210,9125,9160,9030,9095,9090,-115,-120,11680,530926050,25648
1490,l1601,20150410,9095,9090,9095,9135,8985,9060,9060,-30,-30,16624,753084500,25994
1491,l1601,20150413,9060,9060,9090,9170,9025,9090,9095,30,35,11624,528617800,26618
1492,l1601,20150414,9090,9095,9100,9140,9000,9030,9065,-65,-30,10624,481626400,27656
1493,l1601,20150415,9030,9065,9060,9090,8985,9025,9030,-40,-35,9574,432270900,28442
1494,l1601,20150416,9025,9030,9130,9380,9090,9280,9265,250,235,20552,952147000,29482
1495,l1601,20150417,9280,9265,9300,9495,9275,9300,9335,35,70,11346,529583650,29344
1496,l1601,20150420,9300,9335,9360,9470,9340,9430,9420,95,85,12308,579871000,28488
1497,l1601,20150421,9430,9420,9430,9525,9430,9495,9485,75,65,13822,655848150,27516
1498,l1601,20150422,9495,9485,9475,9475,9350,9355,9390,-130,-95,10372,487175500,28906
1499,l1601,20150423,9355,9390,9350,9565,9350,9500,9490,110,100,18056,857002350,30416
1500,l1601,20150424,9500,9490,9595,9680,9580,9660,9635,170,145,19162,923163700,29332
1501,l1601,20150427,9660,9635,9660,9890,9625,9845,9795,210,160,28554,1398774200,34284
1502,l1601,20150428,9845,9795,9840,9860,9735,9805,9780,10,-15,13974,683673000,35106
1503,l1601,20150429,9805,9780,9810,9815,9630,9670,9715,-110,-65,19168,931365450,34892
1504,l1601,20150430,9670,9715,9750,9855,9730,9815,9800,100,85,22704,1112571100,39632
1505,l1601,20150504,9815,9800,9820,9895,9735,9795,9820,-5,20,20508,1007216450,40016
1506,l1601,20150505,9795,9820,9780,9790,9700,9755,9745,-65,-75,13214,643977550,41202
1507,l1601,20150506,9755,9745,9830,9870,9605,9630,9735,-115,-10,31612,1539373000,46076
1508,l1601,20150507,9630,9735,9580,9580,9390,9435,9510,-300,-225,23560,1120695000,46710
1509,l1601,20150508,9435,9510,9380,9430,9315,9340,9370,-170,-140,17292,810282750,48976
1510,l1601,20150511,9340,9370,9375,9415,9300,9320,9335,-50,-35,19338,903051850,52634
1511,l1601,20150512,9320,9335,9270,9320,9220,9275,9280,-60,-55,34534,1602617950,51036
1512,l1601,20150513,9275,9280,9360,9430,9285,9345,9355,65,75,24786,1159942600,50884
1513,l1601,20150514,9345,9355,9280,9370,9210,9365,9280,10,-75,26034,1208173200,52710
1514,l1601,20150515,9365,9280,9345,9395,9265,9275,9320,-5,40,21308,993253550,56470
1515,l1601,20150518,9275,9320,9300,9300,9135,9140,9195,-180,-125,28846,1326748350,64000
1516,l1601,20150519,9140,9195,9130,9130,9005,9005,9085,-190,-110,29680,1348255600,69378
1517,l1601,20150520,9005,9085,8900,9075,8870,9060,8960,-25,-125,41288,1850095100,73182
1518,l1601,20150521,9060,8960,9075,9200,8975,9110,9110,150,150,68344,3113459150,64670
1519,l1601,20150522,9110,9110,9160,9250,9085,9250,9165,140,55,41028,1880804950,58698
1520,l1601,20150525,9250,9165,9190,9225,9135,9170,9175,5,10,26120,1198444300,60270
1521,l1601,20150526,9170,9175,9240,9300,9000,9020,9150,-155,-25,48202,2206444800,60582
1522,l1601,20150527,9020,9150,9000,9065,8975,9045,9015,-105,-135,31236,1408068950,63654
1523,l1601,20150528,9045,9015,9015,9070,8910,8985,8975,-30,-40,34798,1562338750,66452
1524,l1601,20150529,8985,8975,9005,9045,8985,9020,9010,45,35,18576,837301300,68444
1525,l1601,20150601,9020,9010,9105,9145,8970,9030,9040,20,30,28504,1288827450,70302
1526,l1601,20150602,9030,9040,9045,9090,8935,9090,9005,50,-35,37382,1683655050,75510
1527,l1601,20150603,9090,9005,9145,9145,9030,9095,9090,90,85,35258,1602524200,76488
1528,l1601,20150604,9095,9090,9050,9175,8990,9130,9070,40,-20,42116,1910264800,78190
1529,l1601,20150605,9130,9070,9080,9165,9045,9125,9110,55,40,35282,1607095100,83660
1530,l1601,20150608,9125,9110,9170,9170,8995,9030,9070,-80,-40,30278,1373184900,87352
1531,l1601,20150609,9030,9070,9050,9050,8995,9025,9020,-45,-50,19308,871270450,87170
1532,l1601,20150610,9025,9020,9100,9295,9075,9295,9190,275,170,49406,2270304200,87896
1533,l1601,20150611,9295,9190,9265,9425,9230,9345,9335,155,145,103120,4815232250,98986
1534,l1601,20150612,9345,9335,9280,9330,9205,9240,9260,-95,-75,41088,1903146300,97756
1535,l1601,20150615,9240,9260,9225,9400,9210,9395,9275,135,15,46140,2140325500,100068
1536,l1601,20150616,9395,9275,9400,9505,9295,9365,9420,90,145,71896,3386809500,107036
1537,l1601,20150617,9365,9420,9320,9375,9165,9170,9245,-250,-175,51772,2394325900,107544
1538,l1601,20150618,9170,9245,9170,9200,9090,9155,9150,-90,-95,37996,1738887000,104544
1539,l1601,20150619,9155,9150,9165,9315,9165,9205,9235,55,85,47482,2193331700,100594
1540,l1601,20150623,9205,9235,9220,9260,9090,9205,9170,-30,-65,41398,1898973750,103550
1541,l1601,20150624,9205,9170,9240,9340,9215,9320,9280,150,110,55492,2575567600,103808
1542,l1601,20150625,9320,9280,9320,9320,9250,9290,9275,10,-5,41176,1910265900,105052
1543,l1601,20150626,9290,9275,9260,9470,9260,9440,9395,165,120,103100,4845005350,97626
1544,l1601,20150629,9440,9395,9500,9500,9140,9370,9305,-25,-90,113522,5282613500,101248
1545,l1601,20150630,9370,9305,9305,9430,9255,9390,9345,85,40,77754,3633408600,98682
1546,l1601,20150701,9390,9345,9500,9550,9400,9450,9465,105,120,71410,3379687900,102154
1547,l1601,20150702,9450,9465,9390,9465,9365,9465,9405,0,-60,48278,2271020800,101794
1548,l1601,20150703,9465,9405,9445,9485,9350,9425,9425,20,20,71934,3390947650,100942
1549,l1601,20150706,9425,9425,9320,9375,9095,9180,9225,-245,-200,131488,6066538850,109526
1550,l1601,20150707,9180,9225,9070,9110,8860,8860,9010,-365,-215,122288,5509793000,129580
1551,l1601,20150708,8860,9010,8505,8750,8470,8470,8555,-540,-455,151722,6492291550,128448
1552,l1601,20150709,8470,8555,8700,9160,8690,9065,8955,510,400,193998,8688331150,122686
1553,l1601,20150710,9065,8955,9075,9285,9020,9065,9120,110,165,140374,6402862900,129356
1554,l1601,20150713,9065,9120,9050,9050,8885,8985,8960,-135,-160,104818,4697728900,133876
1555,l1601,20150714,8985,8960,8990,9100,8930,8945,9025,-15,65,102406,4622765700,141610
1556,l1601,20150715,8945,9025,9045,9100,8960,9005,9020,-20,-5,83824,3781209800,142354
1557,l1601,20150716,9005,9020,8950,8950,8805,8830,8850,-190,-170,116126,5140796800,151292
1558,l1601,20150717,8830,8850,8805,8880,8765,8825,8825,-25,-25,80704,3562089450,153896
1559,l1601,20150720,8825,8825,8805,8880,8775,8855,8825,30,0,107846,4759070900,154638
1560,l1601,20150721,8855,8825,8835,8850,8760,8830,8800,5,-25,95186,4188533300,162116
1561,l1601,20150722,8830,8800,8830,8975,8795,8960,8890,160,90,173784,7727819350,167746
1562,l1601,20150723,8960,8890,8900,8985,8880,8925,8925,35,35,123728,5521429900,163020
1563,l1601,20150724,8925,8925,8870,8880,8660,8665,8755,-260,-170,269266,11787894600,207662
1564,l1601,20150727,8665,8755,8640,8665,8405,8405,8470,-350,-285,345638,14642366650,241960
1565,l1601,20150728,8405,8470,8555,8555,8280,8525,8440,55,-30,365352,15425763150,234390
1566,l1601,20150729,8525,8440,8585,8715,8550,8600,8625,160,185,267616,11545433100,222180
1567,l1601,20150730,8600,8625,8660,8690,8500,8500,8610,-125,-15,212070,9130896350,245544
1568,l1601,20150731,8500,8610,8455,8515,8430,8490,8470,-120,-140,206650,8756458700,255210
1569,l1601,20150803,8490,8470,8380,8445,8135,8210,8245,-260,-225,458698,18919574050,321184
1570,l1601,20150804,8210,8245,8095,8380,8085,8365,8250,120,5,758844,31305267600,365862
1571,l1601,20150805,8365,8250,8380,8490,8315,8480,8395,230,145,733438,30801799000,349772
1572,l1601,20150806,8480,8395,8405,8455,8305,8380,8370,-15,-25,861970,36081525000,385976
1573,l1601,20150807,8380,8370,8330,8510,8270,8495,8365,125,-5,896740,37528073750,397508
1574,l1601,20150810,8495,8365,8450,8590,8395,8590,8475,225,110,780982,33100880350,422446
1575,l1601,20150811,8590,8475,8625,8810,8625,8810,8760,335,285,1228036,53817317550,409136
1576,l1601,20150812,8810,8760,8790,8880,8720,8870,8805,110,45,1061996,46766622350,416456
1577,l1601,20150813,8870,8805,8895,8920,8755,8885,8820,80,15,910750,40185499700,422034
1578,l1601,20150814,8885,8820,8800,8915,8785,8875,8860,55,40,812658,36001035600,447552
1579,l1601,20150817,8875,8860,8860,8875,8650,8680,8745,-180,-115,997086,43621751700,426500
1580,l1601,20150818,8680,8745,8655,8675,8475,8535,8550,-210,-195,1023460,43767307750,412236
1581,l1601,20150819,8535,8550,8565,8625,8515,8550,8570,0,20,852906,36550799000,427996
1582,l1601,20150820,8550,8570,8425,8475,8350,8460,8405,-110,-165,809264,34023459300,434264
1583,l1601,20150821,8460,8405,8495,8525,8420,8460,8470,55,65,716152,30331800900,430124
1584,l1601,20150824,8460,8470,8300,8300,8140,8155,8195,-315,-275,1042544,42735755850,444318
1585,l1601,20150825,8155,8195,8070,8335,8040,8270,8225,75,30,1162484,47821075600,448018
1586,l1601,20150826,8270,8225,8335,8350,8210,8255,8275,30,50,790224,32705689600,448282
1587,l1601,20150827,8255,8275,8295,8520,8290,8515,8420,240,145,1031358,43425311000,474944
1588,l1601,20150828,8515,8420,8755,8755,8635,8655,8695,235,275,819400,35643428850,395906
1589,l1601,20150831,8655,8695,8655,8680,8530,8555,8590,-140,-105,781986,33597501550,407470
1590,l1601,20150901,8555,8590,8660,8735,8610,8625,8675,35,85,704624,30574321950,408086
1591,l1601,20150902,8625,8675,8505,8610,8475,8610,8540,-65,-135,445662,19040317500,407536
1592,l1601,20150907,8610,8540,8590,8685,8510,8510,8605,-30,65,611760,26324449350,425086
1593,l1601,20150908,8510,8605,8495,8540,8380,8460,8440,-145,-165,892116,37652821150,448110
1594,l1601,20150909,8460,8440,8575,8670,8550,8580,8605,140,165,1085748,46722693400,413416
1595,l1601,20150910,8580,8605,8515,8685,8445,8680,8525,75,-80,1064994,45405511650,452864
1596,l1601,20150911,8680,8525,8720,8795,8620,8640,8705,115,180,1266668,55149265400,456624
1597,l1601,20150914,8640,8705,8640,8710,8525,8530,8625,-175,-80,792222,34182435700,464912
1598,l1601,20150915,8530,8625,8530,8565,8430,8510,8485,-115,-140,835622,35469785800,470368
1599,l1601,20150916,8510,8485,8570,8590,8435,8535,8500,50,15,882912,37540720650,455902
1600,l1601,20150917,8535,8500,8630,8635,8455,8455,8555,-45,55,900066,38521673750,474322
1601,l1601,20150918,8455,8555,8475,8525,8365,8375,8450,-180,-105,1032110,43630705350,505886
1602,l1601,20150921,8375,8450,8310,8485,8300,8475,8395,25,-55,767744,32234967650,469870
1603,l1601,20150922,8475,8395,8460,8470,8360,8420,8410,25,15,674178,28362963350,439544
1604,l1601,20150923,8420,8410,8440,8520,8390,8515,8455,105,45,996838,42154637800,455596
1605,l1601,20150924,8515,8455,8445,8485,8405,8460,8440,5,-15,631180,26650619850,438422
1606,l1601,20150925,8460,8440,8500,8505,8340,8345,8430,-95,-10,779346,32855340150,462524
1607,l1601,20150928,8345,8430,8350,8365,8235,8250,8300,-180,-130,644404,26745387300,463966
1608,l1601,20150929,8250,8300,8210,8240,8110,8230,8170,-70,-130,643004,26277536350,410446
1609,l1601,20150930,8230,8170,8230,8310,8195,8300,8250,130,80,445568,18383875250,400268
1610,l1601,20151008,8300,8250,8445,8480,8370,8410,8415,160,165,462038,19451738750,381392
1611,l1601,20151009,8410,8415,8490,8730,8455,8665,8595,250,180,932116,40060602600,365570
1612,l1601,20151012,8665,8595,8645,8680,8605,8630,8640,35,45,461448,19935851550,378396
1613,l1601,20151013,8630,8640,8530,8605,8515,8595,8545,-45,-95,464530,19852763000,375776
1614,l1601,20151014,8595,8545,8540,8590,8435,8450,8520,-95,-25,576534,24562674050,372352
1615,l1601,20151015,8450,8520,8455,8495,8420,8450,8460,-70,-60,558098,23607912450,367252
1616,l1601,20151016,8450,8460,8485,8490,8380,8395,8425,-65,-35,545592,22987106650,368908
1617,l1601,20151019,8395,8425,8400,8410,8325,8350,8360,-75,-65,419002,17514525350,389186
1618,l1601,20151020,8350,8360,8325,8420,8305,8395,8355,35,-5,478972,20019948200,395992
1619,l1601,20151021,8395,8355,8380,8380,8315,8340,8340,-15,-15,431966,18019316900,382766
1620,l1601,20151022,8340,8340,8370,8535,8360,8435,8455,95,115,827884,35017703450,404132
1621,l1601,20151023,8435,8455,8435,8475,8315,8375,8385,-80,-70,776318,32553158200,377954
1622,l1601,20151026,8375,8385,8335,8360,8230,8240,8280,-145,-105,738192,30562139550,421592
1623,l1601,20151027,8240,8280,8210,8330,8190,8300,8260,20,-20,745458,30796028300,403800
1624,l1601,20151028,8300,8260,8295,8315,8245,8280,8275,20,15,539474,22326480650,411712
1625,l1601,20151029,8280,8275,8380,8390,8265,8285,8330,10,55,496372,20678358350,431106
1626,l1601,20151030,8285,8330,8285,8285,8170,8245,8230,-85,-100,548120,22558170950,441454
1627,l1601,20151102,8245,8230,8230,8315,8220,8285,8275,55,45,456500,18895677450,431514
1628,l1601,20151103,8285,8275,8270,8290,8205,8215,8245,-60,-30,538360,22194180550,428926
1629,l1601,20151104,8215,8245,8270,8345,8235,8300,8290,55,45,663848,27529579850,449920
1630,l1601,20151105,8300,8290,8245,8260,7995,8010,8110,-280,-180,1337040,54224222300,571680
1631,l1601,20151106,8010,8110,8000,8130,7955,8100,8045,-10,-65,1085524,43676652250,571406
1632,l1601,20151109,8100,8045,8070,8120,8010,8040,8055,-5,10,623460,25123958900,565366
1633,l1601,20151110,8040,8055,8030,8035,7930,8025,7975,-30,-80,805580,32129744900,527706
1634,l1601,20151111,8025,7975,8005,8065,7970,8045,8020,70,45,557614,22367293750,495466
1635,l1601,20151112,8045,8020,8025,8085,8010,8035,8050,15,30,505510,20358347300,464110
1636,l1601,20151113,8035,8050,8005,8030,7810,7860,7905,-190,-145,1006050,39778518400,452350
1637,l1601,20151116,7860,7905,7860,7925,7805,7845,7870,-60,-35,552460,21741848650,451804
1638,l1601,20151117,7845,7870,7865,7935,7760,7895,7865,25,-5,913630,35935707200,443174
1639,l1601,20151118,7895,7865,7880,7890,7750,7775,7800,-90,-65,882910,34433566300,454912
1640,l1601,20151119,7775,7800,7760,7820,7695,7710,7750,-90,-50,763510,29590462000,456296
1641,l1601,20151120,7710,7750,7735,7775,7500,7565,7600,-185,-150,1313040,49912820750,435114
1642,l1601,20151123,7565,7600,7590,7705,7485,7690,7620,90,20,1028126,39181155050,402160
1643,l1601,20151124,7690,7620,7710,7920,7690,7920,7805,300,185,720276,28121022800,369426
1644,l1601,20151125,7920,7805,8010,8060,7935,8000,7995,195,190,774738,30987996850,298170
1645,l1601,20151126,8000,7995,8010,8290,7985,8125,8140,130,145,744486,30301182700,247984
1646,l1601,20151127,8125,8140,8110,8180,8060,8150,8105,10,-35,283720,11501708000,212734
1647,l1601,20151130,8150,8105,8130,8295,8110,8295,8195,190,90,248626,10192548100,180112
1648,l1601,20151201,8295,8195,8275,8345,8215,8330,8285,135,90,172460,7147718000,150174
1649,l1601,20151202,8330,8285,8335,8370,8265,8275,8320,-10,35,99136,4124947400,142524
1650,l1601,20151203,8275,8320,8175,8340,8175,8335,8250,15,-70,130280,5376459700,133556
1651,l1601,20151204,8335,8250,8375,8410,8290,8345,8350,95,100,107822,4501893900,133232
1652,l1601,20151207,8345,8350,8300,8345,8215,8280,8275,-70,-75,111980,4635524050,117396
1653,l1601,20151208,8280,8275,8180,8245,8085,8140,8150,-135,-125,120390,4908592800,100528
1654,l1601,20151209,8140,8150,8185,8275,8140,8255,8220,105,70,80056,3292233450,90872
1655,l1601,20151210,8255,8220,8235,8245,8170,8225,8200,5,-20,66430,2723886850,78382
1656,l1601,20151211,8225,8200,8185,8255,8120,8250,8190,50,-10,58508,2396674650,73208
1657,l1601,20151214,8250,8190,8230,8230,8110,8185,8160,-5,-30,48408,1975972600,58902
1658,l1601,20151215,8185,8160,8210,8230,8150,8180,8185,20,25,18568,760151300,54870
1659,l1601,20151216,8180,8185,8190,8260,8170,8245,8220,60,35,13400,550837950,51042
1660,l1601,20151217,8245,8220,8220,8315,8200,8270,8275,50,55,16218,671304000,49154
1661,l1601,20151218,8270,8275,8260,8425,8250,8400,8350,125,75,18220,760773350,46706
1662,l1601,20151221,8400,8350,8410,8540,8390,8510,8460,160,110,23376,988862950,37564
1663,l1601,20151222,8510,8460,8490,8570,8465,8550,8530,90,70,18420,785633650,30654
1664,l1601,20151223,8550,8530,8550,8570,8485,8535,8540,5,10,8656,369738650,26904
1665,l1601,20151224,8535,8540,8565,8700,8555,8605,8610,65,70,11088,477463500,22808
1666,l1601,20151225,8605,8610,8640,8700,8560,8690,8625,80,15,7962,343403900,18202
1667,l1601,20151228,8690,8625,8670,8740,8625,8695,8665,70,40,6158,266829200,14706
1668,l1601,20151229,8695,8665,8665,8745,8635,8690,8690,25,25,8714,378660650,9302
1669,l1601,20151230,8690,8690,8720,8775,8670,8755,8720,65,30,5182,225988200,5964
1670,l1601,20151231,8755,8720,8740,8870,8740,8845,8820,125,100,5280,232877450,1722
1671,l1602,20150216,8530,8530,0,0,0,8535,8535,5,5,0,0,0
1672,l1602,20150217,8535,8535,0,0,0,8500,8500,-35,-35,0,0,0
1673,l1602,20150225,8500,8500,0,0,0,8415,8415,-85,-85,0,0,0
1674,l1602,20150226,8415,8415,0,0,0,8605,8605,190,190,0,0,0
1675,l1602,20150227,8605,8605,0,0,0,8625,8625,20,20,0,0,0
1676,l1602,20150302,8625,8625,0,0,0,8780,8780,155,155,0,0,0
1677,l1602,20150303,8780,8780,0,0,0,8780,8780,0,0,0,0,0
1678,l1602,20150304,8780,8780,0,0,0,8780,8780,0,0,0,0,0
1679,l1602,20150305,8780,8780,0,0,0,8780,8780,0,0,0,0,0
1680,l1602,20150306,8780,8780,0,0,0,8780,8780,0,0,0,0,0
1681,l1602,20150309,8780,8780,0,0,0,8780,8780,0,0,0,0,0
1682,l1602,20150310,8780,8780,0,0,0,8650,8650,-130,-130,0,0,0
1683,l1602,20150311,8650,8650,0,0,0,8650,8650,0,0,0,0,0
1684,l1602,20150312,8650,8650,0,0,0,8650,8650,0,0,0,0,0
1685,l1602,20150313,8650,8650,0,0,0,8670,8670,20,20,0,0,0
1686,l1602,20150316,8670,8670,0,0,0,8690,8690,20,20,0,0,0
1687,l1602,20150317,8690,8690,0,0,0,8770,8770,80,80,0,0,0
1688,l1602,20150318,8770,8770,0,0,0,8595,8595,-175,-175,0,0,0
1689,l1602,20150319,8595,8595,0,0,0,8595,8595,0,0,0,0,0
1690,l1602,20150320,8595,8595,0,0,0,8595,8595,0,0,0,0,0
1691,l1602,20150323,8595,8595,0,0,0,8875,8875,280,280,0,0,0
1692,l1602,20150324,8875,8875,0,0,0,9070,9070,195,195,0,0,0
1693,l1602,20150325,9070,9070,0,0,0,9070,9070,0,0,0,0,0
1694,l1602,20150326,9070,9070,0,0,0,9175,9175,105,105,0,0,0
1695,l1602,20150327,9175,9175,0,0,0,9180,9180,5,5,0,0,0
1696,l1602,20150330,9180,9180,0,0,0,9250,9250,70,70,0,0,0
1697,l1602,20150331,9250,9250,0,0,0,9250,9250,0,0,0,0,0
1698,l1602,20150401,9250,9250,0,0,0,9340,9340,90,90,0,0,0
1699,l1602,20150402,9340,9340,9510,9510,9510,9510,9510,170,170,2,95100,2
1700,l1602,20150403,9510,9510,0,0,0,9280,9280,-230,-230,0,0,2
1701,l1602,20150407,9280,9280,9205,9205,9180,9180,9190,-100,-90,4,183850,6
1702,l1602,20150408,9180,9190,0,0,0,9190,9190,0,0,0,0,6
1703,l1602,20150409,9190,9190,0,0,0,9135,9135,-55,-55,0,0,6
1704,l1602,20150410,9135,9135,9060,9060,9060,9060,9060,-75,-75,2,90600,8
1705,l1602,20150413,9060,9060,9110,9110,9110,9110,9110,50,50,2,91100,10
1706,l1602,20150414,9110,9110,0,0,0,9105,9105,-5,-5,0,0,10
1707,l1602,20150415,9105,9105,0,0,0,9105,9105,0,0,0,0,10
1708,l1602,20150416,9105,9105,9240,9270,9240,9270,9260,165,155,8,370500,6
1709,l1602,20150417,9270,9260,0,0,0,9325,9325,65,65,0,0,6
1710,l1602,20150420,9325,9325,0,0,0,9405,9405,80,80,0,0,6
1711,l1602,20150421,9405,9405,9420,9420,9420,9420,9420,15,15,2,94200,4
1712,l1602,20150422,9420,9420,9420,9420,9420,9420,9420,0,0,2,94200,6
1713,l1602,20150423,9420,9420,0,0,0,9520,9520,100,100,0,0,6
1714,l1602,20150424,9520,9520,0,0,0,9665,9665,145,145,0,0,6
1715,l1602,20150427,9665,9665,9810,9880,9810,9880,9845,215,180,4,196900,6
1716,l1602,20150428,9880,9845,0,0,0,9830,9830,-15,-15,0,0,6
1717,l1602,20150429,9830,9830,0,0,0,9765,9765,-65,-65,0,0,6
1718,l1602,20150430,9765,9765,0,0,0,9765,9765,0,0,0,0,6
1719,l1602,20150504,9765,9765,0,0,0,9780,9780,15,15,0,0,6
1720,l1602,20150505,9780,9780,9710,9710,9710,9710,9710,-70,-70,2,97100,4
1721,l1602,20150506,9710,9710,9705,9705,9705,9705,9705,-5,-5,2,97050,6
1722,l1602,20150507,9705,9705,0,0,0,9485,9485,-220,-220,0,0,6
1723,l1602,20150508,9485,9485,0,0,0,9350,9350,-135,-135,0,0,6
1724,l1602,20150511,9350,9350,0,0,0,9320,9320,-30,-30,0,0,6
1725,l1602,20150512,9320,9320,0,0,0,9270,9270,-50,-50,0,0,6
1726,l1602,20150513,9270,9270,0,0,0,9340,9340,70,70,0,0,6
1727,l1602,20150514,9340,9340,0,0,0,9270,9270,-70,-70,0,0,6
1728,l1602,20150515,9270,9270,0,0,0,9305,9305,35,35,0,0,6
1729,l1602,20150518,9305,9305,0,0,0,9185,9185,-120,-120,0,0,6
1730,l1602,20150519,9185,9185,0,0,0,9080,9080,-105,-105,0,0,6
1731,l1602,20150520,9080,9080,0,0,0,8960,8960,-120,-120,0,0,6
1732,l1602,20150521,8960,8960,0,0,0,9105,9105,145,145,0,0,6
1733,l1602,20150522,9105,9105,0,0,0,9155,9155,50,50,0,0,6
1734,l1602,20150525,9155,9155,0,0,0,9160,9160,5,5,0,0,6
1735,l1602,20150526,9160,9160,0,0,0,9140,9140,-20,-20,0,0,6
1736,l1602,20150527,9140,9140,0,0,0,9010,9010,-130,-130,0,0,6
1737,l1602,20150528,9010,9010,8950,8950,8950,8950,8950,-60,-60,2,89500,6
1738,l1602,20150529,8950,8950,8975,8975,8975,8975,8975,25,25,2,89750,4
1739,l1602,20150601,8975,8975,0,0,0,9000,9000,25,25,0,0,4
1740,l1602,20150602,9000,9000,0,0,0,8970,8970,-30,-30,0,0,4
1741,l1602,20150603,8970,8970,0,0,0,9050,9050,80,80,0,0,4
1742,l1602,20150604,9050,9050,0,0,0,9035,9035,-15,-15,0,0,4
1743,l1602,20150605,9035,9035,0,0,0,9070,9070,35,35,0,0,4
1744,l1602,20150608,9070,9070,0,0,0,9035,9035,-35,-35,0,0,4
1745,l1602,20150609,9035,9035,0,0,0,8990,8990,-45,-45,0,0,4
1746,l1602,20150610,8990,8990,9195,9195,9195,9195,9195,205,205,2,91950,2
1747,l1602,20150611,9195,9195,0,0,0,9340,9340,145,145,0,0,2
1748,l1602,20150612,9340,9340,0,0,0,9265,9265,-75,-75,0,0,2
1749,l1602,20150615,9265,9265,0,0,0,9280,9280,15,15,0,0,2
1750,l1602,20150616,9280,9280,0,0,0,9425,9425,145,145,0,0,2
1751,l1602,20150617,9425,9425,0,0,0,9250,9250,-175,-175,0,0,2
1752,l1602,20150618,9250,9250,0,0,0,9155,9155,-95,-95,0,0,2
1753,l1602,20150619,9155,9155,0,0,0,9240,9240,85,85,0,0,2
1754,l1602,20150623,9240,9240,0,0,0,9175,9175,-65,-65,0,0,2
1755,l1602,20150624,9175,9175,0,0,0,9285,9285,110,110,0,0,2
1756,l1602,20150625,9285,9285,0,0,0,9280,9280,-5,-5,0,0,2
1757,l1602,20150626,9280,9280,0,0,0,9400,9400,120,120,0,0,2
1758,l1602,20150629,9400,9400,0,0,0,9310,9310,-90,-90,0,0,2
1759,l1602,20150630,9310,9310,0,0,0,9350,9350,40,40,0,0,2
1760,l1602,20150701,9350,9350,0,0,0,9470,9470,120,120,0,0,2
1761,l1602,20150702,9470,9470,0,0,0,9410,9410,-60,-60,0,0,2
1762,l1602,20150703,9410,9410,0,0,0,9430,9430,20,20,0,0,2
1763,l1602,20150706,9430,9430,0,0,0,9230,9230,-200,-200,0,0,2
1764,l1602,20150707,9230,9230,0,0,0,9015,9015,-215,-215,0,0,2
1765,l1602,20150708,9015,9015,8655,8655,8655,8655,8655,-360,-360,2,86550,4
1766,l1602,20150709,8655,8655,0,0,0,9055,9055,400,400,0,0,4
1767,l1602,20150710,9055,9055,0,0,0,9220,9220,165,165,0,0,4
1768,l1602,20150713,9220,9220,8970,8985,8970,8985,8975,-235,-245,4,179550,6
1769,l1602,20150714,8985,8975,0,0,0,9040,9040,65,65,0,0,6
1770,l1602,20150715,9040,9040,0,0,0,9035,9035,-5,-5,0,0,6
1771,l1602,20150716,9035,9035,8775,8775,8775,8775,8775,-260,-260,2,87750,4
1772,l1602,20150717,8775,8775,0,0,0,8755,8755,-20,-20,0,0,4
1773,l1602,20150720,8755,8755,0,0,0,8755,8755,0,0,0,0,4
1774,l1602,20150721,8755,8755,0,0,0,8735,8735,-20,-20,0,0,4
1775,l1602,20150722,8735,8735,0,0,0,8820,8820,85,85,0,0,4
1776,l1602,20150723,8820,8820,8815,8950,8815,8950,8880,130,60,4,177650,2
1777,l1602,20150724,8950,8880,0,0,0,8715,8715,-165,-165,0,0,2
1778,l1602,20150727,8715,8715,0,0,0,8435,8435,-280,-280,0,0,2
1779,l1602,20150728,8435,8435,0,0,0,8410,8410,-25,-25,0,0,2
1780,l1602,20150729,8410,8410,0,0,0,8590,8590,180,180,0,0,2
1781,l1602,20150730,8590,8590,0,0,0,8580,8580,-10,-10,0,0,2
1782,l1602,20150731,8580,8580,0,0,0,8445,8445,-135,-135,0,0,2
1783,l1602,20150803,8445,8445,0,0,0,8225,8225,-220,-220,0,0,2
1784,l1602,20150804,8225,8225,0,0,0,8225,8225,0,0,0,0,2
1785,l1602,20150805,8225,8225,0,0,0,8365,8365,140,140,0,0,2
1786,l1602,20150806,8365,8365,0,0,0,8345,8345,-20,-20,0,0,2
1787,l1602,20150807,8345,8345,0,0,0,8345,8345,0,0,0,0,2
1788,l1602,20150810,8345,8345,8310,8440,8305,8440,8370,95,25,8,334950,4
1789,l1602,20150811,8440,8370,0,0,0,8650,8650,280,280,0,0,4
1790,l1602,20150812,8650,8650,0,0,0,8690,8690,40,40,0,0,4
1791,l1602,20150813,8690,8690,0,0,0,8700,8700,10,10,0,0,4
1792,l1602,20150814,8700,8700,0,0,0,8735,8735,35,35,0,0,4
1793,l1602,20150817,8735,8735,0,0,0,8625,8625,-110,-110,0,0,4
1794,l1602,20150818,8625,8625,8405,8500,8405,8500,8450,-125,-175,4,169050,4
1795,l1602,20150819,8500,8450,8535,8580,8425,8455,8490,5,40,42,1783050,2
1796,l1602,20150820,8455,8490,8265,8355,8265,8355,8310,-135,-180,20,831000,0
1797,l1602,20150821,8355,8310,0,0,0,8370,8370,60,60,0,0,0
1798,l1602,20150824,8370,8370,0,0,0,8100,8100,-270,-270,0,0,0
1799,l1602,20150825,8100,8100,0,0,0,8255,8255,155,155,0,0,0
1800,l1602,20150826,8255,8255,8290,8290,8175,8175,8230,-80,-25,4,164650,0
1801,l1602,20150827,8175,8230,8175,8405,8175,8350,8265,120,35,26,1074550,2
1802,l1602,20150828,8350,8265,0,0,0,8530,8530,265,265,0,0,2
1803,l1602,20150831,8530,8530,0,0,0,8430,8430,-100,-100,0,0,2
1804,l1602,20150901,8430,8430,8660,8660,8590,8590,8625,160,195,4,172500,2
1805,l1602,20150902,8590,8625,0,0,0,8495,8495,-130,-130,0,0,2
1806,l1602,20150907,8495,8495,0,0,0,8555,8555,60,60,0,0,2
1807,l1602,20150908,8555,8555,8370,8380,8370,8380,8375,-175,-180,40,1675000,2
1808,l1602,20150909,8380,8375,0,0,0,8535,8535,160,160,0,0,2
1809,l1602,20150910,8535,8535,0,0,0,8460,8460,-75,-75,0,0,2
1810,l1602,20150911,8460,8460,0,0,0,8635,8635,175,175,0,0,2
1811,l1602,20150914,8635,8635,0,0,0,8560,8560,-75,-75,0,0,2
1812,l1602,20150915,8560,8560,8380,8450,8320,8450,8350,-110,-210,34,1420200,2
1813,l1602,20150916,8450,8350,0,0,0,8360,8360,10,10,0,0,2
1814,l1602,20150917,8360,8360,0,0,0,8410,8410,50,50,0,0,2
1815,l1602,20150918,8410,8410,8440,8445,8320,8320,8410,-90,0,52,2187500,8
1816,l1602,20150921,8320,8410,8390,8390,8325,8325,8355,-85,-55,16,668700,0
1817,l1602,20150922,8325,8355,8250,8430,8250,8345,8330,-10,-25,26,1082900,2
1818,l1602,20150923,8345,8330,8230,8345,8230,8345,8265,15,-65,6,248050,4
1819,l1602,20150924,8345,8265,0,0,0,8255,8255,-10,-10,0,0,4
1820,l1602,20150925,8255,8255,0,0,0,8250,8250,-5,-5,0,0,4
1821,l1602,20150928,8250,8250,8330,8330,8215,8215,8270,-35,20,4,165450,4
1822,l1602,20150929,8215,8270,0,0,0,8145,8145,-125,-125,0,0,4
1823,l1602,20150930,8145,8145,0,0,0,8220,8220,75,75,0,0,4
1824,l1602,20151008,8220,8220,8390,8390,8390,8390,8390,170,170,2,83900,4
1825,l1602,20151009,8390,8390,8420,8420,8420,8420,8420,30,30,2,84200,4
1826,l1602,20151012,8420,8420,0,0,0,8425,8425,5,5,0,0,4
1827,l1602,20151013,8425,8425,0,0,0,8445,8445,20,20,0,0,4
1828,l1602,20151014,8445,8445,0,0,0,8425,8425,-20,-20,0,0,4
1829,l1602,20151015,8425,8425,0,0,0,8370,8370,-55,-55,0,0,4
1830,l1602,20151016,8370,8370,0,0,0,8340,8340,-30,-30,0,0,4
1831,l1602,20151019,8340,8340,0,0,0,8280,8280,-60,-60,0,0,4
1832,l1602,20151020,8280,8280,0,0,0,8280,8280,0,0,0,0,4
1833,l1602,20151021,8280,8280,0,0,0,8270,8270,-10,-10,0,0,4
1834,l1602,20151022,8270,8270,0,0,0,8380,8380,110,110,0,0,4
1835,l1602,20151023,8380,8380,0,0,0,8315,8315,-65,-65,0,0,4
1836,l1602,20151026,8315,8315,0,0,0,8215,8215,-100,-100,0,0,4
1837,l1602,20151027,8215,8215,8270,8310,8270,8310,8285,95,70,38,1574800,26
1838,l1602,20151028,8310,8285,0,0,0,8300,8300,15,15,0,0,26
1839,l1602,20151029,8300,8300,8330,8335,8305,8305,8320,5,20,28,1164900,14
1840,l1602,20151030,8305,8320,8180,8180,8180,8180,8180,-140,-140,4,163600,10
1841,l1602,20151102,8180,8180,0,0,0,8220,8220,40,40,0,0,10
1842,l1602,20151103,8220,8220,0,0,0,8195,8195,-25,-25,0,0,10
1843,l1602,20151104,8195,8195,0,0,0,8235,8235,40,40,0,0,10
1844,l1602,20151105,8235,8235,7995,7995,7995,7995,7995,-240,-240,4,159900,6
1845,l1602,20151106,7995,7995,0,0,0,7935,7935,-60,-60,0,0,6
1846,l1602,20151109,7935,7935,0,0,0,7940,7940,5,5,0,0,6
1847,l1602,20151110,7940,7940,0,0,0,7865,7865,-75,-75,0,0,6
1848,l1602,20151111,7865,7865,7945,7995,7945,7995,7970,130,105,8,318800,2
1849,l1602,20151112,7995,7970,0,0,0,7995,7995,25,25,0,0,2
1850,l1602,20151113,7995,7995,0,0,0,7855,7855,-140,-140,0,0,2
1851,l1602,20151116,7855,7855,7750,7750,7750,7750,7750,-105,-105,2,77500,4
1852,l1602,20151117,7750,7750,0,0,0,7750,7750,0,0,0,0,4
1853,l1602,20151118,7750,7750,0,0,0,7690,7690,-60,-60,0,0,4
1854,l1602,20151119,7690,7690,0,0,0,7645,7645,-45,-45,0,0,4
1855,l1602,20151120,7645,7645,7870,7870,7870,7870,7870,225,225,2,78700,4
1856,l1602,20151123,7870,7870,0,0,0,7890,7890,20,20,0,0,4
1857,l1602,20151124,7890,7890,0,0,0,8080,8080,190,190,0,0,4
1858,l1602,20151125,8080,8080,7940,7940,7935,7935,7935,-145,-145,4,158750,2
1859,l1602,20151126,7935,7935,0,0,0,8075,8075,140,140,0,0,2
1860,l1602,20151127,8075,8075,0,0,0,8045,8045,-30,-30,0,0,2
1861,l1602,20151130,8045,8045,0,0,0,8130,8130,85,85,0,0,2
1862,l1602,20151201,8130,8130,8345,8345,8025,8320,8205,190,75,30,1231400,0
1863,l1602,20151202,8320,8205,0,0,0,8235,8235,30,30,0,0,0
1864,l1602,20151203,8235,8235,8235,8235,7955,8040,8090,-195,-145,70,2831750,10
1865,l1602,20151204,8040,8090,0,0,0,8090,8090,0,0,0,0,10
1866,l1602,20151207,8090,8090,0,0,0,8090,8090,0,0,0,0,10
1867,l1602,20151208,8090,8090,7815,7815,7815,7815,7815,-275,-275,2,78150,8
1868,l1602,20151209,7815,7815,7815,7970,7780,7970,7890,155,75,36,1420300,6
1869,l1602,20151210,7970,7890,7835,7990,7815,7990,7865,100,-25,36,1415750,8
1870,l1602,20151211,7990,7865,8215,8215,8110,8110,8160,245,295,4,163250,6
1871,l1602,20151214,8110,8160,0,0,0,8160,8160,0,0,0,0,6
1872,l1602,20151215,8160,8160,0,0,0,8185,8185,25,25,0,0,6
1873,l1602,20151216,8185,8185,0,0,0,8215,8215,30,30,0,0,6
1874,l1602,20151217,8215,8215,8445,8445,8445,8445,8445,230,230,10,422250,16
1875,l1602,20151218,8445,8445,0,0,0,8445,8445,0,0,0,0,16
1876,l1602,20151221,8445,8445,0,0,0,8445,8445,0,0,0,0,16
1877,l1602,20151222,8445,8445,8185,8185,8185,8185,8185,-260,-260,10,409250,16
1878,l1602,20151223,8185,8185,8390,8390,8385,8390,8385,205,200,10,419400,6
1879,l1602,20151224,8390,8385,0,0,0,8450,8450,65,65,0,0,6
1880,l1602,20151225,8450,8450,0,0,0,8450,8450,0,0,0,0,6
1881,l1602,20151228,8450,8450,0,0,0,8485,8485,35,35,0,0,6
1882,l1602,20151229,8485,8485,0,0,0,8505,8505,20,20,0,0,6
1883,l1602,20151230,8505,8505,0,0,0,8530,8530,25,25,0,0,6
1884,l1602,20151231,8530,8530,0,0,0,8625,8625,95,95,0,0,6
1885,l1603,20150316,8790,8790,8885,8885,8885,8885,8885,95,95,2,88850,2
1886,l1603,20150317,8885,8885,0,0,0,8885,8885,0,0,0,0,2
1887,l1603,20150318,8885,8885,0,0,0,8730,8730,-155,-155,0,0,2
1888,l1603,20150319,8730,8730,8560,8560,8560,8560,8560,-170,-170,2,85600,4
1889,l1603,20150320,8560,8560,8555,8555,8555,8555,8555,-5,-5,2,85550,6
1890,l1603,20150323,8555,8555,0,0,0,8830,8830,275,275,0,0,6
1891,l1603,20150324,8830,8830,0,0,0,9035,9035,205,205,0,0,6
1892,l1603,20150325,9035,9035,0,0,0,9035,9035,0,0,0,0,6
1893,l1603,20150326,9035,9035,9200,9200,9200,9200,9200,165,165,2,92000,4
1894,l1603,20150327,9200,9200,0,0,0,9200,9200,0,0,0,0,4
1895,l1603,20150330,9200,9200,0,0,0,9210,9210,10,10,0,0,4
1896,l1603,20150331,9210,9210,0,0,0,9220,9220,10,10,0,0,4
1897,l1603,20150401,9220,9220,0,0,0,9330,9330,110,110,0,0,4
1898,l1603,20150402,9330,9330,9530,9530,9530,9530,9530,200,200,2,95300,6
1899,l1603,20150403,9530,9530,0,0,0,9300,9300,-230,-230,0,0,6
1900,l1603,20150407,9300,9300,0,0,0,9210,9210,-90,-90,0,0,6
1901,l1603,20150408,9210,9210,0,0,0,9210,9210,0,0,0,0,6
1902,l1603,20150409,9210,9210,9180,9180,9180,9180,9180,-30,-30,2,91800,8
1903,l1603,20150410,9180,9180,9095,9095,9095,9095,9095,-85,-85,2,90950,10
1904,l1603,20150413,9095,9095,0,0,0,9145,9145,50,50,0,0,10
1905,l1603,20150414,9145,9145,0,0,0,9115,9115,-30,-30,0,0,10
1906,l1603,20150415,9115,9115,0,0,0,9080,9080,-35,-35,0,0,10
1907,l1603,20150416,9080,9080,0,0,0,9230,9230,150,150,0,0,10
1908,l1603,20150417,9230,9230,0,0,0,9295,9295,65,65,0,0,10
1909,l1603,20150420,9295,9295,0,0,0,9375,9375,80,80,0,0,10
1910,l1603,20150421,9375,9375,0,0,0,9385,9385,10,10,0,0,10
1911,l1603,20150422,9385,9385,0,0,0,9385,9385,0,0,0,0,10
1912,l1603,20150423,9385,9385,0,0,0,9420,9420,35,35,0,0,10
1913,l1603,20150424,9420,9420,0,0,0,9560,9560,140,140,0,0,10
1914,l1603,20150427,9560,9560,0,0,0,9735,9735,175,175,0,0,10
1915,l1603,20150428,9735,9735,0,0,0,9725,9725,-10,-10,0,0,10
1916,l1603,20150429,9725,9725,0,0,0,9665,9665,-60,-60,0,0,10
1917,l1603,20150430,9665,9665,0,0,0,9745,9745,80,80,0,0,10
1918,l1603,20150504,9745,9745,0,0,0,9760,9760,15,15,0,0,10
1919,l1603,20150505,9760,9760,0,0,0,9695,9695,-65,-65,0,0,10
1920,l1603,20150506,9695,9695,9710,9710,9710,9710,9710,15,15,2,97100,8
1921,l1603,20150507,9710,9710,9455,9455,9455,9455,9455,-255,-255,2,94550,10
1922,l1603,20150508,9455,9455,0,0,0,9455,9455,0,0,0,0,10
1923,l1603,20150511,9455,9455,0,0,0,9455,9455,0,0,0,0,10
1924,l1603,20150512,9455,9455,0,0,0,9455,9455,0,0,0,0,10
1925,l1603,20150513,9455,9455,0,0,0,9455,9455,0,0,0,0,10
1926,l1603,20150514,9455,9455,0,0,0,9455,9455,0,0,0,0,10
1927,l1603,20150515,9455,9455,0,0,0,9495,9495,40,40,0,0,10
1928,l1603,20150518,9495,9495,0,0,0,9370,9370,-125,-125,0,0,10
1929,l1603,20150519,9370,9370,0,0,0,9260,9260,-110,-110,0,0,10
1930,l1603,20150520,9260,9260,0,0,0,9135,9135,-125,-125,0,0,10
1931,l1603,20150521,9135,9135,0,0,0,9285,9285,150,150,0,0,10
1932,l1603,20150522,9285,9285,0,0,0,9340,9340,55,55,0,0,10
1933,l1603,20150525,9340,9340,0,0,0,9350,9350,10,10,0,0,10
1934,l1603,20150526,9350,9350,0,0,0,9325,9325,-25,-25,0,0,10
1935,l1603,20150527,9325,9325,0,0,0,9190,9190,-135,-135,0,0,10
1936,l1603,20150528,9190,9190,0,0,0,9130,9130,-60,-60,0,0,10
1937,l1603,20150529,9130,9130,0,0,0,9155,9155,25,25,0,0,10
1938,l1603,20150601,9155,9155,0,0,0,9185,9185,30,30,0,0,10
1939,l1603,20150602,9185,9185,0,0,0,9150,9150,-35,-35,0,0,10
1940,l1603,20150603,9150,9150,0,0,0,9235,9235,85,85,0,0,10
1941,l1603,20150604,9235,9235,0,0,0,9215,9215,-20,-20,0,0,10
1942,l1603,20150605,9215,9215,8935,9115,8935,9115,9025,-100,-190,4,180500,10
1943,l1603,20150608,9115,9025,0,0,0,8990,8990,-35,-35,0,0,10
1944,l1603,20150609,8990,8990,0,0,0,8945,8945,-45,-45,0,0,10
1945,l1603,20150610,8945,8945,0,0,0,9145,9145,200,200,0,0,10
1946,l1603,20150611,9145,9145,0,0,0,9285,9285,140,140,0,0,10
1947,l1603,20150612,9285,9285,0,0,0,9215,9215,-70,-70,0,0,10
1948,l1603,20150615,9215,9215,0,0,0,9225,9225,10,10,0,0,10
1949,l1603,20150616,9225,9225,9350,9355,9350,9355,9350,130,125,4,187050,8
1950,l1603,20150617,9355,9350,0,0,0,9180,9180,-170,-170,0,0,8
1951,l1603,20150618,9180,9180,0,0,0,9090,9090,-90,-90,0,0,8
1952,l1603,20150619,9090,9090,0,0,0,9170,9170,80,80,0,0,8
1953,l1603,20150623,9170,9170,0,0,0,9110,9110,-60,-60,0,0,8
1954,l1603,20150624,9110,9110,0,0,0,9215,9215,105,105,0,0,8
1955,l1603,20150625,9215,9215,0,0,0,9215,9215,0,0,0,0,8
1956,l1603,20150626,9215,9215,0,0,0,9330,9330,115,115,0,0,8
1957,l1603,20150629,9330,9330,0,0,0,9245,9245,-85,-85,0,0,8
1958,l1603,20150630,9245,9245,0,0,0,9280,9280,35,35,0,0,8
1959,l1603,20150701,9280,9280,0,0,0,9395,9395,115,115,0,0,8
1960,l1603,20150702,9395,9395,0,0,0,9340,9340,-55,-55,0,0,8
1961,l1603,20150703,9340,9340,0,0,0,9355,9355,15,15,0,0,8
1962,l1603,20150706,9355,9355,0,0,0,9160,9160,-195,-195,0,0,8
1963,l1603,20150707,9160,9160,0,0,0,8950,8950,-210,-210,0,0,8
1964,l1603,20150708,8950,8950,0,0,0,8595,8595,-355,-355,0,0,8
1965,l1603,20150709,8595,8595,0,0,0,8935,8935,340,340,0,0,8
1966,l1603,20150710,8935,8935,0,0,0,9095,9095,160,160,0,0,8
1967,l1603,20150713,9095,9095,0,0,0,8855,8855,-240,-240,0,0,8
1968,l1603,20150714,8855,8855,0,0,0,8915,8915,60,60,0,0,8
1969,l1603,20150715,8915,8915,0,0,0,8915,8915,0,0,0,0,8
1970,l1603,20150716,8915,8915,0,0,0,8660,8660,-255,-255,0,0,8
1971,l1603,20150717,8660,8660,0,0,0,8640,8640,-20,-20,0,0,8
1972,l1603,20150720,8640,8640,0,0,0,8640,8640,0,0,0,0,8
1973,l1603,20150721,8640,8640,0,0,0,8620,8620,-20,-20,0,0,8
1974,l1603,20150722,8620,8620,0,0,0,8705,8705,85,85,0,0,8
1975,l1603,20150723,8705,8705,0,0,0,8760,8760,55,55,0,0,8
1976,l1603,20150724,8760,8760,0,0,0,8595,8595,-165,-165,0,0,8
1977,l1603,20150727,8595,8595,0,0,0,8320,8320,-275,-275,0,0,8
1978,l1603,20150728,8320,8320,0,0,0,8295,8295,-25,-25,0,0,8
1979,l1603,20150729,8295,8295,0,0,0,8475,8475,180,180,0,0,8
1980,l1603,20150730,8475,8475,0,0,0,8465,8465,-10,-10,0,0,8
1981,l1603,20150731,8465,8465,0,0,0,8330,8330,-135,-135,0,0,8
1982,l1603,20150803,8330,8330,0,0,0,8110,8110,-220,-220,0,0,8
1983,l1603,20150804,8110,8110,0,0,0,8110,8110,0,0,0,0,8
1984,l1603,20150805,8110,8110,0,0,0,8250,8250,140,140,0,0,8
1985,l1603,20150806,8250,8250,0,0,0,8230,8230,-20,-20,0,0,8
1986,l1603,20150807,8230,8230,0,0,0,8230,8230,0,0,0,0,8
1987,l1603,20150810,8230,8230,0,0,0,8250,8250,20,20,0,0,8
1988,l1603,20150811,8250,8250,0,0,0,8580,8580,330,330,0,0,8
1989,l1603,20150812,8580,8580,0,0,0,8620,8620,40,40,0,0,8
1990,l1603,20150813,8620,8620,0,0,0,8630,8630,10,10,0,0,8
1991,l1603,20150814,8630,8630,0,0,0,8665,8665,35,35,0,0,8
1992,l1603,20150817,8665,8665,0,0,0,8555,8555,-110,-110,0,0,8
1993,l1603,20150818,8555,8555,8520,8635,8520,8635,8575,80,20,16,686200,8
1994,l1603,20150819,8635,8575,0,0,0,8615,8615,40,40,0,0,8
1995,l1603,20150820,8615,8615,0,0,0,8435,8435,-180,-180,0,0,8
1996,l1603,20150821,8435,8435,0,0,0,8500,8500,65,65,0,0,8
1997,l1603,20150824,8500,8500,0,0,0,8225,8225,-275,-275,0,0,8
1998,l1603,20150825,8225,8225,0,0,0,8255,8255,30,30,0,0,8
1999,l1603,20150826,8255,8255,0,0,0,8235,8235,-20,-20,0,0,8
2000,l1603,20150827,8235,8235,0,0,0,8270,8270,35,35,0,0,8
2001,l1603,20150828,8270,8270,8600,8600,8600,8600,8600,330,330,6,258000,4
2002,l1603,20150831,8600,8600,0,0,0,8500,8500,-100,-100,0,0,4
2003,l1603,20150901,8500,8500,8660,8660,8660,8660,8660,160,160,2,86600,4
2004,l1603,20150902,8660,8660,0,0,0,8530,8530,-130,-130,0,0,4
2005,l1603,20150907,8530,8530,0,0,0,8590,8590,60,60,0,0,4
2006,l1603,20150908,8590,8590,0,0,0,8410,8410,-180,-180,0,0,4
2007,l1603,20150909,8410,8410,0,0,0,8570,8570,160,160,0,0,4
2008,l1603,20150910,8570,8570,8640,8640,8520,8595,8580,25,10,118,5062900,4
2009,l1603,20150911,8595,8580,8650,8655,8650,8655,8650,75,70,12,519150,4
2010,l1603,20150914,8655,8650,0,0,0,8575,8575,-75,-75,0,0,4
2011,l1603,20150915,8575,8575,0,0,0,8365,8365,-210,-210,0,0,4
2012,l1603,20150916,8365,8365,0,0,0,8375,8375,10,10,0,0,4
2013,l1603,20150917,8375,8375,0,0,0,8425,8425,50,50,0,0,4
2014,l1603,20150918,8425,8425,0,0,0,8425,8425,0,0,0,0,4
2015,l1603,20150921,8425,8425,0,0,0,8370,8370,-55,-55,0,0,4
2016,l1603,20150922,8370,8370,0,0,0,8345,8345,-25,-25,0,0,4
2017,l1603,20150923,8345,8345,0,0,0,8280,8280,-65,-65,0,0,4
2018,l1603,20150924,8280,8280,0,0,0,8270,8270,-10,-10,0,0,4
2019,l1603,20150925,8270,8270,0,0,0,8265,8265,-5,-5,0,0,4
2020,l1603,20150928,8265,8265,0,0,0,8285,8285,20,20,0,0,4
2021,l1603,20150929,8285,8285,0,0,0,8160,8160,-125,-125,0,0,4
2022,l1603,20150930,8160,8160,0,0,0,8235,8235,75,75,0,0,4
2023,l1603,20151008,8235,8235,0,0,0,8405,8405,170,170,0,0,4
2024,l1603,20151009,8405,8405,0,0,0,8435,8435,30,30,0,0,4
2025,l1603,20151012,8435,8435,0,0,0,8475,8475,40,40,0,0,4
2026,l1603,20151013,8475,8475,0,0,0,8475,8475,0,0,0,0,4
2027,l1603,20151014,8475,8475,0,0,0,8455,8455,-20,-20,0,0,4
2028,l1603,20151015,8455,8455,0,0,0,8400,8400,-55,-55,0,0,4
2029,l1603,20151016,8400,8400,0,0,0,8370,8370,-30,-30,0,0,4
2030,l1603,20151019,8370,8370,0,0,0,8310,8310,-60,-60,0,0,4
2031,l1603,20151020,8310,8310,0,0,0,8310,8310,0,0,0,0,4
2032,l1603,20151021,8310,8310,0,0,0,8300,8300,-10,-10,0,0,4
2033,l1603,20151022,8300,8300,0,0,0,8410,8410,110,110,0,0,4
2034,l1603,20151023,8410,8410,0,0,0,8345,8345,-65,-65,0,0,4
2035,l1603,20151026,8345,8345,0,0,0,8245,8245,-100,-100,0,0,4
2036,l1603,20151027,8245,8245,0,0,0,8315,8315,70,70,0,0,4
2037,l1603,20151028,8315,8315,0,0,0,8330,8330,15,15,0,0,4
2038,l1603,20151029,8330,8330,0,0,0,8350,8350,20,20,0,0,4
2039,l1603,20151030,8350,8350,0,0,0,8210,8210,-140,-140,0,0,4
2040,l1603,20151102,8210,8210,0,0,0,8250,8250,40,40,0,0,4
2041,l1603,20151103,8250,8250,0,0,0,8225,8225,-25,-25,0,0,4
2042,l1603,20151104,8225,8225,0,0,0,8265,8265,40,40,0,0,4
2043,l1603,20151105,8265,8265,0,0,0,8025,8025,-240,-240,0,0,4
2044,l1603,20151106,8025,8025,0,0,0,7965,7965,-60,-60,0,0,4
2045,l1603,20151109,7965,7965,0,0,0,7970,7970,5,5,0,0,4
2046,l1603,20151110,7970,7970,0,0,0,7895,7895,-75,-75,0,0,4
2047,l1603,20151111,7895,7895,0,0,0,8000,8000,105,105,0,0,4
2048,l1603,20151112,8000,8000,0,0,0,8025,8025,25,25,0,0,4
2049,l1603,20151113,8025,8025,0,0,0,7885,7885,-140,-140,0,0,4
2050,l1603,20151116,7885,7885,0,0,0,7780,7780,-105,-105,0,0,4
2051,l1603,20151117,7780,7780,0,0,0,7780,7780,0,0,0,0,4
2052,l1603,20151118,7780,7780,0,0,0,7720,7720,-60,-60,0,0,4
2053,l1603,20151119,7720,7720,7595,7595,7595,7595,7595,-125,-125,2,75950,4
2054,l1603,20151120,7595,7595,0,0,0,7815,7815,220,220,0,0,4
2055,l1603,20151123,7815,7815,7505,7505,7505,7505,7505,-310,-310,4,150100,8
2056,l1603,20151124,7505,7505,0,0,0,7685,7685,180,180,0,0,8
2057,l1603,20151125,7685,7685,7985,7985,7815,7815,7900,130,215,8,316050,10
2058,l1603,20151126,7815,7900,0,0,0,8040,8040,140,140,0,0,10
2059,l1603,20151127,8040,8040,0,0,0,8010,8010,-30,-30,0,0,10
2060,l1603,20151130,8010,8010,7965,7965,7965,7965,7965,-45,-45,2,79650,12
2061,l1603,20151201,7965,7965,0,0,0,8035,8035,70,70,0,0,12
2062,l1603,20151202,8035,8035,0,0,0,8065,8065,30,30,0,0,12
2063,l1603,20151203,8065,8065,0,0,0,7925,7925,-140,-140,0,0,12
2064,l1603,20151204,7925,7925,0,0,0,8020,8020,95,95,0,0,12
2065,l1603,20151207,8020,8020,0,0,0,7950,7950,-70,-70,0,0,12
2066,l1603,20151208,7950,7950,0,0,0,7680,7680,-270,-270,0,0,12
2067,l1603,20151209,7680,7680,8000,8000,8000,8000,8000,320,320,2,80000,12
2068,l1603,20151210,8000,8000,7655,7880,7655,7855,7730,-145,-270,54,2087850,16
2069,l1603,20151211,7855,7730,7800,7980,7800,7980,7890,250,160,4,157800,14
2070,l1603,20151214,7980,7890,8055,8055,8045,8045,8050,155,160,8,322000,10
2071,l1603,20151215,8045,8050,8055,8055,7810,8020,7905,-30,-145,18,711650,8
2072,l1603,20151216,8020,7905,0,0,0,7935,7935,30,30,0,0,8
2073,l1603,20151217,7935,7935,0,0,0,8155,8155,220,220,0,0,8
2074,l1603,20151218,8155,8155,0,0,0,8225,8225,70,70,0,0,8
2075,l1603,20151221,8225,8225,0,0,0,8330,8330,105,105,0,0,8
2076,l1603,20151222,8330,8330,8275,8275,8275,8275,8275,-55,-55,2,82750,6
2077,l1603,20151223,8275,8275,8280,8280,8280,8280,8280,5,5,2,82800,4
2078,l1603,20151224,8280,8280,0,0,0,8345,8345,65,65,0,0,4
2079,l1603,20151225,8345,8345,0,0,0,8355,8355,10,10,0,0,4
2080,l1603,20151228,8355,8355,0,0,0,8390,8390,35,35,0,0,4
2081,l1603,20151229,8390,8390,0,0,0,8410,8410,20,20,0,0,4
2082,l1603,20151230,8410,8410,0,0,0,8435,8435,25,25,0,0,4
2083,l1603,20151231,8435,8435,0,0,0,8530,8530,95,95,0,0,4
2084,l1604,20150416,9065,9065,0,0,0,9065,9065,0,0,0,0,0
2085,l1604,20150417,9065,9065,0,0,0,9130,9130,65,65,0,0,0
2086,l1604,20150420,9130,9130,0,0,0,9210,9210,80,80,0,0,0
2087,l1604,20150421,9210,9210,9750,9750,9750,9750,9750,540,540,2,97500,2
2088,l1604,20150422,9750,9750,0,0,0,9750,9750,0,0,0,0,2
2089,l1604,20150423,9750,9750,9550,9550,9550,9550,9550,-200,-200,2,95500,4
2090,l1604,20150424,9550,9550,0,0,0,9555,9555,5,5,0,0,4
2091,l1604,20150427,9555,9555,0,0,0,9730,9730,175,175,0,0,4
2092,l1604,20150428,9730,9730,0,0,0,9730,9730,0,0,0,0,4
2093,l1604,20150429,9730,9730,9745,9745,9745,9745,9745,15,15,2,97450,4
2094,l1604,20150430,9745,9745,0,0,0,9745,9745,0,0,0,0,4
2095,l1604,20150504,9745,9745,0,0,0,9745,9745,0,0,0,0,4
2096,l1604,20150505,9745,9745,0,0,0,9745,9745,0,0,0,0,4
2097,l1604,20150506,9745,9745,0,0,0,9745,9745,0,0,0,0,4
2098,l1604,20150507,9745,9745,9555,9555,9555,9555,9555,-190,-190,2,95550,2
2099,l1604,20150508,9555,9555,0,0,0,9415,9415,-140,-140,0,0,2
2100,l1604,20150511,9415,9415,0,0,0,9380,9380,-35,-35,0,0,2
2101,l1604,20150512,9380,9380,0,0,0,9325,9325,-55,-55,0,0,2
2102,l1604,20150513,9325,9325,0,0,0,9400,9400,75,75,0,0,2
2103,l1604,20150514,9400,9400,0,0,0,9325,9325,-75,-75,0,0,2
2104,l1604,20150515,9325,9325,0,0,0,9365,9365,40,40,0,0,2
2105,l1604,20150518,9365,9365,0,0,0,9240,9240,-125,-125,0,0,2
2106,l1604,20150519,9240,9240,0,0,0,9130,9130,-110,-110,0,0,2
2107,l1604,20150520,9130,9130,8785,8785,8785,8785,8785,-345,-345,2,87850,0
2108,l1604,20150521,8785,8785,0,0,0,8930,8930,145,145,0,0,0
2109,l1604,20150522,8930,8930,0,0,0,8980,8980,50,50,0,0,0
2110,l1604,20150525,8980,8980,0,0,0,8985,8985,5,5,0,0,0
2111,l1604,20150526,8985,8985,0,0,0,8965,8965,-20,-20,0,0,0
2112,l1604,20150527,8965,8965,0,0,0,8835,8835,-130,-130,0,0,0
2113,l1604,20150528,8835,8835,0,0,0,8780,8780,-55,-55,0,0,0
2114,l1604,20150529,8780,8780,0,0,0,8800,8800,20,20,0,0,0
2115,l1604,20150601,8800,8800,0,0,0,8825,8825,25,25,0,0,0
2116,l1604,20150602,8825,8825,0,0,0,8795,8795,-30,-30,0,0,0
2117,l1604,20150603,8795,8795,0,0,0,8875,8875,80,80,0,0,0
2118,l1604,20150604,8875,8875,0,0,0,8860,8860,-15,-15,0,0,0
2119,l1604,20150605,8860,8860,0,0,0,8680,8680,-180,-180,0,0,0
2120,l1604,20150608,8680,8680,0,0,0,8645,8645,-35,-35,0,0,0
2121,l1604,20150609,8645,8645,0,0,0,8600,8600,-45,-45,0,0,0
2122,l1604,20150610,8600,8600,0,0,0,8795,8795,195,195,0,0,0
2123,l1604,20150611,8795,8795,0,0,0,8930,8930,135,135,0,0,0
2124,l1604,20150612,8930,8930,0,0,0,8860,8860,-70,-70,0,0,0
2125,l1604,20150615,8860,8860,0,0,0,8870,8870,10,10,0,0,0
2126,l1604,20150616,8870,8870,0,0,0,8990,8990,120,120,0,0,0
2127,l1604,20150617,8990,8990,0,0,0,8825,8825,-165,-165,0,0,0
2128,l1604,20150618,8825,8825,0,0,0,8735,8735,-90,-90,0,0,0
2129,l1604,20150619,8735,8735,0,0,0,8815,8815,80,80,0,0,0
2130,l1604,20150623,8815,8815,0,0,0,8755,8755,-60,-60,0,0,0
2131,l1604,20150624,8755,8755,0,0,0,8860,8860,105,105,0,0,0
2132,l1604,20150625,8860,8860,0,0,0,8860,8860,0,0,0,0,0
2133,l1604,20150626,8860,8860,0,0,0,8970,8970,110,110,0,0,0
2134,l1604,20150629,8970,8970,0,0,0,8885,8885,-85,-85,0,0,0
2135,l1604,20150630,8885,8885,0,0,0,8920,8920,35,35,0,0,0
2136,l1604,20150701,8920,8920,0,0,0,9030,9030,110,110,0,0,0
2137,l1604,20150702,9030,9030,0,0,0,8975,8975,-55,-55,0,0,0
2138,l1604,20150703,8975,8975,0,0,0,8990,8990,15,15,0,0,0
2139,l1604,20150706,8990,8990,0,0,0,8800,8800,-190,-190,0,0,0
2140,l1604,20150707,8800,8800,0,0,0,8595,8595,-205,-205,0,0,0
2141,l1604,20150708,8595,8595,0,0,0,8255,8255,-340,-340,0,0,0
2142,l1604,20150709,8255,8255,0,0,0,8585,8585,330,330,0,0,0
2143,l1604,20150710,8585,8585,0,0,0,8740,8740,155,155,0,0,0
2144,l1604,20150713,8740,8740,0,0,0,8510,8510,-230,-230,0,0,0
2145,l1604,20150714,8510,8510,0,0,0,8570,8570,60,60,0,0,0
2146,l1604,20150715,8570,8570,0,0,0,8570,8570,0,0,0,0,0
2147,l1604,20150716,8570,8570,0,0,0,8325,8325,-245,-245,0,0,0
2148,l1604,20150717,8325,8325,0,0,0,8305,8305,-20,-20,0,0,0
2149,l1604,20150720,8305,8305,0,0,0,8305,8305,0,0,0,0,0
2150,l1604,20150721,8305,8305,0,0,0,8285,8285,-20,-20,0,0,0
2151,l1604,20150722,8285,8285,0,0,0,8615,8615,330,330,0,0,0
2152,l1604,20150723,8615,8615,0,0,0,8670,8670,55,55,0,0,0
2153,l1604,20150724,8670,8670,0,0,0,8505,8505,-165,-165,0,0,0
2154,l1604,20150727,8505,8505,0,0,0,8230,8230,-275,-275,0,0,0
2155,l1604,20150728,8230,8230,8215,8485,8215,8485,8350,255,120,4,167000,0
2156,l1604,20150729,8485,8350,0,0,0,8530,8530,180,180,0,0,0
2157,l1604,20150730,8530,8530,0,0,0,8520,8520,-10,-10,0,0,0
2158,l1604,20150731,8520,8520,0,0,0,8385,8385,-135,-135,0,0,0
2159,l1604,20150803,8385,8385,8050,8050,8050,8050,8050,-335,-335,6,241500,6
2160,l1604,20150804,8050,8050,0,0,0,8050,8050,0,0,0,0,6
2161,l1604,20150805,8050,8050,0,0,0,8190,8190,140,140,0,0,6
2162,l1604,20150806,8190,8190,0,0,0,8170,8170,-20,-20,0,0,6
2163,l1604,20150807,8170,8170,8180,8350,8180,8350,8265,180,95,4,165300,6
2164,l1604,20150810,8350,8265,0,0,0,8305,8305,40,40,0,0,6
2165,l1604,20150811,8305,8305,8445,8630,8445,8630,8490,325,185,8,339700,4
2166,l1604,20150812,8630,8490,0,0,0,8530,8530,40,40,0,0,4
2167,l1604,20150813,8530,8530,0,0,0,8540,8540,10,10,0,0,4
2168,l1604,20150814,8540,8540,8575,8575,8575,8575,8575,35,35,2,85750,2
2169,l1604,20150817,8575,8575,0,0,0,8465,8465,-110,-110,0,0,2
2170,l1604,20150818,8465,8465,0,0,0,8480,8480,15,15,0,0,2
2171,l1604,20150819,8480,8480,0,0,0,8520,8520,40,40,0,0,2
2172,l1604,20150820,8520,8520,0,0,0,8340,8340,-180,-180,0,0,2
2173,l1604,20150821,8340,8340,8375,8375,8375,8375,8375,35,35,2,83750,2
2174,l1604,20150824,8375,8375,0,0,0,8105,8105,-270,-270,0,0,2
2175,l1604,20150825,8105,8105,0,0,0,8105,8105,0,0,0,0,2
2176,l1604,20150826,8105,8105,0,0,0,8085,8085,-20,-20,0,0,2
2177,l1604,20150827,8085,8085,0,0,0,8115,8115,30,30,0,0,2
2178,l1604,20150828,8115,8115,8430,8430,8430,8430,8430,315,315,2,84300,2
2179,l1604,20150831,8430,8430,0,0,0,8330,8330,-100,-100,0,0,2
2180,l1604,20150901,8330,8330,0,0,0,8485,8485,155,155,0,0,2
2181,l1604,20150902,8485,8485,0,0,0,8355,8355,-130,-130,0,0,2
2182,l1604,20150907,8355,8355,0,0,0,8415,8415,60,60,0,0,2
2183,l1604,20150908,8415,8415,0,0,0,8240,8240,-175,-175,0,0,2
2184,l1604,20150909,8240,8240,0,0,0,8400,8400,160,160,0,0,2
2185,l1604,20150910,8400,8400,0,0,0,8405,8405,5,5,0,0,2
2186,l1604,20150911,8405,8405,0,0,0,8470,8470,65,65,0,0,2
2187,l1604,20150914,8470,8470,0,0,0,8395,8395,-75,-75,0,0,2
2188,l1604,20150915,8395,8395,8270,8430,8170,8225,8245,-170,-150,30,1237050,4
2189,l1604,20150916,8225,8245,8335,8335,8255,8255,8295,10,50,4,165900,2
2190,l1604,20150917,8255,8295,0,0,0,8345,8345,50,50,0,0,2
2191,l1604,20150918,8345,8345,0,0,0,8345,8345,0,0,0,0,2
2192,l1604,20150921,8345,8345,0,0,0,8295,8295,-50,-50,0,0,2
2193,l1604,20150922,8295,8295,0,0,0,8275,8275,-20,-20,0,0,2
2194,l1604,20150923,8275,8275,0,0,0,8215,8215,-60,-60,0,0,2
2195,l1604,20150924,8215,8215,0,0,0,8205,8205,-10,-10,0,0,2
2196,l1604,20150925,8205,8205,0,0,0,8200,8200,-5,-5,0,0,2
2197,l1604,20150928,8200,8200,0,0,0,8215,8215,15,15,0,0,2
2198,l1604,20150929,8215,8215,0,0,0,8090,8090,-125,-125,0,0,2
2199,l1604,20150930,8090,8090,0,0,0,8165,8165,75,75,0,0,2
2200,l1604,20151008,8165,8165,0,0,0,8330,8330,165,165,0,0,2
2201,l1604,20151009,8330,8330,0,0,0,8355,8355,25,25,0,0,2
2202,l1604,20151012,8355,8355,0,0,0,8355,8355,0,0,0,0,2
2203,l1604,20151013,8355,8355,0,0,0,8355,8355,0,0,0,0,2
2204,l1604,20151014,8355,8355,0,0,0,8335,8335,-20,-20,0,0,2
2205,l1604,20151015,8335,8335,0,0,0,8280,8280,-55,-55,0,0,2
2206,l1604,20151016,8280,8280,0,0,0,8250,8250,-30,-30,0,0,2
2207,l1604,20151019,8250,8250,0,0,0,8190,8190,-60,-60,0,0,2
2208,l1604,20151020,8190,8190,0,0,0,8190,8190,0,0,0,0,2
2209,l1604,20151021,8190,8190,8085,8085,8085,8085,8085,-105,-105,2,80850,2
2210,l1604,20151022,8085,8085,0,0,0,8195,8195,110,110,0,0,2
2211,l1604,20151023,8195,8195,0,0,0,8130,8130,-65,-65,0,0,2
2212,l1604,20151026,8130,8130,0,0,0,8030,8030,-100,-100,0,0,2
2213,l1604,20151027,8030,8030,0,0,0,8095,8095,65,65,0,0,2
2214,l1604,20151028,8095,8095,0,0,0,8105,8105,10,10,0,0,2
2215,l1604,20151029,8105,8105,0,0,0,8120,8120,15,15,0,0,2
2216,l1604,20151030,8120,8120,0,0,0,7985,7985,-135,-135,0,0,2
2217,l1604,20151102,7985,7985,0,0,0,8025,8025,40,40,0,0,2
2218,l1604,20151103,8025,8025,0,0,0,8000,8000,-25,-25,0,0,2
2219,l1604,20151104,8000,8000,0,0,0,8040,8040,40,40,0,0,2
2220,l1604,20151105,8040,8040,0,0,0,7810,7810,-230,-230,0,0,2
2221,l1604,20151106,7810,7810,0,0,0,7750,7750,-60,-60,0,0,2
2222,l1604,20151109,7750,7750,0,0,0,7755,7755,5,5,0,0,2
2223,l1604,20151110,7755,7755,7580,7580,7580,7580,7580,-175,-175,4,151600,4
2224,l1604,20151111,7580,7580,7580,7580,7580,7580,7580,0,0,2,75800,6
2225,l1604,20151112,7580,7580,0,0,0,7605,7605,25,25,0,0,6
2226,l1604,20151113,7605,7605,7550,7550,7530,7530,7540,-75,-65,4,150800,10
2227,l1604,20151116,7530,7540,0,0,0,7440,7440,-100,-100,0,0,10
2228,l1604,20151117,7440,7440,0,0,0,7440,7440,0,0,0,0,10
2229,l1604,20151118,7440,7440,0,0,0,7380,7380,-60,-60,0,0,10
2230,l1604,20151119,7380,7380,7460,7460,7460,7460,7460,80,80,4,149200,14
2231,l1604,20151120,7460,7460,0,0,0,7675,7675,215,215,0,0,14
2232,l1604,20151123,7675,7675,0,0,0,7370,7370,-305,-305,0,0,14
2233,l1604,20151124,7370,7370,0,0,0,7545,7545,175,175,0,0,14
2234,l1604,20151125,7545,7545,7480,7480,7480,7480,7480,-65,-65,2,74800,16
2235,l1604,20151126,7480,7480,0,0,0,7615,7615,135,135,0,0,16
2236,l1604,20151127,7615,7615,0,0,0,7585,7585,-30,-30,0,0,16
2237,l1604,20151130,7585,7585,7480,7645,7480,7645,7560,60,-25,4,151250,16
2238,l1604,20151201,7645,7560,0,0,0,7625,7625,65,65,0,0,16
2239,l1604,20151202,7625,7625,0,0,0,7655,7655,30,30,0,0,16
2240,l1604,20151203,7655,7655,0,0,0,7525,7525,-130,-130,0,0,16
2241,l1604,20151204,7525,7525,0,0,0,7615,7615,90,90,0,0,16
2242,l1604,20151207,7615,7615,7570,7720,7570,7720,7645,105,30,4,152900,16
2243,l1604,20151208,7720,7645,7500,7500,7425,7425,7460,-220,-185,8,298500,20
2244,l1604,20151209,7425,7460,0,0,0,7770,7770,310,310,0,0,20
2245,l1604,20151210,7770,7770,0,0,0,7510,7510,-260,-260,0,0,20
2246,l1604,20151211,7510,7510,7595,7870,7595,7870,7730,360,220,4,154650,20
2247,l1604,20151214,7870,7730,7515,7720,7515,7720,7580,-10,-150,16,606700,20
2248,l1604,20151215,7720,7580,0,0,0,7445,7445,-135,-135,0,0,20
2249,l1604,20151216,7445,7445,0,0,0,7475,7475,30,30,0,0,20
2250,l1604,20151217,7475,7475,7660,7660,7660,7660,7660,185,185,2,76600,20
2251,l1604,20151218,7660,7660,7800,8035,7725,7725,7860,65,200,10,393200,22
2252,l1604,20151221,7725,7860,7975,8085,7750,7815,7870,-45,10,114,4486850,24
2253,l1604,20151222,7815,7870,0,0,0,7820,7820,-50,-50,0,0,24
2254,l1604,20151223,7820,7820,8040,8040,8040,8040,8040,220,220,2,80400,22
2255,l1604,20151224,8040,8040,0,0,0,8105,8105,65,65,0,0,22
2256,l1604,20151225,8105,8105,0,0,0,8115,8115,10,10,0,0,22
2257,l1604,20151228,8115,8115,7970,7970,7945,7945,7950,-170,-165,10,397500,32
2258,l1604,20151229,7945,7950,0,0,0,7970,7970,20,20,0,0,32
2259,l1604,20151230,7970,7970,7970,8130,7970,7995,8010,25,40,24,961600,32
2260,l1604,20151231,7995,8010,0,0,0,8100,8100,90,90,0,0,32
2261,l1605,20150518,9280,9280,9100,9100,8885,8890,8960,-390,-320,1680,75266350,1478
2262,l1605,20150519,8890,8960,8870,8870,8760,8760,8820,-200,-140,1264,55755750,2412
2263,l1605,20150520,8760,8820,8605,8815,8605,8815,8705,-5,-115,1192,51902400,2692
2264,l1605,20150521,8815,8705,8820,8930,8730,8830,8835,125,130,1846,81569850,2918
2265,l1605,20150522,8830,8835,8850,8955,8820,8955,8890,120,55,1474,65554250,2738
2266,l1605,20150525,8955,8890,8910,8940,8865,8900,8900,10,10,968,43080750,2844
2267,l1605,20150526,8900,8900,8930,9020,8730,8760,8885,-140,-15,2644,117475950,3752
2268,l1605,20150527,8760,8885,8710,8800,8710,8780,8750,-105,-135,1802,78865900,5046
2269,l1605,20150528,8780,8750,8780,8790,8665,8730,8715,-20,-35,1302,56745300,5736
2270,l1605,20150529,8730,8715,8770,8785,8730,8760,8755,45,40,860,37657350,5790
2271,l1605,20150601,8760,8755,8830,8860,8710,8770,8775,15,20,1552,68126550,5620
2272,l1605,20150602,8770,8775,8770,8810,8685,8805,8735,30,-40,1282,56014900,5634
2273,l1605,20150603,8805,8735,8850,8860,8770,8820,8825,85,90,1070,47221950,5844
2274,l1605,20150604,8820,8825,8825,8895,8735,8850,8800,25,-25,1244,54747300,5952
2275,l1605,20150605,8850,8800,8800,8880,8790,8835,8830,35,30,2050,90550350,6138
2276,l1605,20150608,8835,8830,8835,8890,8745,8770,8780,-60,-50,1662,72999750,6972
2277,l1605,20150609,8770,8780,8760,8790,8730,8760,8765,-20,-15,1472,64516600,7266
2278,l1605,20150610,8760,8765,8850,9020,8820,9020,8925,255,160,2842,126824800,6866
2279,l1605,20150611,9020,8925,9020,9155,8965,9070,9065,145,140,3554,161166150,7490
2280,l1605,20150612,9070,9065,9030,9065,8955,8975,9005,-90,-60,2014,90694150,8000
2281,l1605,20150615,8975,9005,8900,9120,8900,9120,9010,115,5,1702,76717300,7250
2282,l1605,20150616,9120,9010,9130,9230,9030,9105,9125,95,115,2870,130966550,7402
2283,l1605,20150617,9105,9125,9060,9105,8910,8910,8985,-215,-140,2306,103629000,8992
2284,l1605,20150618,8910,8985,8920,8935,8845,8900,8895,-85,-90,1906,84805600,9712
2285,l1605,20150619,8900,8895,8915,9045,8905,8945,8975,50,80,1358,60962950,9598
2286,l1605,20150623,8945,8975,8945,8990,8845,8940,8910,-35,-65,1964,87512100,9884
2287,l1605,20150624,8940,8910,8985,9070,8960,9055,9020,145,110,3004,135483350,9314
2288,l1605,20150625,9055,9020,9025,9050,8995,9030,9015,10,-5,1568,70686450,9466
2289,l1605,20150626,9030,9015,9025,9150,9025,9130,9110,115,95,3060,139414600,8300
2290,l1605,20150629,9130,9110,9120,9150,8880,9065,9010,-45,-100,5466,246258250,8766
2291,l1605,20150630,9065,9010,9005,9110,8960,9075,9025,65,15,2310,104254900,8540
2292,l1605,20150701,9075,9025,9110,9220,9075,9120,9140,95,115,3674,167968750,8178
2293,l1605,20150702,9120,9140,9045,9120,9030,9115,9070,-25,-70,2086,94644650,8662
2294,l1605,20150703,9115,9070,9120,9140,9030,9100,9095,30,25,2762,125627800,8594
2295,l1605,20150706,9100,9095,9060,9060,8820,8890,8935,-205,-160,3878,173296050,10066
2296,l1605,20150707,8890,8935,8830,8960,8585,8585,8725,-350,-210,6558,286157700,13132
2297,l1605,20150708,8585,8725,8400,8480,8380,8380,8380,-345,-345,5726,239982200,15634
2298,l1605,20150709,8380,8380,8480,8875,8450,8800,8670,420,290,7042,305357350,14404
2299,l1605,20150710,8800,8670,8825,8990,8755,8790,8815,120,145,4330,190926350,14150
2300,l1605,20150713,8790,8815,8780,8780,8620,8695,8675,-120,-140,4102,177968400,14596
2301,l1605,20150714,8695,8675,8690,8800,8650,8660,8735,-15,60,3448,150629350,14868
2302,l1605,20150715,8660,8735,8710,8800,8680,8715,8735,-20,0,1976,86342050,14794
2303,l1605,20150716,8715,8735,8660,8665,8535,8560,8575,-175,-160,3984,170854150,16550
2304,l1605,20150717,8560,8575,8560,8590,8500,8555,8550,-20,-25,3016,128973400,17262
2305,l1605,20150720,8555,8550,8550,8600,8505,8585,8550,35,0,4566,195196600,17964
2306,l1605,20150721,8585,8550,8555,8580,8500,8575,8530,25,-20,5480,233745100,19570
2307,l1605,20150722,8575,8530,8580,8685,8530,8670,8600,140,70,4930,212019200,17070
2308,l1605,20150723,8670,8600,8605,8680,8595,8640,8640,40,40,3912,169015150,17052
2309,l1605,20150724,8640,8640,8595,8595,8395,8400,8465,-240,-175,8908,377226550,21836
2310,l1605,20150727,8400,8465,8385,8395,8130,8150,8210,-315,-255,12710,521797100,25212
2311,l1605,20150728,8150,8210,8100,8265,8045,8235,8195,25,-15,15512,635654150,26376
2312,l1605,20150729,8235,8195,8270,8425,8260,8310,8340,115,145,11556,481890450,26938
2313,l1605,20150730,8310,8340,8340,8400,8200,8200,8310,-140,-30,6608,274646050,29332
2314,l1605,20150731,8200,8310,8190,8205,8135,8180,8165,-130,-145,6416,262052500,31918
2315,l1605,20150803,8180,8165,8125,8135,7860,7935,7975,-230,-190,16728,667215900,40856
2316,l1605,20150804,7935,7975,7900,8100,7825,8095,7965,120,-10,13768,548342950,40480
2317,l1605,20150805,8095,7965,8100,8195,8045,8190,8120,225,155,9294,377386200,39398
2318,l1605,20150806,8190,8120,8130,8150,8025,8090,8080,-30,-40,7812,315757000,40062
2319,l1605,20150807,8090,8080,8055,8180,7980,8165,8070,85,-10,11278,455235050,39682
2320,l1605,20150810,8165,8070,8100,8245,8080,8245,8165,175,95,11144,455049100,40334
2321,l1605,20150811,8245,8165,8300,8490,8300,8475,8440,310,275,31836,1344009150,43132
2322,l1605,20150812,8475,8440,8410,8510,8370,8500,8445,60,5,14846,626919850,42076
2323,l1605,20150813,8500,8445,8515,8550,8400,8515,8465,70,20,7640,323495150,42608
2324,l1605,20150814,8515,8465,8465,8530,8430,8500,8500,35,35,10306,438005000,40702
2325,l1605,20150817,8500,8500,8480,8495,8290,8320,8365,-180,-135,11470,479856550,42490
2326,l1605,20150818,8320,8365,8320,8325,8130,8180,8195,-185,-170,18990,778413900,45750
2327,l1605,20150819,8180,8195,8215,8260,8160,8195,8210,0,15,14166,581685850,47330
2328,l1605,20150820,8195,8210,8120,8120,8025,8100,8060,-110,-150,19190,773505100,49416
2329,l1605,20150821,8100,8060,8120,8175,8075,8125,8120,65,60,17358,705141450,53424
2330,l1605,20150824,8125,8120,8050,8050,7825,7835,7875,-285,-245,32558,1282654650,62232
2331,l1605,20150825,7835,7875,7775,7975,7730,7895,7865,20,-10,35334,1389714550,58124
2332,l1605,20150826,7895,7865,8035,8035,7860,7895,7910,30,45,37954,1501098350,60650
2333,l1605,20150827,7895,7910,7910,8140,7910,8130,8050,220,140,43990,1771055100,60872
2334,l1605,20150828,8130,8050,8370,8370,8255,8280,8315,230,265,49564,2060659250,60412
2335,l1605,20150831,8280,8315,8320,8320,8170,8190,8215,-125,-100,39042,1604441000,67858
2336,l1605,20150901,8190,8215,8260,8365,8250,8260,8310,45,95,38318,1592119900,69960
2337,l1605,20150902,8260,8310,8110,8235,8110,8230,8175,-80,-135,21212,867176250,67542
2338,l1605,20150907,8230,8175,8200,8300,8155,8155,8225,-20,50,33854,1392515250,65102
2339,l1605,20150908,8155,8225,8140,8170,8035,8100,8085,-125,-140,38378,1551731400,73476
2340,l1605,20150909,8100,8085,8225,8290,8190,8215,8235,130,150,55774,2297278500,68960
2341,l1605,20150910,8215,8235,8140,8305,8085,8290,8160,55,-75,58372,2381894800,71216
2342,l1605,20150911,8290,8160,8310,8390,8250,8260,8320,100,160,57434,2389680250,66470
2343,l1605,20150914,8260,8320,8250,8340,8165,8180,8250,-140,-70,44596,1840584350,72008
2344,l1605,20150915,8180,8250,8180,8200,8095,8155,8140,-95,-110,49190,2002239500,79996
2345,l1605,20150916,8155,8140,8220,8225,8100,8180,8155,40,15,49614,2023124250,80390
2346,l1605,20150917,8180,8155,8270,8280,8120,8125,8205,-30,50,56196,2305701050,83450
2347,l1605,20150918,8125,8205,8140,8180,8045,8060,8120,-145,-85,58280,2366904850,95156
2348,l1605,20150921,8060,8120,8040,8145,7975,8135,8060,15,-60,37362,1506550500,95680
2349,l1605,20150922,8135,8060,8140,8140,8050,8090,8085,30,25,29944,1210787850,98970
2350,l1605,20150923,8090,8085,8075,8165,8070,8160,8120,75,35,43918,1783562050,98032
2351,l1605,20150924,8160,8120,8115,8140,8080,8120,8110,0,-10,28542,1157515750,100770
2352,l1605,20150925,8120,8110,8170,8170,8035,8040,8100,-70,-10,41368,1676208650,111856
2353,l1605,20150928,8040,8100,8060,8060,7940,7940,7990,-160,-110,34738,1388501200,120210
2354,l1605,20150929,7940,7990,7920,7930,7815,7910,7860,-80,-130,37724,1483465550,117138
2355,l1605,20150930,7910,7860,7895,7975,7880,7960,7920,100,60,30356,1202851000,115620
2356,l1605,20151008,7960,7920,8290,8290,8045,8090,8095,170,175,34220,1385804750,117078
2357,l1605,20151009,8090,8095,8150,8360,8130,8320,8260,225,165,79484,3282792450,101628
2358,l1605,20151012,8320,8260,8270,8330,8270,8290,8295,30,35,36080,1496914500,101574
2359,l1605,20151013,8290,8295,8200,8255,8185,8245,8205,-50,-90,30008,1231730700,104500
2360,l1605,20151014,8245,8205,8210,8240,8105,8125,8180,-80,-25,41558,1700524100,111282
2361,l1605,20151015,8125,8180,8110,8160,8095,8110,8120,-70,-60,33104,1344792950,113844
2362,l1605,20151016,8110,8120,8135,8150,8060,8090,8095,-30,-25,42180,1707585200,125490
2363,l1605,20151019,8090,8095,8090,8090,8020,8035,8040,-60,-55,40310,1621352350,137536
2364,l1605,20151020,8035,8040,8010,8095,7990,8080,8040,40,0,31894,1282253450,135062
2365,l1605,20151021,8080,8040,8050,8065,8010,8030,8030,-10,-10,43582,1749933150,145060
2366,l1605,20151022,8030,8030,8035,8200,8035,8120,8130,90,100,65252,2653558150,134118
2367,l1605,20151023,8120,8130,8100,8150,8020,8085,8085,-45,-45,53288,2155117550,140654
2368,l1605,20151026,8085,8085,8045,8060,7960,7960,8000,-125,-85,59180,2367258000,151784
2369,l1605,20151027,7960,8000,7940,8005,7910,7970,7955,-30,-45,57942,2304855750,148268
2370,l1605,20151028,7970,7955,7955,7985,7940,7970,7955,15,0,30670,1220167650,151802
2371,l1605,20151029,7970,7955,8075,8080,7960,7970,8010,15,55,37826,1515019950,153110
2372,l1605,20151030,7970,8010,7965,7970,7895,7945,7930,-65,-80,42002,1666275700,157572
2373,l1605,20151102,7945,7930,7920,7995,7915,7960,7960,30,30,39020,1553303400,152580
2374,l1605,20151103,7960,7960,7950,7970,7900,7910,7925,-50,-35,62596,2481787750,156624
2375,l1605,20151104,7910,7925,7970,8015,7925,7990,7970,65,45,61286,2442364250,156232
2376,l1605,20151105,7990,7970,7930,7945,7665,7675,7775,-295,-195,245206,9535553050,217584
2377,l1605,20151106,7675,7775,7665,7680,7570,7655,7625,-120,-150,193414,7376217600,228762
2378,l1605,20151109,7655,7625,7605,7660,7540,7565,7585,-60,-40,131902,5004918900,239128
2379,l1605,20151110,7565,7585,7540,7550,7430,7505,7485,-80,-100,167444,6267165950,244926
2380,l1605,20151111,7505,7485,7485,7500,7410,7430,7455,-55,-30,110190,4109623600,260886
2381,l1605,20151112,7430,7455,7385,7490,7365,7420,7430,-35,-25,157500,5851288800,264508
2382,l1605,20151113,7420,7430,7390,7455,7290,7330,7370,-100,-60,229696,8464598250,268362
2383,l1605,20151116,7330,7370,7300,7360,7275,7285,7315,-85,-55,156932,5741626050,294250
2384,l1605,20151117,7285,7315,7330,7430,7285,7390,7355,75,40,252344,9285191250,286430
2385,l1605,20151118,7390,7355,7390,7400,7240,7290,7305,-65,-50,221556,8096010600,289290
2386,l1605,20151119,7290,7305,7280,7335,7175,7175,7245,-130,-60,233944,8476527050,313826
2387,l1605,20151120,7175,7245,7210,7235,6960,6960,7010,-285,-235,501990,17602487800,351100
2388,l1605,20151123,6960,7010,6900,6950,6755,6920,6865,-90,-145,499906,17162114100,335614
2389,l1605,20151124,6920,6865,6980,7135,6920,7135,7045,270,180,399676,14084645000,315012
2390,l1605,20151125,7135,7045,7275,7390,7180,7265,7275,220,230,609034,22167183150,308224
2391,l1605,20151126,7265,7275,7275,7565,7245,7460,7425,185,150,794526,29511112900,300948
2392,l1605,20151127,7460,7425,7435,7530,7310,7375,7400,-50,-25,642276,23768335000,277080
2393,l1605,20151130,7375,7400,7350,7445,7235,7440,7330,40,-70,852068,31240726900,340684
2394,l1605,20151201,7440,7330,7445,7540,7395,7505,7470,175,140,782062,29222761750,340652
2395,l1605,20151202,7505,7470,7535,7595,7425,7445,7510,-25,40,638304,23978655150,351822
2396,l1605,20151203,7445,7510,7390,7440,7265,7440,7345,-70,-165,804346,29542151450,376732
2397,l1605,20151204,7440,7345,7490,7505,7400,7405,7445,60,100,725298,27016328250,377824
2398,l1605,20151207,7405,7445,7325,7475,7290,7470,7405,25,-40,666402,24687155650,393996
2399,l1605,20151208,7470,7405,7350,7360,7080,7145,7185,-260,-220,1062600,38192793400,377280
2400,l1605,20151209,7145,7185,7210,7300,7180,7295,7240,110,55,623370,22575501750,362956
2401,l1605,20151210,7295,7240,7260,7435,7235,7420,7335,180,95,943958,34638968600,403226
2402,l1605,20151211,7420,7335,7395,7475,7320,7470,7385,135,50,754894,27880425700,412904
2403,l1605,20151214,7470,7385,7390,7530,7345,7525,7440,140,55,819318,30496956500,436672
2404,l1605,20151215,7525,7440,7555,7580,7415,7455,7495,15,55,734604,27541510950,417090
2405,l1605,20151216,7455,7495,7465,7520,7395,7505,7460,10,-35,658964,24582745450,447172
2406,l1605,20151217,7505,7460,7475,7615,7445,7465,7525,5,65,908036,34172216550,455188
2407,l1605,20151218,7465,7525,7430,7650,7415,7650,7540,125,15,967714,36502749650,524322
2408,l1605,20151221,7650,7540,7640,7720,7580,7710,7635,170,95,870848,33261293200,484704
2409,l1605,20151222,7710,7635,7710,7825,7680,7820,7745,185,110,885864,34311936200,508286
2410,l1605,20151223,7820,7745,7805,7870,7705,7865,7785,120,40,979014,38123859950,546152
2411,l1605,20151224,7865,7785,7885,7915,7815,7845,7865,60,80,1113814,43816052850,532518
2412,l1605,20151225,7845,7865,7860,7895,7780,7885,7840,20,-25,738778,28976005750,530546
2413,l1605,20151228,7885,7840,7865,7885,7775,7790,7820,-50,-20,855016,33446312250,523832
2414,l1605,20151229,7790,7820,7760,7920,7730,7885,7805,65,-15,882248,34434813750,532868
2415,l1605,20151230,7885,7805,7925,8025,7895,8000,7960,195,155,1087368,43286879850,552014
2416,l1605,20151231,8000,7960,7980,8130,7965,8040,8040,80,80,1189100,47824215050,528958
2417,l1606,20150615,9065,9065,0,0,0,9070,9070,5,5,0,0,0
2418,l1606,20150616,9070,9070,0,0,0,9185,9185,115,115,0,0,0
2419,l1606,20150617,9185,9185,0,0,0,9045,9045,-140,-140,0,0,0
2420,l1606,20150618,9045,9045,0,0,0,8955,8955,-90,-90,0,0,0
2421,l1606,20150619,8955,8955,0,0,0,9035,9035,80,80,0,0,0
2422,l1606,20150623,9035,9035,0,0,0,8970,8970,-65,-65,0,0,0
2423,l1606,20150624,8970,8970,0,0,0,9080,9080,110,110,0,0,0
2424,l1606,20150625,9080,9080,0,0,0,9075,9075,-5,-5,0,0,0
2425,l1606,20150626,9075,9075,0,0,0,9170,9170,95,95,0,0,0
2426,l1606,20150629,9170,9170,0,0,0,9070,9070,-100,-100,0,0,0
2427,l1606,20150630,9070,9070,0,0,0,9085,9085,15,15,0,0,0
2428,l1606,20150701,9085,9085,0,0,0,9200,9200,115,115,0,0,0
2429,l1606,20150702,9200,9200,9200,9300,9090,9090,9195,-110,-5,30,1379500,20
2430,l1606,20150703,9090,9195,0,0,0,9195,9195,0,0,0,0,20
2431,l1606,20150706,9195,9195,0,0,0,9035,9035,-160,-160,0,0,20
2432,l1606,20150707,9035,9035,0,0,0,8825,8825,-210,-210,0,0,20
2433,l1606,20150708,8825,8825,0,0,0,8475,8475,-350,-350,0,0,20
2434,l1606,20150709,8475,8475,8725,8725,8725,8725,8725,250,250,20,872500,0
2435,l1606,20150710,8725,8725,8945,8945,8945,8945,8945,220,220,2,89450,2
2436,l1606,20150713,8945,8945,0,0,0,8805,8805,-140,-140,0,0,2
2437,l1606,20150714,8805,8805,0,0,0,8865,8865,60,60,0,0,2
2438,l1606,20150715,8865,8865,0,0,0,8865,8865,0,0,0,0,2
2439,l1606,20150716,8865,8865,8675,8675,8675,8675,8675,-190,-190,16,694000,18
2440,l1606,20150717,8675,8675,0,0,0,8650,8650,-25,-25,0,0,18
2441,l1606,20150720,8650,8650,0,0,0,8650,8650,0,0,0,0,18
2442,l1606,20150721,8650,8650,0,0,0,8630,8630,-20,-20,0,0,18
2443,l1606,20150722,8630,8630,0,0,0,8700,8700,70,70,0,0,18
2444,l1606,20150723,8700,8700,8690,8690,8690,8690,8690,-10,-10,2,86900,20
2445,l1606,20150724,8690,8690,0,0,0,8515,8515,-175,-175,0,0,20
2446,l1606,20150727,8515,8515,8290,8290,8290,8290,8290,-225,-225,10,414500,30
2447,l1606,20150728,8290,8290,0,0,0,8275,8275,-15,-15,0,0,30
2448,l1606,20150729,8275,8275,0,0,0,8420,8420,145,145,0,0,30
2449,l1606,20150730,8420,8420,0,0,0,8390,8390,-30,-30,0,0,30
2450,l1606,20150731,8390,8390,0,0,0,8245,8245,-145,-145,0,0,30
2451,l1606,20150803,8245,8245,7935,7935,7930,7930,7930,-315,-315,22,872750,50
2452,l1606,20150804,7930,7930,8110,8110,7950,7950,8050,20,120,40,1610050,52
2453,l1606,20150805,7950,8050,0,0,0,8205,8205,155,155,0,0,52
2454,l1606,20150806,8205,8205,0,0,0,8165,8165,-40,-40,0,0,52
2455,l1606,20150807,8165,8165,0,0,0,8155,8155,-10,-10,0,0,52
2456,l1606,20150810,8155,8155,0,0,0,8250,8250,95,95,0,0,52
2457,l1606,20150811,8250,8250,8445,8445,8445,8445,8445,195,195,10,422250,42
2458,l1606,20150812,8445,8445,0,0,0,8445,8445,0,0,0,0,42
2459,l1606,20150813,8445,8445,0,0,0,8460,8460,15,15,0,0,42
2460,l1606,20150814,8460,8460,0,0,0,8490,8490,30,30,0,0,42
2461,l1606,20150817,8490,8490,0,0,0,8360,8360,-130,-130,0,0,42
2462,l1606,20150818,8360,8360,0,0,0,8195,8195,-165,-165,0,0,42
2463,l1606,20150819,8195,8195,0,0,0,8205,8205,10,10,0,0,42
2464,l1606,20150820,8205,8205,0,0,0,8060,8060,-145,-145,0,0,42
2465,l1606,20150821,8060,8060,0,0,0,8115,8115,55,55,0,0,42
2466,l1606,20150824,8115,8115,0,0,0,7875,7875,-240,-240,0,0,42
2467,l1606,20150825,7875,7875,0,0,0,7875,7875,0,0,0,0,42
2468,l1606,20150826,7875,7875,0,0,0,7920,7920,45,45,0,0,42
2469,l1606,20150827,7920,7920,8080,8095,7985,8010,8015,90,95,26,1042350,22
2470,l1606,20150828,8010,8015,0,0,0,8275,8275,260,260,0,0,22
2471,l1606,20150831,8275,8275,0,0,0,8180,8180,-95,-95,0,0,22
2472,l1606,20150901,8180,8180,0,0,0,8270,8270,90,90,0,0,22
2473,l1606,20150902,8270,8270,0,0,0,8140,8140,-130,-130,0,0,22
2474,l1606,20150907,8140,8140,0,0,0,8185,8185,45,45,0,0,22
2475,l1606,20150908,8185,8185,0,0,0,8050,8050,-135,-135,0,0,22
2476,l1606,20150909,8050,8050,0,0,0,8195,8195,145,145,0,0,22
2477,l1606,20150910,8195,8195,0,0,0,8125,8125,-70,-70,0,0,22
2478,l1606,20150911,8125,8125,8385,8400,8310,8400,8350,275,225,20,835450,26
2479,l1606,20150914,8400,8350,0,0,0,8280,8280,-70,-70,0,0,26
2480,l1606,20150915,8280,8280,0,0,0,8170,8170,-110,-110,0,0,26
2481,l1606,20150916,8170,8170,0,0,0,8185,8185,15,15,0,0,26
2482,l1606,20150917,8185,8185,0,0,0,8235,8235,50,50,0,0,26
2483,l1606,20150918,8235,8235,0,0,0,8150,8150,-85,-85,0,0,26
2484,l1606,20150921,8150,8150,8015,8015,8015,8015,8015,-135,-135,2,80150,24
2485,l1606,20150922,8015,8015,0,0,0,8035,8035,20,20,0,0,24
2486,l1606,20150923,8035,8035,0,0,0,8065,8065,30,30,0,0,24
2487,l1606,20150924,8065,8065,0,0,0,8060,8060,-5,-5,0,0,24
2488,l1606,20150925,8060,8060,0,0,0,8055,8055,-5,-5,0,0,24
2489,l1606,20150928,8055,8055,0,0,0,8055,8055,0,0,0,0,24
2490,l1606,20150929,8055,8055,0,0,0,7925,7925,-130,-130,0,0,24
2491,l1606,20150930,7925,7925,0,0,0,7985,7985,60,60,0,0,24
2492,l1606,20151008,7985,7985,0,0,0,8160,8160,175,175,0,0,24
2493,l1606,20151009,8160,8160,0,0,0,8325,8325,165,165,0,0,24
2494,l1606,20151012,8325,8325,0,0,0,8360,8360,35,35,0,0,24
2495,l1606,20151013,8360,8360,0,0,0,8345,8345,-15,-15,0,0,24
2496,l1606,20151014,8345,8345,0,0,0,8320,8320,-25,-25,0,0,24
2497,l1606,20151015,8320,8320,0,0,0,8260,8260,-60,-60,0,0,24
2498,l1606,20151016,8260,8260,0,0,0,8235,8235,-25,-25,0,0,24
2499,l1606,20151019,8235,8235,0,0,0,8180,8180,-55,-55,0,0,24
2500,l1606,20151020,8180,8180,0,0,0,8180,8180,0,0,0,0,24
2501,l1606,20151021,8180,8180,0,0,0,8170,8170,-10,-10,0,0,24
2502,l1606,20151022,8170,8170,0,0,0,8270,8270,100,100,0,0,24
2503,l1606,20151023,8270,8270,8050,8050,8050,8050,8050,-220,-220,6,241500,24
2504,l1606,20151026,8050,8050,0,0,0,7970,7970,-80,-80,0,0,24
2505,l1606,20151027,7970,7970,0,0,0,7930,7930,-40,-40,0,0,24
2506,l1606,20151028,7930,7930,0,0,0,7930,7930,0,0,0,0,24
2507,l1606,20151029,7930,7930,0,0,0,7980,7980,50,50,0,0,24
2508,l1606,20151030,7980,7980,0,0,0,7905,7905,-75,-75,0,0,24
2509,l1606,20151102,7905,7905,0,0,0,7930,7930,25,25,0,0,24
2510,l1606,20151103,7930,7930,0,0,0,7900,7900,-30,-30,0,0,24
2511,l1606,20151104,7900,7900,0,0,0,7940,7940,40,40,0,0,24
2512,l1606,20151105,7940,7940,0,0,0,7750,7750,-190,-190,0,0,24
2513,l1606,20151106,7750,7750,0,0,0,7605,7605,-145,-145,0,0,24
2514,l1606,20151109,7605,7605,7575,7610,7510,7605,7575,0,-30,8,303000,24
2515,l1606,20151110,7605,7575,0,0,0,7480,7480,-95,-95,0,0,24
2516,l1606,20151111,7480,7480,0,0,0,7455,7455,-25,-25,0,0,24
2517,l1606,20151112,7455,7455,0,0,0,7435,7435,-20,-20,0,0,24
2518,l1606,20151113,7435,7435,0,0,0,7375,7375,-60,-60,0,0,24
2519,l1606,20151116,7375,7375,0,0,0,7320,7320,-55,-55,0,0,24
2520,l1606,20151117,7320,7320,0,0,0,7360,7360,40,40,0,0,24
2521,l1606,20151118,7360,7360,0,0,0,7310,7310,-50,-50,0,0,24
2522,l1606,20151119,7310,7310,7140,7140,7140,7140,7140,-170,-170,12,428400,26
2523,l1606,20151120,7140,7140,7170,7170,7170,7170,7170,30,30,12,430200,24
2524,l1606,20151123,7170,7170,6885,6885,6885,6885,6885,-285,-285,6,206550,26
2525,l1606,20151124,6885,6885,6900,6970,6900,6910,6935,25,50,22,763000,24
2526,l1606,20151125,6910,6935,0,0,0,7210,7210,275,275,0,0,24
2527,l1606,20151126,7210,7210,7525,7525,7525,7525,7525,315,315,2,75250,24
2528,l1606,20151127,7525,7525,7390,7510,7390,7510,7445,-15,-80,16,595950,24
2529,l1606,20151130,7510,7445,0,0,0,7375,7375,-70,-70,0,0,24
2530,l1606,20151201,7375,7375,7375,7465,7375,7465,7405,90,30,62,2296150,24
2531,l1606,20151202,7465,7405,7540,7540,7405,7405,7470,0,65,4,149450,24
2532,l1606,20151203,7405,7470,0,0,0,7310,7310,-160,-160,0,0,24
2533,l1606,20151204,7310,7310,0,0,0,7405,7405,95,95,0,0,24
2534,l1606,20151207,7405,7405,0,0,0,7370,7370,-35,-35,0,0,24
2535,l1606,20151208,7370,7370,7375,7375,7005,7180,7145,-190,-225,102,3646050,22
2536,l1606,20151209,7180,7145,0,0,0,7195,7195,50,50,0,0,22
2537,l1606,20151210,7195,7195,7050,7330,7050,7245,7220,50,25,38,1371850,24
2538,l1606,20151211,7245,7220,7350,7425,7235,7335,7355,115,135,138,5075250,24
2539,l1606,20151214,7335,7355,0,0,0,7405,7405,50,50,0,0,24
2540,l1606,20151215,7405,7405,0,0,0,7455,7455,50,50,0,0,24
2541,l1606,20151216,7455,7455,7345,7425,7345,7400,7385,-55,-70,28,1034500,24
2542,l1606,20151217,7400,7385,7545,7545,7410,7410,7475,25,90,16,598200,22
2543,l1606,20151218,7410,7475,7410,7550,7320,7550,7460,75,-15,10,373200,22
2544,l1606,20151221,7550,7460,7600,7600,7540,7540,7570,80,110,4,151400,22
2545,l1606,20151222,7540,7570,7820,7820,7815,7815,7815,245,245,4,156350,24
2546,l1606,20151223,7815,7815,0,0,0,7855,7855,40,40,0,0,24
2547,l1606,20151224,7855,7855,0,0,0,7935,7935,80,80,0,0,24
2548,l1606,20151225,7935,7935,7630,7845,7630,7845,7735,-90,-200,4,154750,24
2549,l1606,20151228,7845,7735,7720,7720,7720,7720,7720,-15,-15,2,77200,22
2550,l1606,20151229,7720,7720,0,0,0,7710,7710,-10,-10,0,0,22
2551,l1606,20151230,7710,7710,7840,7945,7675,7885,7880,175,170,56,2206550,22
2552,l1606,20151231,7885,7880,7980,8020,7880,8020,7940,140,60,12,476600,22
2553,l1607,20150715,8675,8675,0,0,0,8675,8675,0,0,0,0,0
2554,l1607,20150716,8675,8675,8745,8745,8355,8450,8535,-225,-140,8,341400,2
2555,l1607,20150717,8450,8535,0,0,0,8515,8515,-20,-20,0,0,2
2556,l1607,20150720,8515,8515,0,0,0,8515,8515,0,0,0,0,2
2557,l1607,20150721,8515,8515,0,0,0,8500,8500,-15,-15,0,0,2
2558,l1607,20150722,8500,8500,0,0,0,8565,8565,65,65,0,0,2
2559,l1607,20150723,8565,8565,0,0,0,8560,8560,-5,-5,0,0,2
2560,l1607,20150724,8560,8560,0,0,0,8390,8390,-170,-170,0,0,2
2561,l1607,20150727,8390,8390,8220,8220,8220,8220,8220,-170,-170,2,82200,2
2562,l1607,20150728,8220,8220,0,0,0,8205,8205,-15,-15,0,0,2
2563,l1607,20150729,8205,8205,0,0,0,8350,8350,145,145,0,0,2
2564,l1607,20150730,8350,8350,0,0,0,8320,8320,-30,-30,0,0,2
2565,l1607,20150731,8320,8320,0,0,0,8175,8175,-145,-145,0,0,2
2566,l1607,20150803,8175,8175,7920,7990,7910,7915,7920,-260,-255,32,1267450,30
2567,l1607,20150804,7915,7920,0,0,0,8035,8035,115,115,0,0,30
2568,l1607,20150805,8035,8035,0,0,0,8190,8190,155,155,0,0,30
2569,l1607,20150806,8190,8190,0,0,0,8150,8150,-40,-40,0,0,30
2570,l1607,20150807,8150,8150,0,0,0,8140,8140,-10,-10,0,0,30
2571,l1607,20150810,8140,8140,0,0,0,8235,8235,95,95,0,0,30
2572,l1607,20150811,8235,8235,0,0,0,8425,8425,190,190,0,0,30
2573,l1607,20150812,8425,8425,0,0,0,8425,8425,0,0,0,0,30
2574,l1607,20150813,8425,8425,0,0,0,8440,8440,15,15,0,0,30
2575,l1607,20150814,8440,8440,0,0,0,8440,8440,0,0,0,0,30
2576,l1607,20150817,8440,8440,8360,8360,8360,8360,8360,-80,-80,6,250800,30
2577,l1607,20150818,8360,8360,0,0,0,8195,8195,-165,-165,0,0,30
2578,l1607,20150819,8195,8195,0,0,0,8205,8205,10,10,0,0,30
2579,l1607,20150820,8205,8205,0,0,0,8060,8060,-145,-145,0,0,30
2580,l1607,20150821,8060,8060,0,0,0,8115,8115,55,55,0,0,30
2581,l1607,20150824,8115,8115,0,0,0,7875,7875,-240,-240,0,0,30
2582,l1607,20150825,7875,7875,0,0,0,7875,7875,0,0,0,0,30
2583,l1607,20150826,7875,7875,0,0,0,7920,7920,45,45,0,0,30
2584,l1607,20150827,7920,7920,0,0,0,8015,8015,95,95,0,0,30
2585,l1607,20150828,8015,8015,0,0,0,8275,8275,260,260,0,0,30
2586,l1607,20150831,8275,8275,0,0,0,8180,8180,-95,-95,0,0,30
2587,l1607,20150901,8180,8180,0,0,0,8270,8270,90,90,0,0,30
2588,l1607,20150902,8270,8270,0,0,0,8140,8140,-130,-130,0,0,30
2589,l1607,20150907,8140,8140,0,0,0,8185,8185,45,45,0,0,30
2590,l1607,20150908,8185,8185,0,0,0,8050,8050,-135,-135,0,0,30
2591,l1607,20150909,8050,8050,0,0,0,8195,8195,145,145,0,0,30
2592,l1607,20150910,8195,8195,0,0,0,8125,8125,-70,-70,0,0,30
2593,l1607,20150911,8125,8125,0,0,0,8345,8345,220,220,0,0,30
2594,l1607,20150914,8345,8345,0,0,0,8275,8275,-70,-70,0,0,30
2595,l1607,20150915,8275,8275,0,0,0,8165,8165,-110,-110,0,0,30
2596,l1607,20150916,8165,8165,0,0,0,8180,8180,15,15,0,0,30
2597,l1607,20150917,8180,8180,0,0,0,8230,8230,50,50,0,0,30
2598,l1607,20150918,8230,8230,0,0,0,8145,8145,-85,-85,0,0,30
2599,l1607,20150921,8145,8145,0,0,0,8015,8015,-130,-130,0,0,30
2600,l1607,20150922,8015,8015,0,0,0,8035,8035,20,20,0,0,30
2601,l1607,20150923,8035,8035,0,0,0,8065,8065,30,30,0,0,30
2602,l1607,20150924,8065,8065,0,0,0,8060,8060,-5,-5,0,0,30
2603,l1607,20150925,8060,8060,0,0,0,8055,8055,-5,-5,0,0,30
2604,l1607,20150928,8055,8055,0,0,0,8055,8055,0,0,0,0,30
2605,l1607,20150929,8055,8055,0,0,0,7925,7925,-130,-130,0,0,30
2606,l1607,20150930,7925,7925,0,0,0,7985,7985,60,60,0,0,30
2607,l1607,20151008,7985,7985,0,0,0,8160,8160,175,175,0,0,30
2608,l1607,20151009,8160,8160,0,0,0,8325,8325,165,165,0,0,30
2609,l1607,20151012,8325,8325,0,0,0,8325,8325,0,0,0,0,30
2610,l1607,20151013,8325,8325,0,0,0,8325,8325,0,0,0,0,30
2611,l1607,20151014,8325,8325,0,0,0,8300,8300,-25,-25,0,0,30
2612,l1607,20151015,8300,8300,0,0,0,8240,8240,-60,-60,0,0,30
2613,l1607,20151016,8240,8240,0,0,0,8215,8215,-25,-25,0,0,30
2614,l1607,20151019,8215,8215,0,0,0,8160,8160,-55,-55,0,0,30
2615,l1607,20151020,8160,8160,0,0,0,8160,8160,0,0,0,0,30
2616,l1607,20151021,8160,8160,0,0,0,8150,8150,-10,-10,0,0,30
2617,l1607,20151022,8150,8150,0,0,0,8250,8250,100,100,0,0,30
2618,l1607,20151023,8250,8250,0,0,0,8035,8035,-215,-215,0,0,30
2619,l1607,20151026,8035,8035,0,0,0,7955,7955,-80,-80,0,0,30
2620,l1607,20151027,7955,7955,0,0,0,7915,7915,-40,-40,0,0,30
2621,l1607,20151028,7915,7915,0,0,0,7915,7915,0,0,0,0,30
2622,l1607,20151029,7915,7915,0,0,0,7965,7965,50,50,0,0,30
2623,l1607,20151030,7965,7965,0,0,0,7890,7890,-75,-75,0,0,30
2624,l1607,20151102,7890,7890,0,0,0,7915,7915,25,25,0,0,30
2625,l1607,20151103,7915,7915,0,0,0,7885,7885,-30,-30,0,0,30
2626,l1607,20151104,7885,7885,0,0,0,7925,7925,40,40,0,0,30
2627,l1607,20151105,7925,7925,0,0,0,7735,7735,-190,-190,0,0,30
2628,l1607,20151106,7735,7735,0,0,0,7590,7590,-145,-145,0,0,30
2629,l1607,20151109,7590,7590,0,0,0,7565,7565,-25,-25,0,0,30
2630,l1607,20151110,7565,7565,0,0,0,7470,7470,-95,-95,0,0,30
2631,l1607,20151111,7470,7470,0,0,0,7445,7445,-25,-25,0,0,30
2632,l1607,20151112,7445,7445,0,0,0,7425,7425,-20,-20,0,0,30
2633,l1607,20151113,7425,7425,0,0,0,7370,7370,-55,-55,0,0,30
2634,l1607,20151116,7370,7370,0,0,0,7315,7315,-55,-55,0,0,30
2635,l1607,20151117,7315,7315,0,0,0,7350,7350,35,35,0,0,30
2636,l1607,20151118,7350,7350,0,0,0,7305,7305,-45,-45,0,0,30
2637,l1607,20151119,7305,7305,0,0,0,7140,7140,-165,-165,0,0,30
2638,l1607,20151120,7140,7140,0,0,0,7170,7170,30,30,0,0,30
2639,l1607,20151123,7170,7170,0,0,0,6885,6885,-285,-285,0,0,30
2640,l1607,20151124,6885,6885,0,0,0,6930,6930,45,45,0,0,30
2641,l1607,20151125,6930,6930,0,0,0,7155,7155,225,225,0,0,30
2642,l1607,20151126,7155,7155,0,0,0,7440,7440,285,285,0,0,30
2643,l1607,20151127,7440,7440,0,0,0,7365,7365,-75,-75,0,0,30
2644,l1607,20151130,7365,7365,0,0,0,7300,7300,-65,-65,0,0,30
2645,l1607,20151201,7300,7300,7400,7415,7400,7415,7400,115,100,12,444150,30
2646,l1607,20151202,7415,7400,0,0,0,7460,7460,60,60,0,0,30
2647,l1607,20151203,7460,7460,0,0,0,7300,7300,-160,-160,0,0,30
2648,l1607,20151204,7300,7300,0,0,0,7395,7395,95,95,0,0,30
2649,l1607,20151207,7395,7395,0,0,0,7360,7360,-35,-35,0,0,30
2650,l1607,20151208,7360,7360,0,0,0,7140,7140,-220,-220,0,0,30
2651,l1607,20151209,7140,7140,0,0,0,7190,7190,50,50,0,0,30
2652,l1607,20151210,7190,7190,0,0,0,7210,7210,20,20,0,0,30
2653,l1607,20151211,7210,7210,0,0,0,7340,7340,130,130,0,0,30
2654,l1607,20151214,7340,7340,0,0,0,7390,7390,50,50,0,0,30
2655,l1607,20151215,7390,7390,0,0,0,7440,7440,50,50,0,0,30
2656,l1607,20151216,7440,7440,0,0,0,7375,7375,-65,-65,0,0,30
2657,l1607,20151217,7375,7375,7410,7410,7410,7410,7410,35,35,2,74100,30
2658,l1607,20151218,7410,7410,0,0,0,7400,7400,-10,-10,0,0,30
2659,l1607,20151221,7400,7400,0,0,0,7505,7505,105,105,0,0,30
2660,l1607,20151222,7505,7505,7650,7700,7650,7700,7670,195,165,20,767000,22
2661,l1607,20151223,7700,7670,0,0,0,7705,7705,35,35,0,0,22
2662,l1607,20151224,7705,7705,0,0,0,7780,7780,75,75,0,0,22
2663,l1607,20151225,7780,7780,0,0,0,7585,7585,-195,-195,0,0,22
2664,l1607,20151228,7585,7585,0,0,0,7575,7575,-10,-10,0,0,22
2665,l1607,20151229,7575,7575,0,0,0,7565,7565,-10,-10,0,0,22
2666,l1607,20151230,7565,7565,0,0,0,7730,7730,165,165,0,0,22
2667,l1607,20151231,7730,7730,0,0,0,7785,7785,55,55,0,0,22
2668,l1608,20150817,8465,8465,0,0,0,8465,8465,0,0,0,0,0
2669,l1608,20150818,8465,8465,0,0,0,8465,8465,0,0,0,0,0
2670,l1608,20150819,8465,8465,0,0,0,8465,8465,0,0,0,0,0
2671,l1608,20150820,8465,8465,0,0,0,8315,8315,-150,-150,0,0,0
2672,l1608,20150821,8315,8315,0,0,0,8375,8375,60,60,0,0,0
2673,l1608,20150824,8375,8375,0,0,0,8125,8125,-250,-250,0,0,0
2674,l1608,20150825,8125,8125,0,0,0,8115,8115,-10,-10,0,0,0
2675,l1608,20150826,8115,8115,0,0,0,8160,8160,45,45,0,0,0
2676,l1608,20150827,8160,8160,0,0,0,8255,8255,95,95,0,0,0
2677,l1608,20150828,8255,8255,0,0,0,8525,8525,270,270,0,0,0
2678,l1608,20150831,8525,8525,0,0,0,8425,8425,-100,-100,0,0,0
2679,l1608,20150901,8425,8425,0,0,0,8520,8520,95,95,0,0,0
2680,l1608,20150902,8520,8520,0,0,0,8385,8385,-135,-135,0,0,0
2681,l1608,20150907,8385,8385,0,0,0,8435,8435,50,50,0,0,0
2682,l1608,20150908,8435,8435,0,0,0,8295,8295,-140,-140,0,0,0
2683,l1608,20150909,8295,8295,0,0,0,8445,8445,150,150,0,0,0
2684,l1608,20150910,8445,8445,0,0,0,8370,8370,-75,-75,0,0,0
2685,l1608,20150911,8370,8370,0,0,0,8600,8600,230,230,0,0,0
2686,l1608,20150914,8600,8600,0,0,0,8530,8530,-70,-70,0,0,0
2687,l1608,20150915,8530,8530,0,0,0,8420,8420,-110,-110,0,0,0
2688,l1608,20150916,8420,8420,0,0,0,8435,8435,15,15,0,0,0
2689,l1608,20150917,8435,8435,0,0,0,8485,8485,50,50,0,0,0
2690,l1608,20150918,8485,8485,7820,8055,7820,8055,7935,-430,-550,4,158750,2
2691,l1608,20150921,8055,7935,0,0,0,7805,7805,-130,-130,0,0,2
2692,l1608,20150922,7805,7805,0,0,0,7825,7825,20,20,0,0,2
2693,l1608,20150923,7825,7825,0,0,0,7855,7855,30,30,0,0,2
2694,l1608,20150924,7855,7855,0,0,0,7850,7850,-5,-5,0,0,2
2695,l1608,20150925,7850,7850,0,0,0,7845,7845,-5,-5,0,0,2
2696,l1608,20150928,7845,7845,0,0,0,7845,7845,0,0,0,0,2
2697,l1608,20150929,7845,7845,0,0,0,7720,7720,-125,-125,0,0,2
2698,l1608,20150930,7720,7720,0,0,0,7775,7775,55,55,0,0,2
2699,l1608,20151008,7775,7775,0,0,0,7945,7945,170,170,0,0,2
2700,l1608,20151009,7945,7945,0,0,0,8105,8105,160,160,0,0,2
2701,l1608,20151012,8105,8105,0,0,0,8105,8105,0,0,0,0,2
2702,l1608,20151013,8105,8105,0,0,0,8105,8105,0,0,0,0,2
2703,l1608,20151014,8105,8105,8200,8200,8200,8200,8200,95,95,2,82000,4
2704,l1608,20151015,8200,8200,0,0,0,8140,8140,-60,-60,0,0,4
2705,l1608,20151016,8140,8140,0,0,0,8115,8115,-25,-25,0,0,4
2706,l1608,20151019,8115,8115,0,0,0,8115,8115,0,0,0,0,4
2707,l1608,20151020,8115,8115,0,0,0,8115,8115,0,0,0,0,4
2708,l1608,20151021,8115,8115,0,0,0,8115,8115,0,0,0,0,4
2709,l1608,20151022,8115,8115,0,0,0,8215,8215,100,100,0,0,4
2710,l1608,20151023,8215,8215,0,0,0,8000,8000,-215,-215,0,0,4
2711,l1608,20151026,8000,8000,0,0,0,7920,7920,-80,-80,0,0,4
2712,l1608,20151027,7920,7920,0,0,0,7880,7880,-40,-40,0,0,4
2713,l1608,20151028,7880,7880,0,0,0,7880,7880,0,0,0,0,4
2714,l1608,20151029,7880,7880,0,0,0,7930,7930,50,50,0,0,4
2715,l1608,20151030,7930,7930,0,0,0,7930,7930,0,0,0,0,4
2716,l1608,20151102,7930,7930,0,0,0,7955,7955,25,25,0,0,4
2717,l1608,20151103,7955,7955,0,0,0,7925,7925,-30,-30,0,0,4
2718,l1608,20151104,7925,7925,0,0,0,7965,7965,40,40,0,0,4
2719,l1608,20151105,7965,7965,0,0,0,7965,7965,0,0,0,0,4
2720,l1608,20151106,7965,7965,0,0,0,7815,7815,-150,-150,0,0,4
2721,l1608,20151109,7815,7815,0,0,0,7785,7785,-30,-30,0,0,4
2722,l1608,20151110,7785,7785,0,0,0,7685,7685,-100,-100,0,0,4
2723,l1608,20151111,7685,7685,0,0,0,7655,7655,-30,-30,0,0,4
2724,l1608,20151112,7655,7655,0,0,0,7630,7630,-25,-25,0,0,4
2725,l1608,20151113,7630,7630,0,0,0,7570,7570,-60,-60,0,0,4
2726,l1608,20151116,7570,7570,0,0,0,7515,7515,-55,-55,0,0,4
2727,l1608,20151117,7515,7515,0,0,0,7555,7555,40,40,0,0,4
2728,l1608,20151118,7555,7555,0,0,0,7505,7505,-50,-50,0,0,4
2729,l1608,20151119,7505,7505,0,0,0,7335,7335,-170,-170,0,0,4
2730,l1608,20151120,7335,7335,0,0,0,7045,7045,-290,-290,0,0,4
2731,l1608,20151123,7045,7045,0,0,0,6765,6765,-280,-280,0,0,4
2732,l1608,20151124,6765,6765,0,0,0,6810,6810,45,45,0,0,4
2733,l1608,20151125,6810,6810,0,0,0,7030,7030,220,220,0,0,4
2734,l1608,20151126,7030,7030,0,0,0,7310,7310,280,280,0,0,4
2735,l1608,20151127,7310,7310,0,0,0,7235,7235,-75,-75,0,0,4
2736,l1608,20151130,7235,7235,0,0,0,7170,7170,-65,-65,0,0,4
2737,l1608,20151201,7170,7170,0,0,0,7265,7265,95,95,0,0,4
2738,l1608,20151202,7265,7265,0,0,0,7325,7325,60,60,0,0,4
2739,l1608,20151203,7325,7325,0,0,0,7165,7165,-160,-160,0,0,4
2740,l1608,20151204,7165,7165,0,0,0,7260,7260,95,95,0,0,4
2741,l1608,20151207,7260,7260,0,0,0,7225,7225,-35,-35,0,0,4
2742,l1608,20151208,7225,7225,0,0,0,7005,7005,-220,-220,0,0,4
2743,l1608,20151209,7005,7005,0,0,0,7055,7055,50,50,0,0,4
2744,l1608,20151210,7055,7055,0,0,0,7075,7075,20,20,0,0,4
2745,l1608,20151211,7075,7075,0,0,0,7205,7205,130,130,0,0,4
2746,l1608,20151214,7205,7205,0,0,0,7255,7255,50,50,0,0,4
2747,l1608,20151215,7255,7255,0,0,0,7305,7305,50,50,0,0,4
2748,l1608,20151216,7305,7305,0,0,0,7240,7240,-65,-65,0,0,4
2749,l1608,20151217,7240,7240,0,0,0,7270,7270,30,30,0,0,4
2750,l1608,20151218,7270,7270,0,0,0,7260,7260,-10,-10,0,0,4
2751,l1608,20151221,7260,7260,0,0,0,7365,7365,105,105,0,0,4
2752,l1608,20151222,7365,7365,0,0,0,7525,7525,160,160,0,0,4
2753,l1608,20151223,7525,7525,0,0,0,7560,7560,35,35,0,0,4
2754,l1608,20151224,7560,7560,7545,7615,7545,7615,7580,55,20,4,151600,4
2755,l1608,20151225,7615,7580,0,0,0,7390,7390,-190,-190,0,0,4
2756,l1608,20151228,7390,7390,0,0,0,7380,7380,-10,-10,0,0,4
2757,l1608,20151229,7380,7380,0,0,0,7370,7370,-10,-10,0,0,4
2758,l1608,20151230,7370,7370,0,0,0,7530,7530,160,160,0,0,4
2759,l1608,20151231,7530,7530,0,0,0,7585,7585,55,55,0,0,4
2760,l1609,20150917,8140,8140,7940,8060,7875,7875,7935,-265,-205,3790,150429400,2668
2761,l1609,20150918,7875,7935,7880,7920,7810,7830,7870,-105,-65,4020,158189400,5480
2762,l1609,20150921,7830,7870,7820,7890,7755,7875,7810,5,-60,1884,73612950,5666
2763,l1609,20150922,7875,7810,7885,7885,7810,7845,7840,35,30,1838,72082150,6334
2764,l1609,20150923,7845,7840,7830,7900,7825,7890,7860,50,20,3868,152102100,7016
2765,l1609,20150924,7890,7860,7850,7875,7820,7855,7845,-5,-15,1702,66761550,7682
2766,l1609,20150925,7855,7845,7890,7890,7770,7770,7840,-75,-5,5322,208678550,10186
2767,l1609,20150928,7770,7840,7785,7790,7700,7700,7745,-140,-95,5530,214221650,12644
2768,l1609,20150929,7700,7745,7660,7675,7585,7650,7630,-95,-115,6550,249962550,14310
2769,l1609,20150930,7650,7630,7660,7730,7635,7730,7665,100,35,4116,157784450,15132
2770,l1609,20151008,7730,7665,7920,7920,7810,7840,7845,175,180,2908,114082650,15082
2771,l1609,20151009,7840,7845,7890,8095,7875,8055,7955,210,110,9452,376075200,15134
2772,l1609,20151012,8055,7955,8070,8070,8010,8050,8040,95,85,4764,191599150,16862
2773,l1609,20151013,8050,8040,7960,8000,7930,8000,7950,-40,-90,5372,213620600,17188
2774,l1609,20151014,8000,7950,7955,7985,7855,7870,7915,-80,-35,7086,280597600,19896
2775,l1609,20151015,7870,7915,7865,7910,7855,7870,7875,-45,-40,3626,142804100,20476
2776,l1609,20151016,7870,7875,7890,7905,7820,7860,7845,-15,-30,7932,311274550,23890
2777,l1609,20151019,7860,7845,7850,7855,7790,7820,7815,-25,-30,14448,564838750,29370
2778,l1609,20151020,7820,7815,7800,7880,7785,7850,7835,35,20,14888,583518250,30840
2779,l1609,20151021,7850,7835,7835,7855,7810,7840,7830,5,-5,10096,395467350,33086
2780,l1609,20151022,7840,7830,7850,7965,7850,7925,7905,95,75,12754,504389700,30050
2781,l1609,20151023,7925,7905,7935,7935,7820,7885,7855,-20,-50,14380,565130000,30204
2782,l1609,20151026,7885,7855,7885,7885,7790,7805,7815,-50,-40,16154,631586600,31874
2783,l1609,20151027,7805,7815,7780,7815,7740,7795,7770,-20,-45,14742,572903400,33690
2784,l1609,20151028,7795,7770,7800,7800,7745,7790,7770,20,0,10142,394021550,34440
2785,l1609,20151029,7790,7770,7850,7890,7785,7785,7820,15,50,9400,367654050,36480
2786,l1609,20151030,7785,7820,7810,7810,7730,7770,7760,-50,-60,14504,562960300,36760
2787,l1609,20151102,7770,7760,7770,7800,7745,7775,7775,15,15,11092,431409050,34950
2788,l1609,20151103,7775,7775,7785,7800,7745,7765,7765,-10,-10,15918,618264750,33418
2789,l1609,20151104,7765,7765,7790,7860,7770,7850,7830,85,65,9732,381019500,34842
2790,l1609,20151105,7850,7830,7820,7820,7595,7635,7680,-195,-150,26480,1017006650,45638
2791,l1609,20151106,7635,7680,7605,7605,7450,7515,7505,-165,-175,27120,1018334250,52932
2792,l1609,20151109,7515,7505,7480,7505,7410,7440,7450,-65,-55,16084,599148750,55066
2793,l1609,20151110,7440,7450,7440,7440,7300,7350,7340,-100,-110,23714,870837700,53810
2794,l1609,20151111,7350,7340,7330,7340,7260,7270,7300,-70,-40,9854,359747950,58314
2795,l1609,20151112,7270,7300,7250,7270,7215,7225,7240,-75,-60,16466,596394150,58882
2796,l1609,20151113,7225,7240,7225,7235,7120,7140,7180,-100,-60,18658,669939350,59832
2797,l1609,20151116,7140,7180,7100,7150,7090,7095,7115,-85,-65,13032,463836100,60370
2798,l1609,20151117,7095,7115,7120,7215,7100,7180,7160,65,45,23414,838558000,54178
2799,l1609,20151118,7180,7160,7170,7190,7055,7060,7095,-100,-65,25868,918304950,59606
2800,l1609,20151119,7060,7095,7050,7110,6970,6980,7030,-115,-65,26664,937443450,65302
2801,l1609,20151120,6980,7030,6995,7025,6750,6750,6840,-280,-190,38202,1306651400,73906
2802,l1609,20151123,6750,6840,6710,6710,6500,6540,6565,-300,-275,45464,1492889000,61522
2803,l1609,20151124,6540,6565,6580,6825,6575,6825,6720,260,155,43464,1461318450,60586
2804,l1609,20151125,6825,6720,6875,6990,6815,6890,6910,170,190,40250,1391058250,53702
2805,l1609,20151126,6890,6910,6910,7180,6870,7090,7025,180,115,38046,1336901750,53556
2806,l1609,20151127,7090,7025,7050,7110,6955,7010,7015,-15,-10,21826,766048950,49580
2807,l1609,20151130,7010,7015,6985,7000,6840,6985,6920,-30,-95,30306,1048996750,54106
2808,l1609,20151201,6985,6920,6985,7115,6970,7070,7050,150,130,21156,746123500,53758
2809,l1609,20151202,7070,7050,7090,7170,7035,7075,7105,25,55,24016,853715300,55652
2810,l1609,20151203,7075,7105,6895,7050,6890,7050,6960,-55,-145,25232,878425800,60016
2811,l1609,20151204,7050,6960,7090,7100,6990,7020,7045,60,85,17450,615017700,57822
2812,l1609,20151207,7020,7045,6980,7085,6900,7075,7000,30,-45,15492,542448000,56624
2813,l1609,20151208,7075,7000,6960,6975,6700,6740,6805,-260,-195,27728,943590450,59996
2814,l1609,20151209,6740,6805,6780,6850,6775,6845,6810,40,5,25984,884787750,65540
2815,l1609,20151210,6845,6810,6820,6930,6775,6920,6840,110,30,32708,1119186900,74080
2816,l1609,20151211,6920,6840,6895,7010,6865,7000,6910,160,70,26776,925563350,77202
2817,l1609,20151214,7000,6910,6950,7045,6855,7035,6945,125,35,32584,1132114500,81382
2818,l1609,20151215,7035,6945,7055,7120,6965,6990,7040,45,95,37278,1312437500,77076
2819,l1609,20151216,6990,7040,7000,7035,6935,7025,6980,-15,-60,27368,955706050,78826
2820,l1609,20151217,7025,6980,6990,7125,6985,7010,7055,30,75,35512,1253016150,78142
2821,l1609,20151218,7010,7055,7000,7170,6965,7165,7085,110,30,34948,1238107400,75686
2822,l1609,20151221,7165,7085,7210,7270,7125,7265,7185,180,100,46118,1657370850,74078
2823,l1609,20151222,7265,7185,7270,7395,7245,7385,7310,200,125,46020,1682727350,75462
2824,l1609,20151223,7385,7310,7400,7540,7275,7510,7430,200,120,88866,3301410200,86992
2825,l1609,20151224,7510,7430,7550,7565,7390,7420,7475,-10,45,107532,4019659400,95772
2826,l1609,20151225,7420,7475,7435,7440,7325,7430,7385,-45,-90,61132,2258649400,98282
2827,l1609,20151228,7430,7385,7395,7430,7315,7330,7370,-55,-15,40568,1495285750,102248
2828,l1609,20151229,7330,7370,7300,7460,7275,7430,7350,60,-20,53454,1964743900,105066
2829,l1609,20151230,7430,7350,7450,7620,7450,7590,7540,240,190,131444,4958549250,118828
2830,l1609,20151231,7590,7540,7590,7720,7555,7625,7625,85,85,103614,3952384500,132226
2831,l1610,20151022,7835,7835,0,0,0,7910,7910,75,75,0,0,0
2832,l1610,20151023,7910,7910,0,0,0,7860,7860,-50,-50,0,0,0
2833,l1610,20151026,7860,7860,7705,7880,7705,7880,7790,20,-70,4,155850,0
2834,l1610,20151027,7880,7790,0,0,0,7750,7750,-40,-40,0,0,0
2835,l1610,20151028,7750,7750,0,0,0,7750,7750,0,0,0,0,0
2836,l1610,20151029,7750,7750,0,0,0,7795,7795,45,45,0,0,0
2837,l1610,20151030,7795,7795,0,0,0,7740,7740,-55,-55,0,0,0
2838,l1610,20151102,7740,7740,7880,7880,7880,7880,7880,140,140,2,78800,2
2839,l1610,20151103,7880,7880,0,0,0,7870,7870,-10,-10,0,0,2
2840,l1610,20151104,7870,7870,0,0,0,7935,7935,65,65,0,0,2
2841,l1610,20151105,7935,7935,0,0,0,7785,7785,-150,-150,0,0,2
2842,l1610,20151106,7785,7785,7680,7680,7620,7620,7650,-165,-135,4,153000,6
2843,l1610,20151109,7620,7650,7560,7560,7370,7375,7445,-275,-205,8,297950,6
2844,l1610,20151110,7375,7445,0,0,0,7380,7380,-65,-65,0,0,6
2845,l1610,20151111,7380,7380,7395,7395,7395,7395,7395,15,15,2,73950,8
2846,l1610,20151112,7395,7395,0,0,0,7380,7380,-15,-15,0,0,8
2847,l1610,20151113,7380,7380,0,0,0,7320,7320,-60,-60,0,0,8
2848,l1610,20151116,7320,7320,0,0,0,7255,7255,-65,-65,0,0,8
2849,l1610,20151117,7255,7255,0,0,0,7300,7300,45,45,0,0,8
2850,l1610,20151118,7300,7300,0,0,0,7235,7235,-65,-65,0,0,8
2851,l1610,20151119,7235,7235,0,0,0,7170,7170,-65,-65,0,0,8
2852,l1610,20151120,7170,7170,0,0,0,6885,6885,-285,-285,0,0,8
2853,l1610,20151123,6885,6885,6495,6585,6495,6530,6520,-355,-365,10,326000,8
2854,l1610,20151124,6530,6520,6655,6700,6655,6700,6675,180,155,4,133550,4
2855,l1610,20151125,6700,6675,0,0,0,6860,6860,185,185,0,0,4
2856,l1610,20151126,6860,6860,0,0,0,6970,6970,110,110,0,0,4
2857,l1610,20151127,6970,6970,0,0,0,6965,6965,-5,-5,0,0,4
2858,l1610,20151130,6965,6965,0,0,0,6875,6875,-90,-90,0,0,4
2859,l1610,20151201,6875,6875,0,0,0,7000,7000,125,125,0,0,4
2860,l1610,20151202,7000,7000,0,0,0,7050,7050,50,50,0,0,4
2861,l1610,20151203,7050,7050,0,0,0,6910,6910,-140,-140,0,0,4
2862,l1610,20151204,6910,6910,6925,7105,6925,7105,7015,195,105,24,841800,2
2863,l1610,20151207,7105,7015,0,0,0,6975,6975,-40,-40,0,0,2
2864,l1610,20151208,6975,6975,0,0,0,6785,6785,-190,-190,0,0,2
2865,l1610,20151209,6785,6785,0,0,0,6785,6785,0,0,0,0,2
2866,l1610,20151210,6785,6785,0,0,0,6810,6810,25,25,0,0,2
2867,l1610,20151211,6810,6810,0,0,0,6875,6875,65,65,0,0,2
2868,l1610,20151214,6875,6875,0,0,0,6905,6905,30,30,0,0,2
2869,l1610,20151215,6905,6905,0,0,0,6995,6995,90,90,0,0,2
2870,l1610,20151216,6995,6995,0,0,0,6940,6940,-55,-55,0,0,2
2871,l1610,20151217,6940,6940,6875,7075,6875,7075,6980,135,40,8,279350,2
2872,l1610,20151218,7075,6980,0,0,0,7005,7005,25,25,0,0,2
2873,l1610,20151221,7005,7005,0,0,0,7100,7100,95,95,0,0,2
2874,l1610,20151222,7100,7100,0,0,0,7220,7220,120,120,0,0,2
2875,l1610,20151223,7220,7220,0,0,0,7335,7335,115,115,0,0,2
2876,l1610,20151224,7335,7335,7570,7570,7355,7355,7550,20,215,22,830550,22
2877,l1610,20151225,7355,7550,0,0,0,7460,7460,-90,-90,0,0,22
2878,l1610,20151228,7460,7460,0,0,0,7445,7445,-15,-15,0,0,22
2879,l1610,20151229,7445,7445,0,0,0,7425,7425,-20,-20,0,0,22
2880,l1610,20151230,7425,7425,0,0,0,7615,7615,190,190,0,0,22
2881,l1610,20151231,7615,7615,0,0,0,7700,7700,85,85,0,0,22
2882,l1611,20151116,7240,7240,0,0,0,7175,7175,-65,-65,0,0,0
2883,l1611,20151117,7175,7175,0,0,0,7220,7220,45,45,0,0,0
2884,l1611,20151118,7220,7220,7185,7185,7185,7185,7185,-35,-35,2,71850,2
2885,l1611,20151119,7185,7185,6945,6945,6945,6945,6945,-240,-240,2,69450,0
2886,l1611,20151120,6945,6945,0,0,0,6760,6760,-185,-185,0,0,0
2887,l1611,20151123,6760,6760,0,0,0,6490,6490,-270,-270,0,0,0
2888,l1611,20151124,6490,6490,0,0,0,6640,6640,150,150,0,0,0
2889,l1611,20151125,6640,6640,0,0,0,6825,6825,185,185,0,0,0
2890,l1611,20151126,6825,6825,0,0,0,6935,6935,110,110,0,0,0
2891,l1611,20151127,6935,6935,0,0,0,6930,6930,-5,-5,0,0,0
2892,l1611,20151130,6930,6930,0,0,0,6840,6840,-90,-90,0,0,0
2893,l1611,20151201,6840,6840,0,0,0,6965,6965,125,125,0,0,0
2894,l1611,20151202,6965,6965,0,0,0,7015,7015,50,50,0,0,0
2895,l1611,20151203,7015,7015,0,0,0,6875,6875,-140,-140,0,0,0
2896,l1611,20151204,6875,6875,0,0,0,6975,6975,100,100,0,0,0
2897,l1611,20151207,6975,6975,0,0,0,6935,6935,-40,-40,0,0,0
2898,l1611,20151208,6935,6935,0,0,0,6745,6745,-190,-190,0,0,0
2899,l1611,20151209,6745,6745,0,0,0,6745,6745,0,0,0,0,0
2900,l1611,20151210,6745,6745,0,0,0,6770,6770,25,25,0,0,0
2901,l1611,20151211,6770,6770,0,0,0,6835,6835,65,65,0,0,0
2902,l1611,20151214,6835,6835,0,0,0,6865,6865,30,30,0,0,0
2903,l1611,20151215,6865,6865,0,0,0,6955,6955,90,90,0,0,0
2904,l1611,20151216,6955,6955,0,0,0,6900,6900,-55,-55,0,0,0
2905,l1611,20151217,6900,6900,0,0,0,6935,6935,35,35,0,0,0
2906,l1611,20151218,6935,6935,0,0,0,6960,6960,25,25,0,0,0
2907,l1611,20151221,6960,6960,0,0,0,7055,7055,95,95,0,0,0
2908,l1611,20151222,7055,7055,0,0,0,7175,7175,120,120,0,0,0
2909,l1611,20151223,7175,7175,0,0,0,7290,7290,115,115,0,0,0
2910,l1611,20151224,7290,7290,0,0,0,7500,7500,210,210,0,0,0
2911,l1611,20151225,7500,7500,0,0,0,7410,7410,-90,-90,0,0,0
2912,l1611,20151228,7410,7410,0,0,0,7395,7395,-15,-15,0,0,0
2913,l1611,20151229,7395,7395,0,0,0,7375,7375,-20,-20,0,0,0
2914,l1611,20151230,7375,7375,0,0,0,7565,7565,190,190,0,0,0
2915,l1611,20151231,7565,7565,0,0,0,7650,7650,85,85,0,0,0
2916,l1612,20151215,6910,6910,0,0,0,7000,7000,90,90,0,0,0
2917,l1612,20151216,7000,7000,0,0,0,6945,6945,-55,-55,0,0,0
2918,l1612,20151217,6945,6945,0,0,0,6985,6985,40,40,0,0,0
2919,l1612,20151218,6985,6985,0,0,0,7010,7010,25,25,0,0,0
2920,l1612,20151221,7010,7010,0,0,0,7105,7105,95,95,0,0,0
2921,l1612,20151222,7105,7105,0,0,0,7225,7225,120,120,0,0,0
2922,l1612,20151223,7225,7225,0,0,0,7340,7340,115,115,0,0,0
2923,l1612,20151224,7340,7340,0,0,0,7555,7555,215,215,0,0,0
2924,l1612,20151225,7555,7555,0,0,0,7465,7465,-90,-90,0,0,0
2925,l1612,20151228,7465,7465,0,0,0,7450,7450,-15,-15,0,0,0
2926,l1612,20151229,7450,7450,0,0,0,7430,7430,-20,-20,0,0,0
2927,l1612,20151230,7430,7430,0,0,0,7620,7620,190,190,0,0,0
2928,l1612,20151231,7620,7620,0,0,0,7705,7705,85,85,0,0,0
