 1,a1501,20150105,4670,4665,4665,4711,4660,4690,4697,25,32,8932,419602560,28210
2,a1501,20150106,4690,4697,4699,4715,4685,4709,4707,12,10,4788,225371980,21880
3,a1501,20150107,4709,4707,4685,4690,4680,4687,4686,-20,-21,2280,106858000,19984
4,a1501,20150108,4687,4686,4690,4720,4690,4720,4709,34,23,2612,123022600,17814
5,a1501,20150109,4720,4709,4700,4720,4700,4710,4716,1,7,42,1980780,16794
6,a1501,20150112,4710,4716,4720,4722,4710,4710,4717,-6,1,810,38208600,14300
7,a1501,20150113,4710,4717,4700,4720,4700,4701,4701,-16,-16,534,25103800,9416
8,a1501,20150114,4701,4701,4700,4720,4700,4710,4700,9,-1,912,42869300,6714
9,a1501,20150115,4710,4700,4700,4709,4601,4709,4697,9,-3,1306,61344860,1952
10,a1501,20150116,4709,4697,4599,4599,4599,4599,4700,-98,3,6,275940,0
11,a1503,20150105,4445,4444,4459,4459,4312,4445,4390,1,-54,258,11326520,206
12,a1503,20150106,4445,4390,4423,4495,4423,4495,4463,105,73,22,981860,208
13,a1503,20150107,4495,4463,4630,4630,4498,4510,4542,47,79,82,3724800,192
14,a1503,20150108,4510,4542,4520,4560,4514,4548,4537,6,-5,20,907480,194
15,a1503,20150109,4548,4537,4565,4574,4489,4502,4544,-35,7,158,7179680,228
16,a1503,20150112,4502,4544,4470,4516,4468,4502,4504,-42,-40,52,2342580,258
17,a1503,20150113,4502,4504,4450,4458,4438,4449,4441,-55,-63,136,6039980,138
18,a1503,20150114,4449,4441,4452,4452,4452,4452,4452,11,11,2,89040,136
19,a1503,20150115,4452,4452,0,0,0,4452,4452,0,0,0,0,136
20,a1503,20150116,4452,4452,4460,4478,4426,4450,4450,-2,-2,56,2492180,138
21,a1503,20150119,4450,4450,4415,4477,4415,4469,4453,19,3,6,267220,140
22,a1503,20150120,4469,4453,4421,4459,4421,4440,4435,-13,-18,12,532280,136
23,a1503,20150121,4440,4435,4427,4457,4415,4425,4431,-10,-4,30,1329540,126
24,a1503,20150122,4425,4431,4403,4437,4403,4420,4426,-11,-5,28,1239280,118
25,a1503,20150123,4420,4426,0,0,0,4426,4426,0,0,0,0,118
26,a1503,20150126,4426,4426,4416,4416,4340,4340,4378,-86,-48,4,175120,118
27,a1503,20150127,4340,4378,4408,4408,4350,4350,4379,-28,1,12,525580,122
28,a1503,20150128,4350,4379,4385,4385,4370,4370,4375,-9,-4,12,525000,126
29,a1503,20150129,4370,4375,4350,4367,4307,4354,4343,-21,-32,26,1129420,126
30,a1503,20150130,4354,4343,4353,4360,4330,4330,4341,-13,-2,30,1302460,130
31,a1503,20150202,4330,4341,4339,4339,4311,4330,4324,-11,-17,20,864980,130
32,a1503,20150203,4330,4324,4349,4349,4320,4320,4334,-4,10,4,173380,130
33,a1503,20150204,4320,4334,4335,4380,4280,4285,4319,-49,-15,74,3196220,138
34,a1503,20150205,4285,4319,4310,4321,4300,4321,4311,2,-8,28,1207300,122
35,a1503,20150206,4321,4311,0,0,0,4311,4311,0,0,0,0,122
36,a1503,20150209,4311,4311,4344,4344,4257,4306,4297,-5,-14,56,2406360,120
37,a1503,20150210,4306,4297,4303,4303,4262,4270,4287,-27,-10,20,857520,116
38,a1503,20150211,4270,4287,4260,4280,4255,4260,4266,-27,-21,20,853300,116
39,a1503,20150212,4260,4266,0,0,0,4263,4263,-3,-3,0,0,116
40,a1503,20150213,4263,4263,4269,4269,4211,4240,4240,-23,-23,6,254400,114
41,a1503,20150216,4240,4240,4200,4236,4200,4220,4211,-20,-29,14,589560,110
42,a1503,20150217,4220,4211,4140,4140,4140,4140,4140,-71,-71,2,82800,108
43,a1503,20150225,4140,4140,4005,4180,4000,4000,4022,-140,-118,20,804400,100
44,a1503,20150226,4000,4022,4057,4059,4031,4059,4055,37,33,46,1865560,110
45,a1503,20150227,4059,4055,4059,4217,4057,4150,4081,95,26,86,3510060,90
46,a1503,20150302,4150,4081,4078,4078,4078,4078,4078,-3,-3,82,3343960,2
47,a1503,20150303,4078,4078,0,0,0,4078,4078,0,0,0,0,2
48,a1503,20150304,4078,4078,0,0,0,4078,4078,0,0,0,0,2
49,a1503,20150305,4078,4078,0,0,0,4078,4078,0,0,0,0,2
50,a1503,20150306,4078,4078,4000,4000,4000,4000,4000,-78,-78,2,80000,0
51,a1503,20150309,4000,4000,0,0,0,4000,4000,0,0,0,0,0
52,a1503,20150310,4000,4000,0,0,0,4000,4000,0,0,0,0,0
53,a1503,20150311,4000,4000,0,0,0,4000,4000,0,0,0,0,0
54,a1503,20150312,4000,4000,0,0,0,4000,4000,0,0,0,0,0
55,a1503,20150313,4000,4000,0,0,0,4076,4076,76,76,0,0,0
56,a1505,20150105,4510,4505,4488,4504,4446,4497,4486,-8,-19,72400,3248361220,257298
57,a1505,20150106,4497,4486,4500,4548,4486,4503,4514,17,28,176706,7977943480,257146
58,a1505,20150107,4503,4514,4514,4528,4480,4505,4503,-9,-11,102236,4604083940,259540
59,a1505,20150108,4505,4503,4510,4524,4490,4503,4508,0,5,93610,4220490960,258778
60,a1505,20150109,4503,4508,4508,4519,4486,4509,4502,1,-6,106146,4779244560,257520
61,a1505,20150112,4509,4502,4511,4538,4497,4510,4521,8,19,134590,6084913440,256854
62,a1505,20150113,4510,4521,4501,4504,4465,4483,4482,-38,-39,116956,5242181380,246092
63,a1505,20150114,4483,4482,4485,4487,4452,4467,4469,-15,-13,96432,4310197200,246202
64,a1505,20150115,4467,4469,4456,4504,4456,4497,4482,28,13,96184,4311249760,247480
65,a1505,20150116,4497,4482,4495,4522,4470,4506,4494,24,12,115612,5195739760,242850
66,a1505,20150119,4506,4494,4514,4518,4475,4496,4497,2,3,105682,4753200120,239272
67,a1505,20150120,4496,4497,4500,4515,4457,4458,4478,-39,-19,88182,3949372360,233202
68,a1505,20150121,4458,4478,4457,4496,4408,4460,4456,-18,-22,155502,6929374760,219656
69,a1505,20150122,4460,4456,4452,4472,4434,4441,4453,-15,-3,71814,3198444140,215952
70,a1505,20150123,4441,4453,4445,4454,4416,4426,4432,-27,-21,56848,2519627520,210796
71,a1505,20150126,4426,4432,4421,4445,4391,4391,4414,-41,-18,82258,3630911060,209592
72,a1505,20150127,4391,4414,4395,4465,4393,4440,4429,26,15,65310,2892932700,203284
73,a1505,20150128,4440,4429,4440,4450,4412,4418,4430,-11,1,49192,2179404040,203628
74,a1505,20150129,4418,4430,4415,4421,4350,4364,4371,-66,-59,212272,9279981680,209296
75,a1505,20150130,4364,4371,4355,4386,4340,4349,4366,-22,-5,97866,4273338120,203100
76,a1505,20150202,4349,4366,4350,4408,4349,4403,4382,37,16,112488,4929467000,194300
77,a1505,20150203,4403,4382,4403,4436,4403,4433,4421,51,39,90338,3994318620,184900
78,a1505,20150204,4433,4421,4438,4455,4409,4413,4431,-8,10,72228,3200637660,179178
79,a1505,20150205,4413,4431,4411,4425,4380,4417,4406,-14,-25,67152,2958896400,175700
80,a1505,20150206,4417,4406,4426,4436,4412,4433,4423,27,17,43952,1944338660,178198
81,a1505,20150209,4433,4423,4437,4440,4384,4415,4405,-8,-18,75788,3338863760,175166
82,a1505,20150210,4415,4405,4403,4427,4398,4404,4411,-1,6,37656,1661164560,175410
83,a1505,20150211,4404,4411,4402,4413,4394,4406,4403,-5,-8,27402,1206588300,174202
84,a1505,20150212,4406,4403,4411,4431,4395,4412,4416,9,13,42358,1870620180,172010
85,a1505,20150213,4412,4416,4404,4433,4402,4409,4418,-7,2,55144,2436523200,166090
86,a1505,20150216,4409,4418,4414,4415,4356,4367,4377,-51,-41,86658,3793866460,151852
87,a1505,20150217,4367,4377,4361,4377,4361,4367,4369,-10,-8,24642,1076837680,149446
88,a1505,20150225,4367,4369,4381,4388,4284,4287,4321,-82,-48,72532,3134379160,153108
89,a1505,20150226,4287,4321,4286,4290,4230,4284,4268,-37,-53,122612,5233807500,162036
90,a1505,20150227,4284,4268,4285,4339,4251,4317,4302,49,34,107898,4642308580,155760
91,a1505,20150302,4317,4302,4322,4330,4265,4272,4292,-30,-10,102046,4380122820,172618
92,a1505,20150303,4272,4292,4253,4292,4250,4280,4275,-12,-17,86130,3682768900,170542
93,a1505,20150304,4280,4275,4273,4287,4263,4280,4274,5,-1,43144,1844343200,169030
94,a1505,20150305,4280,4274,4273,4279,4171,4179,4216,-95,-58,153078,6454254960,197828
95,a1505,20150306,4179,4216,4178,4194,4161,4172,4179,-44,-37,70410,2943059280,193814
96,a1505,20150309,4172,4179,4180,4218,4154,4193,4188,14,9,82488,3455033180,184668
97,a1505,20150310,4193,4188,4188,4205,4115,4119,4152,-69,-36,105646,4386803560,204018
98,a1505,20150311,4119,4152,4129,4200,4106,4184,4169,32,17,148358,6186247140,183226
99,a1505,20150312,4184,4169,4190,4190,4157,4170,4173,1,4,40778,1701917000,181136
100,a1505,20150313,4170,4173,4166,4185,4152,4154,4169,-19,-4,42586,1775554040,179448
101,a1505,20150316,4154,4169,4155,4183,4141,4180,4162,11,-7,47218,1965363800,175256
102,a1505,20150317,4180,4162,4177,4228,4166,4169,4192,7,30,67066,2811474940,172268
103,a1505,20150318,4169,4192,4161,4192,4161,4170,4173,-22,-19,70052,2923756800,168440
104,a1505,20150319,4170,4173,4181,4189,4151,4177,4173,4,0,72930,3043376420,163540
105,a1505,20150320,4177,4173,4175,4194,4148,4174,4168,1,-5,74576,3108439140,166846
106,a1505,20150323,4174,4168,4175,4197,4160,4164,4179,-4,11,55042,2300727440,174834
107,a1505,20150324,4164,4179,4166,4191,4111,4161,4151,-18,-28,134338,5576885080,173996
108,a1505,20150325,4161,4151,4161,4161,4070,4074,4109,-77,-42,139516,5733284520,180834
109,a1505,20150326,4074,4109,4074,4090,4004,4060,4044,-49,-65,219736,8887018760,187800
110,a1505,20150327,4060,4044,4053,4058,4027,4032,4043,-12,-1,71974,2910423160,184748
111,a1505,20150330,4032,4043,4031,4043,3985,4028,4005,-15,-38,100360,4019740540,186212
112,a1505,20150331,4028,4005,4020,4031,4008,4016,4019,11,14,45186,1816067140,177466
113,a1505,20150401,4016,4019,4010,4058,4005,4035,4034,16,15,103478,4174550680,167666
114,a1505,20150402,4035,4034,4020,4047,4019,4019,4033,-15,-1,44324,1787947400,160484
115,a1505,20150403,4019,4033,4001,4019,3959,3998,3995,-35,-38,97128,3880768920,153460
116,a1505,20150407,3998,3995,3982,4000,3952,3956,3973,-39,-22,34076,1354149220,154172
117,a1505,20150408,3956,3973,3972,3975,3941,3958,3956,-15,-17,48548,1920841320,151524
118,a1505,20150409,3958,3956,3959,3960,3940,3952,3951,-4,-5,35588,1406133600,147844
119,a1505,20150410,3952,3951,3956,3981,3951,3965,3962,14,11,24410,967263200,144604
120,a1505,20150413,3965,3962,3965,4046,3965,4030,4008,68,46,48098,1927857620,142920
121,a1505,20150414,4030,4008,4030,4165,4010,4161,4102,153,94,96274,3949450640,142612
122,a1505,20150415,4161,4102,4153,4248,4153,4220,4216,118,114,118376,4991010660,143104
123,a1505,20150416,4220,4216,4222,4261,4198,4210,4226,-6,10,72658,3070810920,139332
124,a1505,20150417,4210,4226,4206,4222,4057,4057,4148,-169,-78,84100,3488509640,123030
125,a1505,20150420,4057,4148,4010,4045,3900,3900,3962,-248,-186,70944,2811479200,116494
126,a1505,20150421,3900,3962,3848,3920,3830,3908,3877,-54,-85,73556,2852108680,101342
127,a1505,20150422,3908,3877,3908,4032,3902,4027,3962,150,85,73030,2894149080,59244
128,a1505,20150423,4027,3962,4030,4040,3978,4008,4001,46,39,28136,1125979920,50882
129,a1505,20150424,4008,4001,4016,4072,4005,4059,4035,58,34,23966,967191880,46486
130,a1505,20150427,4059,4035,4056,4120,4056,4098,4083,63,48,25410,1037553700,39640
131,a1505,20150428,4098,4083,4087,4102,4059,4084,4090,1,7,5160,211070640,36236
132,a1505,20150429,4084,4090,4078,4094,4077,4093,4083,3,-7,11722,478659660,31382
133,a1505,20150430,4093,4083,4099,4207,4093,4192,4160,109,77,4600,191405120,28408
134,a1505,20150504,4192,4160,4154,4200,4143,4143,4164,-17,4,1874,78033600,26516
135,a1505,20150505,4143,4164,4145,4185,4145,4185,4159,21,-5,558,23209420,25816
136,a1505,20150506,4185,4159,4140,4226,4140,4226,4151,67,-8,7698,319561920,25796
137,a1505,20150507,4226,4151,4160,4160,4151,4151,4156,0,5,4896,203503960,17236
138,a1505,20150508,4151,4156,4156,4170,4131,4160,4158,4,2,3376,140375300,11454
139,a1505,20150511,4160,4158,4151,4151,4151,4151,4151,-7,-7,10,415100,11464
140,a1505,20150512,4151,4151,4208,4222,4208,4222,4216,71,65,116,4891180,10904
141,a1505,20150513,4222,4216,4222,4281,4222,4281,4251,65,35,8,340120,9630
142,a1505,20150514,4281,4251,4250,4274,4250,4274,4250,23,-1,1342,57035960,5162
143,a1505,20150515,4274,4250,0,0,0,4162,4162,-88,-88,0,0,0
144,a1507,20150105,4455,4455,4450,4457,4450,4457,4451,2,-4,8,356140,20
145,a1507,20150106,4457,4451,4462,4462,4462,4462,4462,11,11,2,89240,18
146,a1507,20150107,4462,4462,4486,4486,4486,4486,4486,24,24,2,89720,20
147,a1507,20150108,4486,4486,4427,4467,4427,4440,4444,-46,-42,6,266680,18
148,a1507,20150109,4440,4444,4435,4460,4435,4460,4447,16,3,4,177900,16
149,a1507,20150112,4460,4447,4515,4515,4457,4466,4483,19,36,10,448320,20
150,a1507,20150113,4466,4483,4434,4482,4408,4435,4436,-48,-47,12,532360,22
151,a1507,20150114,4435,4436,0,0,0,4424,4424,-12,-12,0,0,22
152,a1507,20150115,4424,4424,0,0,0,4436,4436,12,12,0,0,22
153,a1507,20150116,4436,4436,0,0,0,4447,4447,11,11,0,0,22
154,a1507,20150119,4447,4447,4496,4503,4448,4448,4490,1,43,12,538840,24
155,a1507,20150120,4448,4490,4434,4476,4429,4476,4446,-14,-44,6,266780,20
156,a1507,20150121,4476,4446,4421,4421,4421,4421,4421,-25,-25,2,88420,20
157,a1507,20150122,4421,4421,0,0,0,4421,4421,0,0,0,0,20
158,a1507,20150123,4421,4421,0,0,0,4421,4421,0,0,0,0,20
159,a1507,20150126,4421,4421,0,0,0,4396,4396,-25,-25,0,0,20
160,a1507,20150127,4396,4396,0,0,0,4396,4396,0,0,0,0,20
161,a1507,20150128,4396,4396,0,0,0,4396,4396,0,0,0,0,20
162,a1507,20150129,4396,4396,4349,4349,4339,4339,4345,-57,-51,6,260740,20
163,a1507,20150130,4339,4345,0,0,0,4341,4341,-4,-4,0,0,20
164,a1507,20150202,4341,4341,0,0,0,4356,4356,15,15,0,0,20
165,a1507,20150203,4356,4356,0,0,0,4394,4394,38,38,0,0,20
166,a1507,20150204,4394,4394,4393,4393,4393,4393,4393,-1,-1,2,87860,18
167,a1507,20150205,4393,4393,4416,4416,4379,4388,4394,-5,1,6,263660,20
168,a1507,20150206,4388,4394,0,0,0,4410,4410,16,16,0,0,20
169,a1507,20150209,4410,4410,4353,4394,4301,4394,4349,-16,-61,6,260960,18
170,a1507,20150210,4394,4349,4380,4380,4380,4380,4380,31,31,4,175200,18
171,a1507,20150211,4380,4380,0,0,0,4380,4380,0,0,0,0,18
172,a1507,20150212,4380,4380,4388,4388,4388,4388,4388,8,8,2,87760,20
173,a1507,20150213,4388,4388,4383,4383,4383,4383,4383,-5,-5,2,87660,18
174,a1507,20150216,4383,4383,0,0,0,4343,4343,-40,-40,0,0,18
175,a1507,20150217,4343,4343,0,0,0,4336,4336,-7,-7,0,0,18
176,a1507,20150225,4336,4336,0,0,0,4289,4289,-47,-47,0,0,18
177,a1507,20150226,4289,4289,4290,4290,4276,4276,4285,-13,-4,6,257120,12
178,a1507,20150227,4276,4285,0,0,0,4319,4319,34,34,0,0,12
179,a1507,20150302,4319,4319,0,0,0,4309,4309,-10,-10,0,0,12
180,a1507,20150303,4309,4309,4298,4298,4298,4298,4298,-11,-11,2,85960,10
181,a1507,20150304,4298,4298,0,0,0,4298,4298,0,0,0,0,10
182,a1507,20150305,4298,4298,0,0,0,4248,4248,-50,-50,0,0,10
183,a1507,20150306,4248,4248,0,0,0,4240,4240,-8,-8,0,0,10
184,a1507,20150309,4240,4240,0,0,0,4249,4249,9,9,0,0,10
185,a1507,20150310,4249,4249,0,0,0,4213,4213,-36,-36,0,0,10
186,a1507,20150311,4213,4213,0,0,0,4230,4230,17,17,0,0,10
187,a1507,20150312,4230,4230,0,0,0,4234,4234,4,4,0,0,10
188,a1507,20150313,4234,4234,0,0,0,4224,4224,-10,-10,0,0,10
189,a1507,20150316,4224,4224,0,0,0,4224,4224,0,0,0,0,10
190,a1507,20150317,4224,4224,0,0,0,4254,4254,30,30,0,0,10
191,a1507,20150318,4254,4254,4159,4222,4159,4212,4197,-42,-57,6,251860,10
192,a1507,20150319,4212,4197,4228,4228,4228,4228,4228,31,31,2,84560,10
193,a1507,20150320,4228,4228,4218,4226,4207,4211,4216,-17,-12,24,1011940,10
194,a1507,20150323,4211,4216,4223,4223,4223,4223,4223,7,7,2,84460,8
195,a1507,20150324,4223,4223,0,0,0,4223,4223,0,0,0,0,8
196,a1507,20150325,4223,4223,4067,4148,4067,4098,4104,-125,-119,6,246260,8
197,a1507,20150326,4098,4104,0,0,0,4104,4104,0,0,0,0,8
198,a1507,20150327,4104,4104,4087,4087,4087,4087,4087,-17,-17,2,81740,10
199,a1507,20150330,4087,4087,0,0,0,4084,4084,-3,-3,0,0,10
200,a1507,20150331,4084,4084,0,0,0,4084,4084,0,0,0,0,10
201,a1507,20150401,4084,4084,0,0,0,4084,4084,0,0,0,0,10
202,a1507,20150402,4084,4084,0,0,0,4084,4084,0,0,0,0,10
203,a1507,20150403,4084,4084,3995,4059,3995,4041,4035,-43,-49,10,403540,8
204,a1507,20150407,4041,4035,4072,4072,4011,4052,4045,17,10,6,242700,10
205,a1507,20150408,4052,4045,0,0,0,4028,4028,-17,-17,0,0,10
206,a1507,20150409,4028,4028,3974,4036,3973,3979,3992,-49,-36,18,718600,10
207,a1507,20150410,3979,3992,4023,4023,4005,4005,4017,13,25,6,241020,10
208,a1507,20150413,4005,4017,3865,4042,3865,4026,3966,9,-51,10,396680,10
209,a1507,20150414,4026,3966,4053,4119,4048,4097,4079,131,113,28,1142160,12
210,a1507,20150415,4097,4079,4097,4141,4097,4118,4119,39,40,56,2307000,8
211,a1507,20150416,4118,4119,0,0,0,4128,4128,9,9,0,0,8
212,a1507,20150417,4128,4128,4115,4153,4097,4137,4124,9,-4,82,3381760,14
213,a1507,20150420,4137,4124,4036,4050,3960,4050,4029,-74,-95,42,1692420,42
214,a1507,20150421,4050,4029,3955,4019,3954,4014,3968,-15,-61,36,1428720,42
215,a1507,20150422,4014,3968,3888,4101,3888,4055,3994,87,26,90,3595060,28
216,a1507,20150423,4055,3994,4070,4070,4036,4036,4057,42,63,6,243420,28
217,a1507,20150424,4036,4057,4050,4121,4050,4078,4086,21,29,18,735580,26
218,a1507,20150427,4078,4086,4023,4143,4023,4143,4115,57,29,32,1316800,34
219,a1507,20150428,4143,4115,4131,4131,4131,4131,4131,16,16,16,660960,32
220,a1507,20150429,4131,4131,4179,4179,4128,4128,4153,-3,22,4,166140,30
221,a1507,20150430,4128,4153,4238,4280,4176,4280,4225,127,72,12,507000,30
222,a1507,20150504,4280,4225,4160,4230,4158,4215,4201,-10,-24,14,588260,24
223,a1507,20150505,4215,4201,4150,4150,4149,4149,4149,-52,-52,4,165980,26
224,a1507,20150506,4149,4149,4191,4228,4164,4194,4193,45,44,64,2684020,22
225,a1507,20150507,4194,4193,4189,4206,4189,4195,4193,2,0,30,1258100,14
226,a1507,20150508,4195,4193,4213,4213,4184,4184,4194,-9,1,6,251640,12
227,a1507,20150511,4184,4194,0,0,0,4187,4187,-7,-7,0,0,12
228,a1507,20150512,4187,4187,4319,4337,4240,4276,4281,89,94,22,941920,10
229,a1507,20150513,4276,4281,4344,4344,4273,4280,4298,-1,17,28,1203440,6
230,a1507,20150514,4280,4298,0,0,0,4297,4297,-1,-1,0,0,6
231,a1507,20150515,4297,4297,4261,4261,4261,4261,4261,-36,-36,2,85220,6
232,a1507,20150518,4261,4261,4294,4347,4253,4270,4289,9,28,14,600540,6
233,a1507,20150519,4270,4289,4337,4337,4214,4317,4274,28,-15,44,1880640,8
234,a1507,20150520,4317,4274,4240,4278,4170,4170,4229,-104,-45,6,253760,8
235,a1507,20150521,4170,4229,4225,4280,4184,4279,4257,50,28,22,936660,20
236,a1507,20150522,4279,4257,4268,4368,4267,4354,4303,97,46,24,1032800,10
237,a1507,20150525,4354,4303,4462,4462,4348,4359,4386,56,83,38,1666920,10
238,a1507,20150526,4359,4386,4420,4420,4318,4329,4357,-57,-29,10,435760,10
239,a1507,20150527,4329,4357,0,0,0,4357,4357,0,0,0,0,10
240,a1507,20150528,4357,4357,4417,4417,4325,4325,4361,-32,4,34,1482980,8
241,a1507,20150529,4325,4361,4347,4347,4293,4339,4313,-22,-48,10,431340,10
242,a1507,20150601,4339,4313,4375,4375,4375,4375,4375,62,62,2,87500,8
243,a1507,20150602,4375,4375,0,0,0,4375,4375,0,0,0,0,8
244,a1507,20150603,4375,4375,4282,4363,4257,4348,4320,-27,-55,10,432040,8
245,a1507,20150604,4348,4320,4284,4321,4205,4311,4265,-9,-55,24,1023640,8
246,a1507,20150605,4311,4265,4433,4433,4161,4161,4363,-104,98,8,349040,4
247,a1507,20150608,4161,4363,0,0,0,4363,4363,0,0,0,0,4
248,a1507,20150609,4363,4363,4537,4537,4189,4199,4261,-164,-102,60,2556600,16
249,a1507,20150610,4199,4261,4237,4267,4237,4267,4252,6,-9,8,340160,8
250,a1507,20150611,4267,4252,4248,4422,4167,4167,4286,-85,34,10,428660,4
251,a1507,20150612,4167,4286,4249,4457,4115,4115,4192,-171,-94,28,1174000,12
252,a1507,20150615,4115,4192,4350,4350,4081,4088,4163,-104,-29,20,832640,10
253,a1507,20150616,4088,4163,4245,4304,4073,4096,4179,-67,16,8,334360,10
254,a1507,20150617,4096,4179,0,0,0,4179,4179,0,0,0,0,10
255,a1507,20150618,4179,4179,0,0,0,4179,4179,0,0,0,0,10
256,a1507,20150619,4179,4179,4333,4333,4016,4016,4201,-163,22,12,504140,10
257,a1507,20150623,4016,4201,4300,4300,4037,4121,4145,-80,-56,22,912020,14
258,a1507,20150624,4121,4145,4285,4310,3980,4189,4174,44,29,26,1085420,20
259,a1507,20150625,4189,4174,4170,4250,4082,4134,4133,-40,-41,50,2066960,20
260,a1507,20150626,4134,4133,4130,4130,4070,4070,4106,-63,-27,50,2053000,22
261,a1507,20150629,4070,4106,4098,4098,4018,4020,4055,-86,-51,40,1622380,28
262,a1507,20150630,4020,4055,4035,4217,3893,3971,4075,-84,20,80,3260200,22
263,a1507,20150701,3971,4075,4245,4245,4245,4245,4245,170,170,2,84900,20
264,a1507,20150702,4245,4245,0,0,0,4220,4220,-25,-25,0,0,10
265,a1507,20150703,4220,4220,0,0,0,4180,4180,-40,-40,0,0,10
266,a1507,20150706,4180,4180,4020,4020,4020,4020,4020,-160,-160,2,80400,12
267,a1507,20150707,4020,4020,3980,3980,3980,3980,3980,-40,-40,2,79600,2
268,a1507,20150708,3980,3980,0,0,0,3980,3980,0,0,0,0,2
269,a1507,20150709,3980,3980,0,0,0,3980,3980,0,0,0,0,2
270,a1507,20150710,3980,3980,0,0,0,3980,3980,0,0,0,0,2
271,a1507,20150713,3980,3980,0,0,0,3980,3980,0,0,0,0,2
272,a1507,20150714,3980,3980,0,0,0,4081,4081,101,101,2,81620,0
273,a1509,20150105,4442,4442,4410,4435,4385,4433,4425,-9,-17,10920,483218560,67760
274,a1509,20150106,4433,4425,4437,4475,4427,4443,4450,18,25,20078,893547560,66150
275,a1509,20150107,4443,4450,4454,4465,4424,4441,4443,-9,-7,10520,467424800,65282
276,a1509,20150108,4441,4443,4444,4450,4428,4437,4440,-6,-3,12362,548978060,64012
277,a1509,20150109,4437,4440,4435,4457,4426,4439,4442,-1,2,15374,683039980,64318
278,a1509,20150112,4439,4442,4440,4460,4433,4438,4450,-4,8,9726,432816880,63566
279,a1509,20150113,4438,4450,4440,4440,4393,4410,4408,-40,-42,7722,340460400,64870
280,a1509,20150114,4410,4408,4385,4416,4381,4391,4398,-17,-10,11582,509475160,65246
281,a1509,20150115,4391,4398,4420,4424,4384,4417,4404,19,6,12020,529392280,65168
282,a1509,20150116,4417,4404,4418,4443,4396,4421,4416,17,12,13870,612501920,64896
283,a1509,20150119,4421,4416,4420,4440,4401,4418,4419,2,3,13120,579889000,66330
284,a1509,20150120,4418,4419,4420,4515,4390,4391,4412,-28,-7,12764,563193120,68568
285,a1509,20150121,4391,4412,4391,4414,4350,4380,4387,-32,-25,19256,844883600,67976
286,a1509,20150122,4380,4387,4380,4393,4361,4367,4374,-20,-13,12010,525396760,67638
287,a1509,20150123,4367,4374,4382,4382,4345,4349,4356,-25,-18,11154,485903420,67986
288,a1509,20150126,4349,4356,4344,4370,4317,4325,4340,-31,-16,15736,682974260,68610
289,a1509,20150127,4325,4340,4325,4380,4323,4364,4357,24,17,15976,696163100,65274
290,a1509,20150128,4364,4357,4359,4375,4343,4354,4361,-3,4,9574,417616420,65226
291,a1509,20150129,4354,4361,4345,4364,4308,4331,4325,-30,-36,30966,1339423120,67838
292,a1509,20150130,4331,4325,4326,4343,4318,4318,4331,-7,6,13986,605837680,65722
293,a1509,20150202,4318,4331,4330,4359,4321,4355,4340,24,9,20110,872888700,66306
294,a1509,20150203,4355,4340,4359,4386,4358,4383,4371,43,31,14102,616515260,64334
295,a1509,20150204,4383,4371,4321,4398,4321,4377,4384,6,13,11528,505408360,62034
296,a1509,20150205,4377,4384,4383,4383,4346,4371,4366,-13,-18,6406,279699440,61890
297,a1509,20150206,4371,4366,4373,4392,4369,4380,4379,14,13,6462,283004280,61058
298,a1509,20150209,4380,4379,4380,4385,4347,4369,4359,-10,-20,8782,382862120,61576
299,a1509,20150210,4369,4359,4364,4375,4344,4348,4356,-11,-3,5856,255140320,62594
300,a1509,20150211,4348,4356,4354,4363,4343,4363,4352,7,-4,4684,203872340,62106
301,a1509,20150212,4363,4352,4353,4378,4351,4364,4363,12,11,5864,255875940,61226
302,a1509,20150213,4364,4363,4365,4377,4360,4364,4369,1,6,12336,539023860,58636
303,a1509,20150216,4364,4369,4361,4373,4320,4327,4340,-42,-29,12644,548808060,58396
304,a1509,20150217,4327,4340,4328,4342,4321,4340,4331,0,-9,5664,245315560,58778
305,a1509,20150225,4340,4331,4349,4355,4289,4292,4315,-39,-16,16188,698540420,60446
306,a1509,20150226,4292,4315,4295,4298,4256,4288,4279,-27,-36,29290,1253446580,66524
307,a1509,20150227,4288,4279,4292,4335,4265,4319,4304,40,25,31448,1353654420,63746
308,a1509,20150302,4319,4304,4325,4342,4306,4325,4323,21,19,35860,1550557380,66934
309,a1509,20150303,4325,4323,4325,4332,4294,4318,4316,-5,-7,26386,1138826140,67488
310,a1509,20150304,4318,4316,4321,4325,4303,4317,4316,1,0,11090,478752040,66012
311,a1509,20150305,4317,4316,4304,4317,4236,4239,4263,-77,-53,51724,2205161640,80120
312,a1509,20150306,4239,4263,4235,4255,4225,4226,4239,-37,-24,28562,1210831980,83880
313,a1509,20150309,4226,4239,4225,4254,4210,4235,4233,-4,-6,34192,1447681780,82110
314,a1509,20150310,4235,4233,4233,4255,4180,4181,4212,-52,-21,50302,2118901680,98708
315,a1509,20150311,4181,4212,4188,4255,4171,4241,4223,29,11,57902,2445755880,85200
316,a1509,20150312,4241,4223,4241,4244,4221,4234,4233,11,10,18750,793726400,83262
317,a1509,20150313,4234,4233,4233,4247,4210,4215,4225,-18,-8,28712,1213126480,84978
318,a1509,20150316,4215,4225,4201,4236,4194,4231,4215,6,-10,32548,1372068960,82388
319,a1509,20150317,4231,4215,4238,4280,4224,4225,4248,10,33,28888,1227227400,82044
320,a1509,20150318,4225,4248,4220,4248,4213,4215,4227,-33,-21,29422,1243831220,84178
321,a1509,20150319,4215,4227,4221,4236,4203,4215,4220,-12,-7,32680,1379127620,89514
322,a1509,20150320,4215,4220,4202,4220,4191,4206,4205,-14,-15,34488,1450460240,94754
323,a1509,20150323,4206,4205,4206,4232,4200,4210,4219,5,14,32920,1388895160,94414
324,a1509,20150324,4210,4219,4214,4236,4147,4212,4195,-7,-24,102380,4295325360,99368
325,a1509,20150325,4212,4195,4203,4212,4143,4145,4172,-50,-23,69736,2909861600,111320
326,a1509,20150326,4145,4172,4135,4163,4122,4152,4142,-20,-30,91886,3806472260,121606
327,a1509,20150327,4152,4142,4138,4158,4132,4136,4143,-6,1,40228,1666859220,121064
328,a1509,20150330,4136,4143,4132,4141,4087,4134,4111,-9,-32,67804,2787685380,123730
329,a1509,20150331,4134,4111,4127,4136,4106,4110,4117,-1,6,38682,1592873060,122934
330,a1509,20150401,4110,4117,4105,4156,4104,4132,4134,15,17,50332,2081078000,119308
331,a1509,20150402,4132,4134,4139,4152,4102,4102,4126,-32,-8,47784,1971941840,124314
332,a1509,20150403,4102,4126,4092,4116,4050,4084,4081,-42,-45,69132,2821617380,133212
333,a1509,20150407,4084,4081,4078,4092,4041,4043,4058,-38,-23,46884,1902902000,147266
334,a1509,20150408,4043,4058,4020,4043,4011,4027,4026,-31,-32,69238,2787807700,154046
335,a1509,20150409,4027,4026,4030,4035,3991,3995,4009,-31,-17,72656,2913117920,161072
336,a1509,20150410,3995,4009,3992,4038,3992,4006,4010,-3,1,61318,2459252360,155070
337,a1509,20150413,4006,4010,4014,4057,4005,4048,4032,38,22,101382,4088592800,145654
338,a1509,20150414,4048,4032,4045,4096,4040,4085,4069,53,37,141336,5751788700,165560
339,a1509,20150415,4085,4069,4089,4131,4078,4098,4102,29,33,138756,5692921680,153606
340,a1509,20150416,4098,4102,4093,4118,4085,4092,4099,-10,-3,70984,2910241360,155802
341,a1509,20150417,4092,4099,4099,4099,4038,4040,4065,-59,-34,171152,6958920580,184052
342,a1509,20150420,4040,4065,4038,4059,3966,4000,4005,-65,-60,387608,15525899800,194694
343,a1509,20150421,4000,4005,3996,4069,3983,4060,4037,55,32,177818,7180137140,197532
344,a1509,20150422,4060,4037,4060,4181,4054,4160,4108,123,71,290722,11945633700,197214
345,a1509,20150423,4160,4108,4152,4179,4124,4154,4151,46,43,177206,7356350100,197462
346,a1509,20150424,4154,4151,4168,4218,4152,4217,4191,66,40,229592,9622915680,205414
347,a1509,20150427,4217,4191,4217,4250,4194,4226,4221,35,30,205434,8673090140,195272
348,a1509,20150428,4226,4221,4226,4235,4190,4220,4218,-1,-3,115740,4882635260,189742
349,a1509,20150429,4220,4218,4228,4238,4209,4225,4222,7,4,91586,3867487320,185758
350,a1509,20150430,4225,4222,4223,4335,4221,4320,4296,98,74,257472,11062435060,189604
351,a1509,20150504,4320,4296,4302,4308,4256,4272,4272,-24,-24,123328,5269786400,170686
352,a1509,20150505,4272,4272,4272,4296,4232,4272,4273,0,1,105224,4496442380,161102
353,a1509,20150506,4272,4273,4277,4331,4261,4306,4296,33,23,127526,5479352740,158448
354,a1509,20150507,4306,4296,4307,4315,4265,4293,4291,-3,-5,86592,3716475740,157760
355,a1509,20150508,4293,4291,4293,4298,4243,4280,4268,-11,-23,104380,4455877220,157466
356,a1509,20150511,4280,4268,4287,4365,4272,4362,4330,94,62,209584,9075482940,175828
357,a1509,20150512,4362,4330,4352,4386,4343,4361,4360,31,30,157564,6870039380,175470
358,a1509,20150513,4361,4360,4366,4377,4344,4367,4362,7,2,129932,5667963600,172936
359,a1509,20150514,4367,4362,4375,4382,4321,4359,4351,-3,-11,114750,4993419360,165500
360,a1509,20150515,4359,4351,4360,4374,4351,4362,4359,11,8,70112,3056848300,163424
361,a1509,20150518,4362,4359,4361,4369,4335,4358,4352,-1,-7,78180,3402702680,160410
362,a1509,20150519,4358,4352,4367,4367,4321,4322,4342,-30,-10,70084,3043075480,157178
363,a1509,20150520,4322,4342,4320,4329,4270,4295,4295,-47,-47,139968,6012170540,147242
364,a1509,20150521,4295,4295,4295,4328,4275,4295,4305,0,10,100330,4319777720,140030
365,a1509,20150522,4295,4305,4295,4475,4289,4447,4393,142,88,339348,14909064640,169896
366,a1509,20150525,4447,4393,4447,4463,4402,4416,4431,23,38,236628,10486847920,160274
367,a1509,20150526,4416,4431,4426,4450,4406,4415,4424,-16,-7,117050,5179161320,158210
368,a1509,20150527,4415,4424,4406,4424,4371,4388,4395,-36,-29,121044,5320807480,147186
369,a1509,20150528,4388,4395,4392,4440,4377,4393,4411,-2,16,137656,6072178420,145280
370,a1509,20150529,4393,4411,4400,4412,4372,4409,4390,-2,-21,83516,3666602720,142738
371,a1509,20150601,4409,4390,4412,4419,4308,4323,4370,-67,-20,129076,5641852420,140206
372,a1509,20150602,4323,4370,4325,4370,4321,4351,4344,-19,-26,87606,3805608560,132726
373,a1509,20150603,4351,4344,4359,4387,4349,4360,4366,16,22,77534,3385903160,130696
374,a1509,20150604,4360,4366,4357,4365,4302,4327,4329,-39,-37,90724,3928068500,124978
375,a1509,20150605,4327,4329,4322,4337,4252,4256,4293,-73,-36,92178,3957368000,122172
376,a1509,20150608,4256,4293,4251,4284,4240,4248,4263,-45,-30,76236,3250578880,119098
377,a1509,20150609,4248,4263,4251,4295,4244,4246,4272,-17,9,85082,3634933860,116982
378,a1509,20150610,4246,4272,4250,4272,4240,4262,4257,-10,-15,68302,2907873320,113828
379,a1509,20150611,4262,4257,4275,4284,4245,4256,4264,-1,7,61360,2616977080,114468
380,a1509,20150612,4256,4264,4245,4260,4147,4162,4190,-102,-74,169804,7115904760,98898
381,a1509,20150615,4162,4190,4176,4190,4141,4148,4165,-42,-25,72524,3021142780,90668
382,a1509,20150616,4148,4165,4145,4218,4135,4193,4184,28,19,93544,3914474660,75454
383,a1509,20150617,4193,4184,4195,4255,4164,4244,4221,60,37,98140,4143280160,71322
384,a1509,20150618,4244,4221,4238,4295,4236,4250,4263,29,42,101838,4341486940,65562
385,a1509,20150619,4250,4263,4250,4260,4206,4237,4231,-26,-32,75214,3183013520,66814
386,a1509,20150623,4237,4231,4250,4290,4249,4264,4265,33,34,58438,2492752600,70724
387,a1509,20150624,4264,4265,4252,4262,4208,4226,4230,-39,-35,77402,3274204120,68640
388,a1509,20150625,4226,4230,4233,4257,4207,4221,4229,-9,-1,55178,2333727580,67324
389,a1509,20150626,4221,4229,4233,4258,4182,4191,4225,-38,-4,94360,3986762560,64146
390,a1509,20150629,4191,4225,4212,4227,4151,4173,4178,-52,-47,87582,3660038220,62754
391,a1509,20150630,4173,4178,4173,4188,4130,4136,4153,-42,-25,64084,2661810760,57012
392,a1509,20150701,4136,4153,4137,4244,4106,4174,4179,21,26,112474,4700553500,61480
393,a1509,20150702,4174,4179,4174,4180,4138,4154,4155,-25,-24,51470,2138754000,51868
394,a1509,20150703,4154,4155,4151,4163,4125,4131,4146,-24,-9,52506,2177098500,55808
395,a1509,20150706,4131,4146,4140,4140,4057,4077,4096,-69,-50,68748,2816378480,52860
396,a1509,20150707,4077,4096,4093,4093,4040,4053,4060,-43,-36,54192,2200579740,50100
397,a1509,20150708,4053,4060,4053,4053,3898,3910,3943,-150,-117,134730,5312618600,41974
398,a1509,20150709,3910,3943,3923,4100,3910,4100,4032,157,89,109362,4410319660,36840
399,a1509,20150710,4100,4032,4116,4240,4115,4198,4196,166,164,146080,6130215400,42724
400,a1509,20150713,4198,4196,4220,4220,4146,4182,4178,-14,-18,50178,2096490400,40254
401,a1509,20150714,4182,4178,4178,4208,4155,4183,4186,5,8,37210,1557728120,38488
402,a1509,20150715,4183,4186,4175,4187,4126,4141,4158,-45,-28,19312,803068580,36806
403,a1509,20150716,4141,4158,4136,4150,4058,4113,4101,-45,-57,22898,939177540,35890
404,a1509,20150717,4113,4101,4121,4148,4083,4115,4114,14,13,20452,841437740,34758
405,a1509,20150720,4115,4114,4100,4122,4050,4062,4082,-52,-32,16966,692577720,32686
406,a1509,20150721,4062,4082,4060,4089,4052,4059,4071,-23,-11,7322,298082060,32996
407,a1509,20150722,4059,4071,4068,4068,4015,4047,4043,-24,-28,17424,704517780,35238
408,a1509,20150723,4047,4043,4020,4062,4003,4047,4032,4,-11,33856,1365157920,36908
409,a1509,20150724,4047,4032,4059,4080,4035,4061,4058,29,26,10754,436419240,34794
410,a1509,20150727,4061,4058,4055,4073,4019,4024,4044,-34,-14,9888,399921840,32894
411,a1509,20150728,4024,4044,4013,4064,3975,4064,4028,20,-16,13512,544340160,33614
412,a1509,20150729,4064,4028,4069,4131,4059,4129,4107,101,79,19030,781627040,30172
413,a1509,20150730,4129,4107,4124,4175,4115,4135,4148,28,41,22384,928519280,31190
414,a1509,20150731,4135,4148,4141,4162,4128,4155,4144,7,-4,8690,360188340,30908
415,a1509,20150803,4155,4144,4152,4167,4096,4130,4132,-14,-12,10050,415320080,30128
416,a1509,20150804,4130,4132,4127,4159,4110,4154,4140,22,8,8730,361491620,30334
417,a1509,20150805,4154,4140,4160,4166,4132,4144,4148,4,8,6628,274959480,30130
418,a1509,20150806,4144,4148,4155,4229,4145,4212,4189,64,41,25900,1085043260,24648
419,a1509,20150807,4212,4189,4210,4222,4173,4211,4195,22,6,10464,439019460,22834
420,a1509,20150810,4211,4195,4198,4255,4198,4233,4228,38,33,11202,473655420,21344
421,a1509,20150811,4233,4228,4207,4268,4207,4249,4251,21,23,9264,393825880,20352
422,a1509,20150812,4249,4251,4240,4266,4230,4262,4247,11,-4,5846,248280220,19240
423,a1509,20150813,4262,4247,4270,4295,4179,4230,4238,-17,-9,8540,361991660,18238
424,a1509,20150814,4230,4238,4228,4261,4220,4250,4239,12,1,3818,161878800,17636
425,a1509,20150817,4250,4239,4250,4278,4247,4261,4261,22,22,2670,113778480,17376
426,a1509,20150818,4261,4261,4274,4279,4202,4226,4241,-35,-20,3506,148722660,17572
427,a1509,20150819,4226,4241,4220,4224,4186,4199,4199,-42,-42,7202,302431740,17848
428,a1509,20150820,4199,4199,4210,4211,4150,4168,4176,-31,-23,2358,98490460,17168
429,a1509,20150821,4168,4176,4163,4197,4157,4167,4170,-9,-6,1600,66724000,16328
430,a1509,20150824,4167,4170,4162,4162,4069,4082,4104,-88,-66,6582,270163000,15236
431,a1509,20150825,4082,4104,4050,4129,4045,4095,4095,-9,-9,3824,156620020,12330
432,a1509,20150826,4095,4095,4159,4159,4085,4086,4112,-9,17,638,26236280,12254
433,a1509,20150827,4086,4112,4112,4112,4050,4091,4072,-21,-40,6430,261843640,11058
434,a1509,20150828,4091,4072,4090,4132,4050,4057,4079,-15,7,3192,130204180,9604
435,a1509,20150831,4057,4079,4057,4130,4046,4062,4063,-17,-16,2686,109141440,7594
436,a1509,20150901,4062,4063,4050,4073,4050,4059,4062,-4,-1,1014,41198280,560
437,a1509,20150902,4059,4062,4060,4060,4050,4050,4058,-12,-4,234,9497720,544
438,a1509,20150907,4050,4058,4029,4045,4008,4008,4032,-50,-26,20,806400,554
439,a1509,20150908,4008,4032,3996,4012,3995,4012,3996,-20,-36,46,1838360,570
440,a1509,20150909,4012,3996,4014,4014,4014,4014,4014,18,18,58,2328580,558
441,a1509,20150910,4014,4014,4016,4028,4006,4012,4015,-2,1,288,11566020,518
442,a1509,20150911,4012,4015,0,0,0,4038,4038,23,23,0,0,518
443,a1509,20150914,4038,4038,0,0,0,4027,4027,-11,-11,0,0,518
444,a1509,20150915,4027,4027,0,0,0,4022,4022,-5,-5,0,0,518
445,a1509,20150916,4022,4022,0,0,0,4050,4050,28,28,0,0,0
446,a1511,20150105,4422,4422,4390,4405,4390,4405,4395,-17,-27,6,263700,128
447,a1511,20150106,4405,4395,0,0,0,4395,4395,0,0,0,0,128
448,a1511,20150107,4395,4395,4450,4450,4399,4399,4416,4,21,8,353280,128
449,a1511,20150108,4399,4416,0,0,0,4414,4414,-2,-2,0,0,128
450,a1511,20150109,4414,4414,0,0,0,4415,4415,1,1,0,0,128
451,a1511,20150112,4415,4415,4423,4424,4376,4401,4402,-14,-13,28,1232720,128
452,a1511,20150113,4401,4402,0,0,0,4398,4398,-4,-4,0,0,128
453,a1511,20150114,4398,4398,0,0,0,4385,4385,-13,-13,0,0,128
454,a1511,20150115,4385,4385,0,0,0,4385,4385,0,0,0,0,128
455,a1511,20150116,4385,4385,4378,4380,4377,4377,4378,-8,-7,16,700560,130
456,a1511,20150119,4377,4378,4400,4400,4364,4364,4382,-14,4,4,175280,130
457,a1511,20150120,4364,4382,4360,4360,4359,4359,4359,-23,-23,8,348760,130
458,a1511,20150121,4359,4359,4306,4330,4303,4312,4310,-47,-49,18,775840,128
459,a1511,20150122,4312,4310,0,0,0,4298,4298,-12,-12,0,0,128
460,a1511,20150123,4298,4298,0,0,0,4281,4281,-17,-17,0,0,128
461,a1511,20150126,4281,4281,4286,4286,4214,4252,4250,-29,-31,10,425060,128
462,a1511,20150127,4252,4250,0,0,0,4271,4271,21,21,0,0,128
463,a1511,20150128,4271,4271,4280,4280,4280,4280,4280,9,9,2,85600,128
464,a1511,20150129,4280,4280,4200,4264,4200,4264,4250,-16,-30,12,510080,128
465,a1511,20150130,4264,4250,4264,4264,4264,4264,4264,14,14,2,85280,128
466,a1511,20150202,4264,4264,0,0,0,4264,4264,0,0,0,0,128
467,a1511,20150203,4264,4264,0,0,0,4309,4309,45,45,0,0,128
468,a1511,20150204,4309,4309,4317,4321,4317,4318,4318,9,9,8,345500,128
469,a1511,20150205,4318,4318,0,0,0,4300,4300,-18,-18,0,0,128
470,a1511,20150206,4300,4300,4316,4321,4308,4321,4313,21,13,26,1121420,134
471,a1511,20150209,4321,4313,0,0,0,4313,4313,0,0,0,0,134
472,a1511,20150210,4313,4313,4307,4308,4300,4308,4302,-5,-11,16,688420,134
473,a1511,20150211,4308,4302,0,0,0,4302,4302,0,0,0,0,134
474,a1511,20150212,4302,4302,4299,4299,4287,4295,4293,-7,-9,6,257620,132
475,a1511,20150213,4295,4293,4296,4296,4292,4292,4295,-1,2,8,343600,130
476,a1511,20150216,4292,4295,4295,4298,4288,4288,4292,-7,-3,8,343380,128
477,a1511,20150217,4288,4292,4267,4268,4237,4268,4259,-24,-33,16,681540,128
478,a1511,20150225,4268,4259,4249,4249,4249,4249,4249,-10,-10,2,84980,128
479,a1511,20150226,4249,4249,4204,4251,4201,4246,4224,-3,-25,32,1351780,134
480,a1511,20150227,4246,4224,4257,4281,4252,4252,4262,28,38,8,341000,132
481,a1511,20150302,4252,4262,4296,4308,4279,4308,4291,46,29,64,2746840,134
482,a1511,20150303,4308,4291,4269,4283,4269,4283,4272,-8,-19,8,341800,134
483,a1511,20150304,4283,4272,4317,4317,4303,4303,4310,31,38,4,172400,136
484,a1511,20150305,4303,4310,4268,4268,4201,4259,4242,-51,-68,16,678720,134
485,a1511,20150306,4259,4242,4231,4248,4231,4248,4239,6,-3,4,169580,134
486,a1511,20150309,4248,4239,4256,4256,4256,4256,4256,17,17,2,85120,134
487,a1511,20150310,4256,4256,4264,4264,4239,4239,4243,-17,-13,22,933600,136
488,a1511,20150311,4239,4243,4285,4324,4266,4266,4289,23,46,14,600540,128
489,a1511,20150312,4266,4289,0,0,0,4299,4299,10,10,0,0,128
490,a1511,20150313,4299,4299,4293,4293,4269,4269,4281,-30,-18,12,513720,126
491,a1511,20150316,4269,4281,0,0,0,4281,4281,0,0,0,0,126
492,a1511,20150317,4281,4281,4286,4286,4285,4285,4285,4,4,12,514280,122
493,a1511,20150318,4285,4285,0,0,0,4285,4285,0,0,0,0,122
494,a1511,20150319,4285,4285,0,0,0,4285,4285,0,0,0,0,122
495,a1511,20150320,4285,4285,0,0,0,4255,4255,-30,-30,0,0,122
496,a1511,20150323,4255,4255,4263,4277,4262,4277,4267,22,12,6,256040,126
497,a1511,20150324,4277,4267,4258,4258,4258,4258,4258,-9,-9,2,85160,124
498,a1511,20150325,4258,4258,4256,4256,4256,4256,4256,-2,-2,2,85120,126
499,a1511,20150326,4256,4256,4228,4228,4188,4220,4204,-36,-52,20,840940,132
500,a1511,20150327,4220,4204,0,0,0,4205,4205,1,1,0,0,132
501,a1511,20150330,4205,4205,4244,4244,4172,4235,4209,30,4,12,505080,134
502,a1511,20150331,4235,4209,0,0,0,4215,4215,6,6,0,0,134
503,a1511,20150401,4215,4215,4232,4283,4227,4245,4251,30,36,16,680220,134
504,a1511,20150402,4245,4251,4240,4240,4239,4239,4239,-12,-12,28,1187160,160
505,a1511,20150403,4239,4239,4144,4158,4144,4158,4151,-81,-88,4,166040,160
506,a1511,20150407,4158,4151,4194,4194,4130,4130,4147,-21,-4,14,580680,152
507,a1511,20150408,4130,4147,4119,4119,4073,4080,4091,-67,-56,50,2045500,144
508,a1511,20150409,4080,4091,0,0,0,4058,4058,-33,-33,0,0,144
509,a1511,20150410,4058,4058,4025,4062,4025,4062,4044,4,-14,30,1213260,128
510,a1511,20150413,4062,4044,0,0,0,4087,4087,43,43,0,0,128
511,a1511,20150414,4087,4087,4111,4135,4111,4135,4129,48,42,10,412960,130
512,a1511,20150415,4135,4129,4113,4180,4113,4151,4139,22,10,36,1490340,132
513,a1511,20150416,4151,4139,0,0,0,4136,4136,-3,-3,0,0,132
514,a1511,20150417,4136,4136,4118,4149,4076,4148,4120,12,-16,16,659220,136
515,a1511,20150420,4148,4120,4077,4085,4030,4085,4069,-35,-51,14,569680,134
516,a1511,20150421,4085,4069,0,0,0,4101,4101,32,32,0,0,134
517,a1511,20150422,4101,4101,4167,4264,4167,4264,4198,163,97,34,1427500,156
518,a1511,20150423,4264,4198,4249,4249,4093,4207,4175,9,-23,60,2505080,134
519,a1511,20150424,4207,4175,4215,4250,4215,4218,4234,43,59,34,1439840,124
520,a1511,20150427,4218,4234,4230,4248,4230,4248,4239,14,5,4,169560,122
521,a1511,20150428,4248,4239,0,0,0,4236,4236,-3,-3,0,0,122
522,a1511,20150429,4236,4236,4253,4259,4204,4251,4238,15,2,26,1102020,128
523,a1511,20150430,4251,4238,4297,4347,4294,4347,4311,109,73,22,948620,134
524,a1511,20150504,4347,4311,4290,4298,4290,4296,4294,-15,-17,24,1030760,158
525,a1511,20150505,4296,4294,4320,4323,4301,4320,4318,26,24,24,1036420,174
526,a1511,20150506,4320,4318,4310,4346,4310,4346,4328,28,10,6,259700,172
527,a1511,20150507,4346,4328,4312,4330,4311,4330,4317,2,-11,56,2417700,126
528,a1511,20150508,4330,4317,4312,4312,4305,4305,4308,-12,-9,4,172340,124
529,a1511,20150511,4305,4308,4316,4383,4305,4383,4339,75,31,46,1996000,120
530,a1511,20150512,4383,4339,4379,4419,4364,4400,4391,61,52,26,1141840,120
531,a1511,20150513,4400,4391,4410,4410,4400,4400,4407,9,16,8,352600,122
532,a1511,20150514,4400,4407,4414,4429,4385,4394,4405,-13,-2,78,3436100,120
533,a1511,20150515,4394,4405,4398,4400,4398,4400,4398,-5,-7,6,263920,120
534,a1511,20150518,4400,4398,4393,4393,4393,4393,4393,-5,-5,2,87860,122
535,a1511,20150519,4393,4393,0,0,0,4383,4383,-10,-10,0,0,122
536,a1511,20150520,4383,4383,4361,4365,4353,4353,4359,-30,-24,6,261580,124
537,a1511,20150521,4353,4359,0,0,0,4369,4369,10,10,0,0,124
538,a1511,20150522,4369,4369,0,0,0,4458,4458,89,89,0,0,124
539,a1511,20150525,4458,4458,4451,4496,4451,4496,4476,38,18,6,268600,124
540,a1511,20150526,4496,4476,4489,4490,4450,4454,4472,-22,-4,12,536720,120
541,a1511,20150527,4454,4472,0,0,0,4443,4443,-29,-29,0,0,120
542,a1511,20150528,4443,4443,0,0,0,4459,4459,16,16,0,0,120
543,a1511,20150529,4459,4459,0,0,0,4438,4438,-21,-21,0,0,120
544,a1511,20150601,4438,4438,0,0,0,4418,4418,-20,-20,0,0,120
545,a1511,20150602,4418,4418,0,0,0,4392,4392,-26,-26,0,0,120
546,a1511,20150603,4392,4392,4408,4408,4408,4408,4408,16,16,2,88160,122
547,a1511,20150604,4408,4408,0,0,0,4371,4371,-37,-37,0,0,122
548,a1511,20150605,4371,4371,4403,4403,4340,4340,4373,-31,2,8,349900,122
549,a1511,20150608,4340,4373,0,0,0,4343,4343,-30,-30,0,0,122
550,a1511,20150609,4343,4343,4308,4317,4296,4300,4305,-43,-38,26,1119480,128
551,a1511,20150610,4300,4305,4303,4310,4253,4268,4291,-37,-14,48,2059780,122
552,a1511,20150611,4268,4291,0,0,0,4298,4298,7,7,0,0,122
553,a1511,20150612,4298,4298,4235,4262,4182,4182,4237,-116,-61,20,847460,116
554,a1511,20150615,4182,4237,4201,4201,4201,4201,4201,-36,-36,2,84020,114
555,a1511,20150616,4201,4201,4164,4203,4164,4203,4189,2,-12,6,251360,118
556,a1511,20150617,4203,4189,4228,4243,4228,4243,4230,54,41,16,676800,118
557,a1511,20150618,4243,4230,4254,4254,4235,4254,4247,24,17,6,254860,118
558,a1511,20150619,4254,4247,4219,4219,4181,4211,4204,-36,-43,16,672680,118
559,a1511,20150623,4211,4204,4311,4311,4251,4251,4271,47,67,6,256260,120
560,a1511,20150624,4251,4271,4221,4221,4221,4221,4221,-50,-50,2,84420,118
561,a1511,20150625,4221,4221,4176,4251,4176,4222,4211,1,-10,12,505400,118
562,a1511,20150626,4222,4211,4199,4257,4199,4209,4221,-2,10,6,253300,120
563,a1511,20150629,4209,4221,4159,4210,4159,4210,4189,-11,-32,6,251360,120
564,a1511,20150630,4210,4189,4199,4199,4110,4135,4149,-54,-40,22,912900,118
565,a1511,20150701,4135,4149,4111,4221,4111,4178,4161,29,12,22,915560,120
566,a1511,20150702,4178,4161,4280,4280,4112,4154,4150,-7,-11,20,830100,120
567,a1511,20150703,4154,4150,4148,4170,4127,4140,4150,-10,0,26,1079180,118
568,a1511,20150706,4140,4150,4110,4124,4060,4078,4094,-72,-56,60,2456760,116
569,a1511,20150707,4078,4094,4068,4072,4053,4053,4063,-41,-31,12,487600,112
570,a1511,20150708,4053,4063,3972,3972,3901,3917,3935,-146,-128,28,1101840,112
571,a1511,20150709,3917,3935,3979,4092,3969,4058,4044,123,109,126,5096660,128
572,a1511,20150710,4058,4044,4099,4196,4041,4153,4132,109,88,196,8098840,136
573,a1511,20150713,4153,4132,4167,4168,4082,4162,4162,30,30,134,5577680,176
574,a1511,20150714,4162,4162,4154,4197,4154,4180,4168,18,6,28,1167220,174
575,a1511,20150715,4180,4168,4150,4168,4147,4148,4150,-20,-18,18,747060,180
576,a1511,20150716,4148,4150,4107,4126,4060,4126,4091,-24,-59,16,654680,174
577,a1511,20150717,4126,4091,4138,4139,4070,4113,4110,22,19,32,1315420,164
578,a1511,20150720,4113,4110,4096,4115,4072,4080,4095,-30,-15,14,573320,158
579,a1511,20150721,4080,4095,4110,4110,4051,4051,4080,-44,-15,4,163220,158
580,a1511,20150722,4051,4080,4063,4076,4026,4051,4056,-29,-24,12,486740,152
581,a1511,20150723,4051,4056,0,0,0,4056,4056,0,0,0,0,152
582,a1511,20150724,4056,4056,4066,4110,4066,4075,4087,19,31,26,1062620,154
583,a1511,20150727,4075,4087,4104,4112,4023,4062,4069,-25,-18,62,2523020,150
584,a1511,20150728,4062,4069,4085,4090,4082,4090,4085,21,16,22,898900,130
585,a1511,20150729,4090,4085,4137,4178,4137,4169,4166,84,81,14,583340,120
586,a1511,20150730,4169,4166,4244,4245,4168,4212,4212,46,46,100,4212420,122
587,a1511,20150731,4212,4212,4213,4221,4213,4221,4219,9,7,10,421940,116
588,a1511,20150803,4221,4219,4186,4229,4186,4202,4208,-17,-11,12,505020,118
589,a1511,20150804,4202,4208,0,0,0,4208,4208,0,0,0,0,118
590,a1511,20150805,4208,4208,0,0,0,4208,4208,0,0,0,0,118
591,a1511,20150806,4208,4208,4160,4289,4160,4242,4224,34,16,62,2619280,116
592,a1511,20150807,4242,4224,4246,4252,4215,4215,4240,-9,16,20,848080,116
593,a1511,20150810,4215,4240,4240,4297,4211,4274,4247,34,7,146,6201980,116
594,a1511,20150811,4274,4247,4292,4320,4265,4300,4297,53,50,54,2320760,118
595,a1511,20150812,4300,4297,4294,4299,4271,4299,4289,2,-8,14,600540,120
596,a1511,20150813,4299,4289,4302,4335,4213,4256,4281,-33,-8,20,856360,122
597,a1511,20150814,4256,4281,4257,4330,4243,4281,4275,0,-6,44,1881320,120
598,a1511,20150817,4281,4275,0,0,0,4297,4297,22,22,0,0,120
599,a1511,20150818,4297,4297,4299,4299,4294,4294,4296,-3,-1,4,171860,120
600,a1511,20150819,4294,4296,4212,4276,4212,4267,4244,-29,-52,16,679060,120
601,a1511,20150820,4267,4244,4182,4182,4182,4182,4182,-62,-62,2,83640,122
602,a1511,20150821,4182,4182,4235,4235,4200,4205,4213,23,31,14,589920,122
603,a1511,20150824,4205,4213,4190,4190,4190,4190,4190,-23,-23,4,167600,120
604,a1511,20150825,4190,4190,4258,4258,4123,4123,4179,-67,-11,10,417900,122
605,a1511,20150826,4123,4179,4241,4241,4175,4176,4208,-3,29,12,505000,122
606,a1511,20150827,4176,4208,4158,4158,4158,4158,4158,-50,-50,2,83160,120
607,a1511,20150828,4158,4158,4169,4169,4111,4140,4145,-18,-13,10,414560,118
608,a1511,20150831,4140,4145,4103,4147,4103,4147,4122,2,-23,8,329780,116
609,a1511,20150901,4147,4122,0,0,0,4148,4148,26,26,0,0,116
610,a1511,20150902,4148,4148,0,0,0,4148,4148,0,0,0,0,116
611,a1511,20150907,4148,4148,4056,4150,4056,4088,4105,-60,-43,12,492640,114
612,a1511,20150908,4088,4105,4057,4057,4050,4050,4053,-55,-52,4,162140,114
613,a1511,20150909,4050,4053,4169,4169,4022,4145,4091,92,38,14,572740,114
614,a1511,20150910,4145,4091,4057,4099,4057,4099,4078,8,-13,4,163120,114
615,a1511,20150911,4099,4078,4089,4089,4089,4089,4089,11,11,2,81780,114
616,a1511,20150914,4089,4089,4156,4174,4042,4065,4082,-24,-7,84,3429180,118
617,a1511,20150915,4065,4082,4133,4133,4061,4066,4096,-16,14,28,1146980,114
618,a1511,20150916,4066,4096,0,0,0,4096,4096,0,0,0,0,114
619,a1511,20150917,4096,4096,4123,4123,4056,4059,4080,-37,-16,20,816020,116
620,a1511,20150918,4059,4080,4068,4070,4068,4070,4069,-10,-11,4,162760,116
621,a1511,20150921,4070,4069,4052,4080,3972,4006,4012,-63,-57,44,1765360,118
622,a1511,20150922,4006,4012,3976,4059,3976,4059,4028,47,16,12,483400,112
623,a1511,20150923,4059,4028,4001,4062,3970,3970,4003,-58,-25,28,1120860,106
624,a1511,20150924,3970,4003,3990,4024,3875,3981,3968,-22,-35,12,476180,108
625,a1511,20150925,3981,3968,3939,3959,3938,3954,3950,-14,-18,12,474080,106
626,a1511,20150928,3954,3950,3908,3959,3908,3932,3933,-18,-17,6,235980,106
627,a1511,20150929,3932,3933,4008,4008,3931,3984,3958,51,25,16,633360,106
628,a1511,20150930,3984,3958,3984,4129,3984,3984,4008,26,50,22,881960,106
629,a1511,20151008,3984,4008,3901,3951,3806,3806,3885,-202,-123,20,777000,110
630,a1511,20151009,3806,3885,3806,3850,3775,3796,3804,-89,-81,48,1826040,108
631,a1511,20151012,3796,3804,3794,3862,3792,3854,3816,50,12,56,2137340,108
632,a1511,20151013,3854,3816,3829,3859,3827,3859,3843,43,27,36,1383600,110
633,a1511,20151014,3859,3843,3881,3930,3875,3900,3903,57,60,36,1405280,108
634,a1511,20151015,3900,3903,0,0,0,3903,3903,0,0,0,0,108
635,a1511,20151016,3903,3903,3940,3962,3851,3874,3904,-29,1,20,780860,112
636,a1511,20151019,3874,3904,3819,3880,3819,3823,3850,-81,-54,8,308040,110
637,a1511,20151020,3823,3850,3811,3940,3811,3818,3857,-32,7,34,1311440,114
638,a1511,20151021,3818,3857,3818,3930,3818,3839,3875,-18,18,42,1627760,114
639,a1511,20151022,3839,3875,3839,3902,3839,3902,3870,27,-5,4,154820,112
640,a1511,20151023,3902,3870,3868,3935,3856,3879,3894,9,24,42,1635820,112
641,a1511,20151026,3879,3894,3876,3897,3825,3825,3868,-69,-26,72,2785440,112
642,a1511,20151027,3825,3868,3800,3826,3780,3780,3800,-88,-68,42,1596120,112
643,a1511,20151028,3780,3800,3781,3781,3780,3780,3780,-20,-20,4,151220,112
644,a1511,20151029,3780,3780,3768,3800,3768,3800,3791,20,11,8,303300,114
645,a1511,20151030,3800,3791,3802,3880,3755,3770,3846,-21,55,224,8616880,40
646,a1511,20151102,3770,3846,0,0,0,3846,3846,0,0,0,0,0
647,a1511,20151103,3846,3846,0,0,0,3846,3846,0,0,0,0,0
648,a1511,20151104,3846,3846,0,0,0,3846,3846,0,0,0,0,0
649,a1511,20151105,3846,3846,0,0,0,3846,3846,0,0,0,0,0
650,a1511,20151106,3846,3846,0,0,0,3846,3846,0,0,0,0,0
651,a1511,20151109,3846,3846,0,0,0,3846,3846,0,0,0,0,0
652,a1511,20151110,3846,3846,0,0,0,3846,3846,0,0,0,0,0
653,a1511,20151111,3846,3846,0,0,0,3846,3846,0,0,0,0,0
654,a1511,20151112,3846,3846,0,0,0,3846,3846,0,0,0,0,0
655,a1511,20151113,3846,3846,0,0,0,3846,3846,0,0,0,0,0
656,a1601,20150105,4440,4442,4401,4435,4390,4435,4424,-7,-18,290,12830280,13664
657,a1601,20150106,4435,4424,4439,4475,4436,4444,4449,20,25,1010,44934900,13744
658,a1601,20150107,4444,4449,4451,4455,4432,4443,4443,-6,-6,398,17686140,13750
659,a1601,20150108,4443,4443,4451,4451,4432,4440,4438,-3,-5,658,29206760,13772
660,a1601,20150109,4440,4438,4436,4453,4431,4435,4439,-3,1,230,10211400,13730
661,a1601,20150112,4435,4439,4450,4455,4432,4439,4444,0,5,188,8355460,13744
662,a1601,20150113,4439,4444,4421,4430,4397,4409,4408,-35,-36,310,13667440,13786
663,a1601,20150114,4409,4408,4399,4417,4389,4393,4402,-15,-6,788,34687840,13802
664,a1601,20150115,4393,4402,4400,4415,4384,4415,4399,13,-3,1534,67489200,12982
665,a1601,20150116,4415,4399,4417,4427,4393,4410,4406,11,7,334,14716800,12956
666,a1601,20150119,4410,4406,4417,4418,4376,4392,4398,-14,-8,862,37912720,13216
667,a1601,20150120,4392,4398,4400,4400,4351,4353,4359,-45,-39,2704,117893580,15084
668,a1601,20150121,4353,4359,4331,4366,4313,4340,4346,-19,-13,1658,72068700,14780
669,a1601,20150122,4340,4346,4340,4350,4318,4321,4327,-25,-19,596,25792860,15108
670,a1601,20150123,4321,4327,4325,4325,4304,4309,4315,-18,-12,358,15450080,15114
671,a1601,20150126,4309,4315,4315,4325,4290,4295,4305,-20,-10,2100,90423680,16670
672,a1601,20150127,4295,4305,4295,4337,4295,4322,4317,17,12,274,11831100,16684
673,a1601,20150128,4322,4317,4316,4329,4311,4326,4322,9,5,232,10027800,16720
674,a1601,20150129,4326,4322,4324,4331,4278,4320,4299,-2,-23,3178,136633220,18786
675,a1601,20150130,4320,4299,4320,4337,4316,4320,4325,21,26,1150,49743760,18730
676,a1601,20150202,4320,4325,4317,4349,4311,4348,4325,23,0,1436,62112960,18606
677,a1601,20150203,4348,4325,4352,4372,4345,4359,4357,34,32,964,42002740,18086
678,a1601,20150204,4359,4357,4362,4382,4358,4358,4371,1,14,166,7255860,18050
679,a1601,20150205,4358,4371,4354,4376,4337,4346,4348,-25,-23,1180,51314300,18202
680,a1601,20150206,4346,4348,4346,4366,4346,4361,4359,13,11,186,8108480,18128
681,a1601,20150209,4361,4359,4387,4387,4337,4353,4345,-6,-14,266,11558580,18134
682,a1601,20150210,4353,4345,4350,4354,4333,4333,4340,-12,-5,218,9462960,18066
683,a1601,20150211,4333,4340,4331,4345,4331,4338,4337,-2,-3,140,6071920,18046
684,a1601,20150212,4338,4337,4340,4355,4332,4349,4346,12,9,730,31726880,17592
685,a1601,20150213,4349,4346,4348,4398,4345,4380,4382,34,36,1590,69683100,16938
686,a1601,20150216,4380,4382,4375,4389,4342,4348,4358,-34,-24,688,29983160,16710
687,a1601,20150217,4348,4358,4348,4358,4341,4358,4349,0,-9,352,15310700,16490
688,a1601,20150225,4358,4349,4365,4365,4320,4320,4333,-29,-16,934,40479360,16870
689,a1601,20150226,4320,4333,4343,4343,4291,4317,4302,-16,-31,1692,72802980,17822
690,a1601,20150227,4317,4302,4330,4353,4297,4345,4315,43,13,1552,66976780,18102
691,a1601,20150302,4345,4315,4320,4357,4320,4355,4345,40,30,958,41632200,18016
692,a1601,20150303,4355,4345,4357,4365,4336,4347,4348,2,3,2060,89580040,17544
693,a1601,20150304,4347,4348,4355,4355,4338,4346,4345,-2,-3,332,14428500,17566
694,a1601,20150305,4346,4345,4345,4345,4281,4291,4301,-54,-44,3316,142636800,19024
695,a1601,20150306,4291,4301,4300,4306,4283,4283,4293,-18,-8,992,42590040,19168
696,a1601,20150309,4283,4293,4281,4313,4280,4288,4288,-5,-5,2076,89034520,19582
697,a1601,20150310,4288,4288,4293,4302,4248,4252,4268,-36,-20,4886,208549800,23314
698,a1601,20150311,4252,4268,4252,4314,4235,4296,4276,28,8,5362,229314720,24026
699,a1601,20150312,4296,4276,4293,4300,4277,4290,4286,14,10,1580,67728680,23856
700,a1601,20150313,4290,4286,4268,4297,4266,4273,4283,-13,-3,1066,45659180,23690
701,a1601,20150316,4273,4283,4273,4285,4255,4279,4271,-4,-12,1082,46222780,23740
702,a1601,20150317,4279,4271,4286,4327,4276,4276,4296,5,25,802,34455960,23788
703,a1601,20150318,4276,4296,4276,4295,4265,4265,4273,-31,-23,826,35299040,23744
704,a1601,20150319,4265,4273,4276,4283,4255,4267,4269,-6,-4,778,33214300,23726
705,a1601,20150320,4267,4269,4264,4270,4251,4256,4256,-13,-13,3212,136714400,25200
706,a1601,20150323,4256,4256,4251,4275,4251,4262,4269,6,13,2306,98454760,24984
707,a1601,20150324,4262,4269,4258,4284,4208,4269,4254,0,-15,6632,282176280,25350
708,a1601,20150325,4269,4254,4268,4268,4214,4214,4233,-40,-21,6596,279260200,29206
709,a1601,20150326,4214,4233,4211,4234,4202,4225,4218,-8,-15,16930,714185200,39440
710,a1601,20150327,4225,4218,4220,4230,4213,4220,4219,2,1,4660,196636960,41292
711,a1601,20150330,4220,4219,4210,4221,4179,4220,4197,1,-22,10754,451426520,43226
712,a1601,20150331,4220,4197,4220,4221,4190,4191,4204,-6,7,1784,75005180,43280
713,a1601,20150401,4191,4204,4188,4231,4188,4210,4212,6,8,3988,168002660,42406
714,a1601,20150402,4210,4212,4212,4228,4192,4192,4209,-20,-3,4550,191554400,44986
715,a1601,20150403,4192,4209,4191,4191,4149,4157,4159,-52,-50,8092,336610940,47632
716,a1601,20150407,4157,4159,4155,4164,4121,4122,4140,-37,-19,5150,213253200,50678
717,a1601,20150408,4122,4140,4102,4123,4082,4103,4101,-37,-39,5646,231593480,50758
718,a1601,20150409,4103,4101,4098,4106,4062,4069,4076,-32,-25,5344,217864820,52028
719,a1601,20150410,4069,4076,4068,4105,4062,4069,4075,-7,-1,2592,105630860,52142
720,a1601,20150413,4069,4075,4078,4143,4071,4129,4112,54,37,11296,464507300,53742
721,a1601,20150414,4129,4112,4117,4171,4111,4163,4152,51,40,17890,742866960,53046
722,a1601,20150415,4163,4152,4163,4189,4160,4167,4177,15,25,17556,733406860,51118
723,a1601,20150416,4167,4177,4166,4182,4156,4164,4165,-13,-12,7716,321447460,51646
724,a1601,20150417,4164,4165,4165,4165,4112,4115,4135,-50,-30,6928,286506860,50300
725,a1601,20150420,4115,4135,4107,4131,4048,4083,4084,-52,-51,15178,619995500,51528
726,a1601,20150421,4083,4084,4073,4151,4071,4150,4128,66,44,13910,574323840,52506
727,a1601,20150422,4150,4128,4137,4260,4137,4242,4190,114,62,28586,1197927060,54258
728,a1601,20150423,4242,4190,4238,4255,4203,4232,4228,42,38,19404,820448420,53354
729,a1601,20150424,4232,4228,4245,4308,4232,4300,4280,72,52,27662,1183967900,52558
730,a1601,20150427,4300,4280,4304,4329,4277,4312,4302,32,22,15514,667535240,52764
731,a1601,20150428,4312,4302,4311,4321,4282,4310,4310,8,8,15508,668539420,54286
732,a1601,20150429,4310,4310,4332,4332,4302,4315,4314,5,4,16062,692958120,56492
733,a1601,20150430,4315,4314,4311,4421,4311,4405,4384,91,70,27740,1216312360,62656
734,a1601,20150504,4405,4384,4398,4398,4345,4361,4364,-23,-20,12866,561531960,65800
735,a1601,20150505,4361,4364,4361,4384,4320,4360,4361,-4,-3,11902,519107740,65694
736,a1601,20150506,4360,4361,4375,4416,4352,4397,4389,36,28,16314,716126060,66886
737,a1601,20150507,4397,4389,4398,4405,4361,4385,4383,-4,-6,8648,379101800,68314
738,a1601,20150508,4385,4383,4385,4392,4335,4370,4359,-13,-24,12026,524221940,68314
739,a1601,20150511,4370,4359,4377,4454,4365,4451,4420,92,61,29430,1300924900,74158
740,a1601,20150512,4451,4420,4450,4469,4431,4452,4449,32,29,21632,962621420,77058
741,a1601,20150513,4452,4449,4451,4466,4439,4460,4454,11,5,14620,651217640,77220
742,a1601,20150514,4460,4454,4464,4472,4419,4453,4445,-1,-9,18422,818867520,75590
743,a1601,20150515,4453,4445,4453,4465,4443,4454,4451,9,6,10238,455705540,74522
744,a1601,20150518,4454,4451,4454,4458,4428,4452,4444,1,-7,9008,400326340,74392
745,a1601,20150519,4452,4444,4456,4459,4421,4421,4437,-23,-7,10310,457551280,74408
746,a1601,20150520,4421,4437,4415,4424,4367,4391,4394,-46,-43,17518,769865880,75360
747,a1601,20150521,4391,4394,4395,4426,4301,4397,4402,3,8,15998,704364380,76650
748,a1601,20150522,4397,4402,4400,4571,4391,4547,4498,145,96,58842,2646973460,79412
749,a1601,20150525,4547,4498,4532,4560,4493,4509,4518,11,20,44038,1989674560,72782
750,a1601,20150526,4509,4518,4517,4534,4498,4498,4510,-20,-8,21276,959673980,70552
751,a1601,20150527,4498,4510,4488,4510,4462,4480,4485,-30,-25,20308,910892980,71414
752,a1601,20150528,4480,4485,4481,4526,4473,4493,4496,8,11,31548,1418480380,77514
753,a1601,20150529,4493,4496,4498,4510,4439,4504,4489,8,-7,12748,572281880,75826
754,a1601,20150601,4504,4489,4496,4514,4415,4429,4469,-60,-20,28392,1269004400,80416
755,a1601,20150602,4429,4469,4429,4468,4423,4457,4450,-12,-19,14706,654498280,80014
756,a1601,20150603,4457,4450,4467,4487,4458,4472,4472,22,22,14664,655891420,78408
757,a1601,20150604,4472,4472,4469,4472,4415,4439,4437,-33,-35,20328,901987520,76604
758,a1601,20150605,4439,4437,4431,4445,4355,4365,4393,-72,-44,31526,1385120340,76098
759,a1601,20150608,4365,4393,4365,4394,4347,4358,4375,-35,-18,23178,1014082600,79322
760,a1601,20150609,4358,4375,4361,4406,4360,4365,4384,-10,9,29648,1299986840,87990
761,a1601,20150610,4365,4384,4367,4393,4357,4379,4373,-5,-11,14220,621961520,88032
762,a1601,20150611,4379,4373,4382,4402,4362,4370,4380,-3,7,18092,792549320,88922
763,a1601,20150612,4370,4380,4360,4373,4256,4259,4296,-121,-84,63798,2741180460,97284
764,a1601,20150615,4259,4296,4271,4279,4224,4232,4252,-64,-44,31136,1324084720,101460
765,a1601,20150616,4232,4252,4231,4304,4221,4275,4267,23,15,45244,1930599800,110516
766,a1601,20150617,4275,4267,4273,4332,4250,4325,4304,58,37,35988,1549062940,113258
767,a1601,20150618,4325,4304,4320,4368,4311,4326,4333,22,29,42310,1833517600,114622
768,a1601,20150619,4326,4333,4308,4335,4291,4321,4311,-12,-22,27446,1183449240,108670
769,a1601,20150623,4321,4311,4367,4370,4332,4350,4345,39,34,20452,888837160,106696
770,a1601,20150624,4350,4345,4343,4349,4288,4308,4315,-37,-30,32990,1423797600,108406
771,a1601,20150625,4308,4315,4308,4344,4291,4303,4312,-12,-3,22680,978156760,108272
772,a1601,20150626,4303,4312,4313,4335,4270,4280,4309,-32,-3,37568,1619064380,107938
773,a1601,20150629,4280,4309,4306,4317,4241,4261,4270,-48,-39,39734,1696961120,106508
774,a1601,20150630,4261,4270,4262,4278,4206,4212,4233,-58,-37,30164,1277048880,104380
775,a1601,20150701,4212,4233,4209,4331,4187,4270,4265,37,32,66492,2836096720,105818
776,a1601,20150702,4270,4265,4266,4270,4227,4241,4246,-24,-19,25006,1061924180,105052
777,a1601,20150703,4241,4246,4241,4255,4223,4231,4240,-15,-6,31150,1320837460,107192
778,a1601,20150706,4231,4240,4239,4239,4156,4170,4188,-70,-52,47150,1974913880,107610
779,a1601,20150707,4170,4188,4169,4180,4122,4127,4151,-61,-37,38010,1578000540,105818
780,a1601,20150708,4127,4151,4125,4126,3985,3986,4022,-165,-129,94778,3812589080,114646
781,a1601,20150709,3986,4022,3986,4182,3986,4166,4105,144,83,88100,3616519920,110460
782,a1601,20150710,4166,4105,4176,4269,4169,4265,4251,160,146,88428,3759816400,111618
783,a1601,20150713,4265,4251,4269,4290,4222,4261,4253,10,2,81614,3471441760,112206
784,a1601,20150714,4261,4253,4253,4294,4236,4269,4269,16,16,88602,3782884140,114890
785,a1601,20150715,4269,4269,4267,4275,4214,4230,4247,-39,-22,53104,2255795380,115898
786,a1601,20150716,4230,4247,4225,4236,4142,4206,4189,-41,-58,84654,3546258260,116106
787,a1601,20150717,4206,4189,4208,4243,4174,4202,4207,13,18,72928,3068513640,117994
788,a1601,20150720,4202,4207,4191,4214,4124,4147,4168,-60,-39,58284,2429730860,116700
789,a1601,20150721,4147,4168,4141,4178,4136,4147,4154,-21,-14,47456,1971714300,118158
790,a1601,20150722,4147,4154,4146,4156,4101,4141,4130,-13,-24,73762,3046641220,123154
791,a1601,20150723,4141,4130,4129,4164,4105,4150,4133,20,3,103328,4271276360,126258
792,a1601,20150724,4150,4133,4151,4187,4137,4163,4162,30,29,94288,3924709460,127696
793,a1601,20150727,4163,4162,4158,4177,4119,4127,4146,-35,-16,83930,3480349380,135142
794,a1601,20150728,4127,4146,4121,4173,4074,4170,4124,24,-22,139216,5741975440,129064
795,a1601,20150729,4170,4124,4179,4238,4170,4234,4212,110,88,153390,6461039860,125886
796,a1601,20150730,4234,4212,4234,4278,4220,4232,4249,20,37,170986,7266010400,125398
797,a1601,20150731,4232,4249,4245,4260,4227,4248,4243,-1,-6,128384,5448229180,127492
798,a1601,20150803,4248,4243,4255,4267,4186,4222,4230,-21,-13,122470,5180560260,127732
799,a1601,20150804,4222,4230,4225,4257,4201,4255,4241,25,11,125318,5315009900,132580
800,a1601,20150805,4255,4241,4260,4270,4231,4249,4251,8,10,91916,3907597980,133980
801,a1601,20150806,4249,4251,4265,4345,4252,4331,4300,80,49,246188,10586400300,153382
802,a1601,20150807,4331,4300,4330,4347,4283,4325,4313,25,13,187696,8097113060,154042
803,a1601,20150810,4325,4313,4313,4381,4313,4361,4350,48,37,149176,6489405280,161470
804,a1601,20150811,4361,4350,4355,4396,4351,4379,4379,29,29,139000,6087922100,160636
805,a1601,20150812,4379,4379,4367,4392,4352,4388,4372,9,-7,99746,4361866620,155758
806,a1601,20150813,4388,4372,4402,4420,4299,4344,4358,-28,-14,171362,7468624380,146682
807,a1601,20150814,4344,4358,4337,4375,4333,4359,4354,1,-4,88358,3847642480,148494
808,a1601,20150817,4359,4354,4355,4396,4347,4372,4372,18,18,86388,3777535400,150500
809,a1601,20150818,4372,4372,4374,4394,4312,4313,4358,-59,-14,127630,5562340060,149878
810,a1601,20150819,4313,4358,4316,4343,4292,4325,4315,-33,-43,149810,6465687800,139240
811,a1601,20150820,4325,4315,4331,4340,4259,4279,4299,-36,-16,131020,5632764300,138608
812,a1601,20150821,4279,4299,4277,4315,4269,4281,4292,-18,-7,114694,4923281420,132990
813,a1601,20150824,4281,4292,4278,4284,4172,4197,4225,-95,-67,166944,7054649040,127524
814,a1601,20150825,4197,4225,4175,4245,4156,4210,4208,-15,-17,135454,5700851440,122334
815,a1601,20150826,4210,4208,4242,4270,4196,4204,4229,-4,21,102434,4332819640,117352
816,a1601,20150827,4204,4229,4210,4229,4166,4219,4203,-10,-26,124986,5253409540,115836
817,a1601,20150828,4219,4203,4218,4265,4141,4156,4195,-47,-8,273034,11454130240,144090
818,a1601,20150831,4156,4195,4148,4191,4130,4160,4159,-35,-36,180586,7512155160,141276
819,a1601,20150901,4160,4159,4158,4199,4145,4181,4182,22,23,138606,5796870360,135294
820,a1601,20150902,4181,4182,4170,4203,4162,4189,4185,7,3,97438,4078467140,132080
821,a1601,20150907,4189,4185,4180,4188,4125,4128,4144,-57,-41,87746,3636526100,143656
822,a1601,20150908,4128,4144,4126,4155,4094,4147,4122,3,-22,152362,6281469580,140366
823,a1601,20150909,4147,4122,4157,4173,4121,4123,4148,1,26,133404,5534819580,143374
824,a1601,20150910,4123,4148,4120,4165,4111,4158,4138,10,-10,122668,5076785760,138428
825,a1601,20150911,4158,4138,4142,4198,4133,4170,4170,32,32,116204,4846605800,132208
826,a1601,20150914,4170,4170,4169,4186,4141,4144,4168,-26,-2,92810,3868890220,132074
827,a1601,20150915,4144,4168,4143,4175,4134,4139,4158,-29,-10,106860,4444105980,127894
828,a1601,20150916,4139,4158,4139,4168,4115,4165,4136,7,-22,123058,5089919880,123148
829,a1601,20150917,4165,4136,4165,4172,4145,4150,4158,14,22,81576,3392169040,121674
830,a1601,20150918,4150,4158,4142,4169,4122,4128,4146,-30,-12,99056,4107809640,126840
831,a1601,20150921,4128,4146,4124,4136,4048,4099,4083,-47,-63,173326,7077173520,136054
832,a1601,20150922,4099,4083,4099,4108,4056,4071,4078,-12,-5,112778,4599762980,137266
833,a1601,20150923,4071,4078,4057,4074,4032,4064,4053,-14,-25,100340,4067465480,135406
834,a1601,20150924,4064,4053,4065,4083,4037,4045,4056,-8,3,99952,4054741420,136174
835,a1601,20150925,4045,4056,4039,4065,3997,4027,4035,-29,-21,208118,8399300520,131620
836,a1601,20150928,4027,4035,4047,4055,4007,4014,4024,-21,-11,51964,2091177300,132856
837,a1601,20150929,4014,4024,4014,4075,3982,4073,4034,49,10,167052,6740081240,126916
838,a1601,20150930,4073,4034,4079,4097,4041,4047,4066,13,32,134822,5482954100,115326
839,a1601,20151008,4047,4066,4056,4064,3870,3903,3946,-163,-120,289110,11408552880,153154
840,a1601,20151009,3903,3946,3898,3945,3842,3888,3889,-58,-57,572602,22271424280,154898
841,a1601,20151012,3888,3889,3897,3962,3870,3956,3916,67,27,374446,14664159800,147646
842,a1601,20151013,3956,3916,3949,3963,3923,3952,3942,36,26,281438,11094762720,148050
843,a1601,20151014,3952,3942,3952,3999,3944,3984,3973,42,31,278330,11060125360,133608
844,a1601,20151015,3984,3973,3988,3999,3962,3971,3978,-2,5,168512,6703455300,134480
845,a1601,20151016,3971,3978,3966,3969,3926,3945,3944,-33,-34,226762,8945085640,146902
846,a1601,20151019,3945,3944,3936,3954,3916,3939,3936,-5,-8,154736,6091732900,145770
847,a1601,20151020,3939,3936,3926,3951,3903,3930,3928,-6,-8,176582,6936273400,149322
848,a1601,20151021,3930,3928,3930,3946,3907,3910,3925,-18,-3,115160,4520203000,148996
849,a1601,20151022,3910,3925,3911,3983,3898,3969,3940,44,15,212442,8370864700,134004
850,a1601,20151023,3969,3940,3976,3985,3930,3965,3951,25,11,169676,6704227500,120346
851,a1601,20151026,3965,3951,3969,3975,3866,3905,3910,-46,-41,267988,10478440440,132390
852,a1601,20151027,3905,3910,3905,3913,3869,3912,3890,2,-20,167042,6498855740,128074
853,a1601,20151028,3912,3890,3908,3918,3875,3879,3894,-11,4,114280,4450839200,132162
854,a1601,20151029,3879,3894,3880,3908,3870,3885,3888,-9,-6,118276,4599361640,132096
855,a1601,20151030,3885,3888,3880,3892,3855,3881,3876,-7,-12,145762,5650110900,131102
856,a1601,20151102,3881,3876,3884,3892,3870,3875,3878,-1,2,86936,3372240940,128404
857,a1601,20151103,3875,3878,3870,3887,3860,3878,3873,0,-5,82820,3207654980,125600
858,a1601,20151104,3878,3873,3875,3898,3865,3887,3881,14,8,136458,5296052520,111242
859,a1601,20151105,3887,3881,3882,3889,3836,3876,3873,-5,-8,93480,3620831280,113132
860,a1601,20151106,3876,3873,3875,3885,3844,3884,3867,11,-6,112198,4339298800,112500
861,a1601,20151109,3884,3867,3877,3898,3850,3861,3870,-6,3,98762,3822928220,114844
862,a1601,20151110,3861,3870,3863,3867,3838,3853,3853,-17,-17,71340,2748832620,114966
863,a1601,20151111,3853,3853,3847,3879,3813,3867,3845,14,-8,108122,4157618460,109802
864,a1601,20151112,3867,3845,3867,3894,3860,3887,3876,42,31,85736,3323291580,97092
865,a1601,20151113,3887,3876,3880,3891,3865,3868,3878,-8,2,54624,2118731160,92988
866,a1601,20151116,3868,3878,3878,3878,3764,3766,3810,-112,-68,111220,4238231520,94152
867,a1601,20151117,3766,3810,3780,3780,3707,3770,3745,-40,-65,158962,5954063280,80864
868,a1601,20151118,3770,3745,3766,3789,3764,3780,3777,35,32,57358,2166537780,83300
869,a1601,20151119,3780,3777,3787,3794,3756,3784,3776,7,-1,73212,2764766520,79534
870,a1601,20151120,3784,3776,3771,3850,3771,3846,3824,70,48,63976,2446472340,81362
871,a1601,20151123,3846,3824,3838,3912,3838,3901,3882,77,58,61258,2378300960,68836
872,a1601,20151124,3901,3882,3886,3906,3876,3890,3892,8,10,32942,1282116720,64942
873,a1601,20151125,3890,3892,3888,3900,3857,3895,3885,3,-7,24340,945710500,63996
874,a1601,20151126,3895,3885,3888,3914,3880,3890,3896,5,11,23524,916638220,61482
875,a1601,20151127,3890,3896,3883,3926,3880,3915,3901,19,5,17114,667744480,58238
876,a1601,20151130,3915,3901,3911,3928,3901,3918,3913,17,12,12996,508644720,52772
877,a1601,20151201,3918,3913,3918,3926,3910,3918,3918,5,5,7030,275461160,49936
878,a1601,20151202,3918,3918,3924,3934,3865,3893,3896,-25,-22,21514,838229960,43560
879,a1601,20151203,3893,3896,3885,3912,3885,3901,3904,5,8,10312,402587580,41386
880,a1601,20151204,3901,3904,3910,3910,3865,3888,3899,-16,-5,9730,379445660,39080
881,a1601,20151207,3888,3899,3888,3895,3862,3871,3876,-28,-23,10806,418913300,38752
882,a1601,20151208,3871,3876,3871,3873,3820,3822,3835,-54,-41,12456,477751100,36162
883,a1601,20151209,3822,3835,3827,3889,3827,3831,3857,-4,22,16990,655466180,32810
884,a1601,20151210,3831,3857,3832,3867,3827,3850,3851,-7,-6,3932,151457240,32346
885,a1601,20151211,3850,3851,3853,3864,3838,3847,3848,-4,-3,5346,205748160,30986
886,a1601,20151214,3847,3848,3838,3858,3835,3837,3847,-11,-1,6252,240543000,30624
887,a1601,20151215,3837,3847,3847,3849,3829,3840,3837,-7,-10,5698,218684540,30250
888,a1601,20151216,3840,3837,3846,3858,3838,3855,3849,18,12,1696,65295240,29470
889,a1601,20151217,3855,3849,3850,3887,3850,3884,3875,35,26,2782,107813540,28628
890,a1601,20151218,3884,3875,3870,3888,3860,3873,3872,-2,-3,2760,106874180,26704
891,a1601,20151221,3873,3872,3875,3878,3871,3871,3874,-1,2,2022,78342600,24944
892,a1601,20151222,3871,3874,3870,3878,3870,3873,3873,-1,-1,782,30292680,24490
893,a1601,20151223,3873,3873,3873,3878,3865,3875,3872,2,-1,974,37715560,23890
894,a1601,20151224,3875,3872,3875,3878,3860,3868,3872,-4,0,1450,56144160,22628
895,a1601,20151225,3868,3872,3871,3875,3858,3860,3868,-12,-4,1772,68541460,22304
896,a1601,20151228,3860,3868,3865,3875,3863,3869,3869,1,1,1528,59121980,21142
897,a1601,20151229,3869,3869,3871,3875,3864,3865,3869,-4,0,8054,311629180,13876
898,a1601,20151230,3865,3869,3863,3870,3742,3841,3844,-28,-25,2954,113575380,11826
899,a1601,20151231,3841,3844,3844,3870,3779,3815,3826,-29,-18,8668,331674960,7960
900,a1603,20150105,4510,4510,0,0,0,4507,4507,-3,-3,0,0,2
901,a1603,20150106,4507,4507,0,0,0,4532,4532,25,25,0,0,2
902,a1603,20150107,4532,4532,4395,4539,4395,4539,4491,7,-41,6,269460,4
903,a1603,20150108,4539,4491,4414,4414,4414,4414,4414,-77,-77,4,176560,0
904,a1603,20150109,4414,4414,0,0,0,4414,4414,0,0,0,0,0
905,a1603,20150112,4414,4414,0,0,0,4414,4414,0,0,0,0,0
906,a1603,20150113,4414,4414,0,0,0,4414,4414,0,0,0,0,0
907,a1603,20150114,4414,4414,0,0,0,4414,4414,0,0,0,0,0
908,a1603,20150115,4414,4414,0,0,0,4414,4414,0,0,0,0,0
909,a1603,20150116,4414,4414,0,0,0,4414,4414,0,0,0,0,0
910,a1603,20150119,4414,4414,0,0,0,4414,4414,0,0,0,0,0
911,a1603,20150120,4414,4414,0,0,0,4414,4414,0,0,0,0,0
912,a1603,20150121,4414,4414,0,0,0,4414,4414,0,0,0,0,0
913,a1603,20150122,4414,4414,0,0,0,4414,4414,0,0,0,0,0
914,a1603,20150123,4414,4414,0,0,0,4414,4414,0,0,0,0,0
915,a1603,20150126,4414,4414,0,0,0,4375,4375,-39,-39,0,0,0
916,a1603,20150127,4375,4375,0,0,0,4375,4375,0,0,0,0,0
917,a1603,20150128,4375,4375,0,0,0,4375,4375,0,0,0,0,0
918,a1603,20150129,4375,4375,0,0,0,4375,4375,0,0,0,0,0
919,a1603,20150130,4375,4375,0,0,0,4375,4375,0,0,0,0,0
920,a1603,20150202,4375,4375,0,0,0,4375,4375,0,0,0,0,0
921,a1603,20150203,4375,4375,0,0,0,4375,4375,0,0,0,0,0
922,a1603,20150204,4375,4375,0,0,0,4375,4375,0,0,0,0,0
923,a1603,20150205,4375,4375,0,0,0,4375,4375,0,0,0,0,0
924,a1603,20150206,4375,4375,0,0,0,4375,4375,0,0,0,0,0
925,a1603,20150209,4375,4375,4317,4466,4317,4333,4395,-42,20,8,351640,0
926,a1603,20150210,4333,4395,0,0,0,4395,4395,0,0,0,0,0
927,a1603,20150211,4395,4395,0,0,0,4395,4395,0,0,0,0,0
928,a1603,20150212,4395,4395,0,0,0,4395,4395,0,0,0,0,0
929,a1603,20150213,4395,4395,0,0,0,4395,4395,0,0,0,0,0
930,a1603,20150216,4395,4395,0,0,0,4395,4395,0,0,0,0,0
931,a1603,20150217,4395,4395,0,0,0,4395,4395,0,0,0,0,0
932,a1603,20150225,4395,4395,0,0,0,4395,4395,0,0,0,0,0
933,a1603,20150226,4395,4395,4402,4402,4402,4402,4402,7,7,60,2641200,60
934,a1603,20150227,4402,4402,4351,4425,4351,4400,4391,-2,-11,8,351300,62
935,a1603,20150302,4400,4391,0,0,0,4391,4391,0,0,0,0,62
936,a1603,20150303,4391,4391,0,0,0,4391,4391,0,0,0,0,62
937,a1603,20150304,4391,4391,4392,4392,4390,4390,4391,-1,0,4,175640,62
938,a1603,20150305,4390,4391,0,0,0,4391,4391,0,0,0,0,62
939,a1603,20150306,4391,4391,0,0,0,4378,4378,-13,-13,0,0,62
940,a1603,20150309,4378,4378,0,0,0,4378,4378,0,0,0,0,62
941,a1603,20150310,4378,4378,4336,4336,4336,4336,4336,-42,-42,2,86720,62
942,a1603,20150311,4336,4336,4351,4351,4351,4351,4351,15,15,2,87020,64
943,a1603,20150312,4351,4351,0,0,0,4351,4351,0,0,0,0,64
944,a1603,20150313,4351,4351,4385,4387,4344,4344,4367,-7,16,14,611460,66
945,a1603,20150316,4344,4367,0,0,0,4367,4367,0,0,0,0,66
946,a1603,20150317,4367,4367,0,0,0,4392,4392,25,25,0,0,66
947,a1603,20150318,4392,4392,0,0,0,4381,4381,-11,-11,0,0,66
948,a1603,20150319,4381,4381,4406,4406,4286,4360,4351,-21,-30,14,609180,70
949,a1603,20150320,4360,4351,4330,4330,4301,4302,4307,-49,-44,32,1378520,86
950,a1603,20150323,4302,4307,4356,4368,4325,4335,4340,28,33,62,2691260,118
951,a1603,20150324,4335,4340,4351,4351,4290,4307,4331,-33,-9,54,2339000,132
952,a1603,20150325,4307,4331,4310,4310,4310,4310,4310,-21,-21,2,86200,134
953,a1603,20150326,4310,4310,4270,4320,4252,4252,4280,-58,-30,22,941720,138
954,a1603,20150327,4252,4280,4282,4309,4282,4309,4292,29,12,10,429280,142
955,a1603,20150330,4309,4292,4288,4288,4273,4273,4282,-19,-10,10,428200,138
956,a1603,20150331,4273,4282,4269,4269,4269,4269,4269,-13,-13,4,170760,134
957,a1603,20150401,4269,4269,4280,4289,4280,4289,4284,20,15,8,342760,138
958,a1603,20150402,4289,4284,4289,4290,4289,4290,4289,6,5,32,1372520,138
959,a1603,20150403,4290,4289,4231,4231,4231,4231,4231,-58,-58,8,338480,138
960,a1603,20150407,4231,4231,4226,4230,4216,4216,4224,-15,-7,6,253440,138
961,a1603,20150408,4216,4224,4194,4194,4170,4180,4182,-44,-42,22,920040,144
962,a1603,20150409,4180,4182,4163,4163,4138,4141,4142,-41,-40,38,1574120,126
963,a1603,20150410,4141,4142,0,0,0,4142,4142,0,0,0,0,126
964,a1603,20150413,4142,4142,4170,4170,4170,4170,4170,28,28,2,83400,126
965,a1603,20150414,4170,4170,0,0,0,4171,4171,1,1,0,0,126
966,a1603,20150415,4171,4171,0,0,0,4196,4196,25,25,0,0,126
967,a1603,20150416,4196,4196,0,0,0,4196,4196,0,0,0,0,126
968,a1603,20150417,4196,4196,4207,4224,4119,4119,4202,-77,6,54,2269320,126
969,a1603,20150420,4119,4202,4171,4187,4122,4161,4160,-41,-42,32,1331380,128
970,a1603,20150421,4161,4160,4188,4245,4185,4213,4202,53,42,32,1344740,118
971,a1603,20150422,4213,4202,4260,4299,4260,4263,4271,61,69,18,768800,118
972,a1603,20150423,4263,4271,4271,4271,4271,4271,4271,0,0,2,85420,118
973,a1603,20150424,4271,4271,4317,4349,4317,4349,4336,78,65,32,1387700,116
974,a1603,20150427,4349,4336,4377,4377,4377,4377,4377,41,41,2,87540,116
975,a1603,20150428,4377,4377,0,0,0,4377,4377,0,0,0,0,116
976,a1603,20150429,4377,4377,4376,4376,4371,4371,4374,-6,-3,12,524900,114
977,a1603,20150430,4371,4374,4446,4446,4446,4446,4446,72,72,2,88920,114
978,a1603,20150504,4446,4446,4430,4430,4416,4418,4419,-28,-27,14,618760,116
979,a1603,20150505,4418,4419,4415,4415,4415,4415,4415,-4,-4,2,88300,116
980,a1603,20150506,4415,4415,4421,4421,4421,4421,4421,6,6,6,265260,116
981,a1603,20150507,4421,4421,4425,4448,4412,4445,4427,24,6,20,885440,112
982,a1603,20150508,4445,4427,4399,4399,4399,4399,4399,-28,-28,4,175960,112
983,a1603,20150511,4399,4399,0,0,0,4460,4460,61,61,0,0,112
984,a1603,20150512,4460,4460,4474,4501,4474,4482,4484,22,24,16,717540,110
985,a1603,20150513,4482,4484,4526,4526,4500,4500,4516,16,32,8,361320,110
986,a1603,20150514,4500,4516,4500,4500,4500,4500,4500,-16,-16,2,90000,110
987,a1603,20150515,4500,4500,4500,4500,4500,4500,4500,0,0,2,90000,110
988,a1603,20150518,4500,4500,4490,4513,4471,4513,4490,13,-10,62,2783900,108
989,a1603,20150519,4513,4490,4493,4493,4470,4470,4487,-20,-3,10,448780,108
990,a1603,20150520,4470,4487,4464,4464,4464,4464,4464,-23,-23,6,267840,102
991,a1603,20150521,4464,4464,4472,4472,4472,4472,4472,8,8,6,268320,102
992,a1603,20150522,4472,4472,0,0,0,4569,4569,97,97,0,0,102
993,a1603,20150525,4569,4569,4565,4565,4565,4565,4565,-4,-4,4,182600,106
994,a1603,20150526,4565,4565,4566,4577,4530,4530,4563,-35,-2,12,547620,106
995,a1603,20150527,4530,4563,4561,4561,4561,4561,4561,-2,-2,12,547320,106
996,a1603,20150528,4561,4561,0,0,0,4572,4572,11,11,0,0,106
997,a1603,20150529,4572,4572,0,0,0,4565,4565,-7,-7,0,0,106
998,a1603,20150601,4565,4565,4574,4574,4555,4555,4564,-10,-1,12,547740,106
999,a1603,20150602,4555,4564,0,0,0,4545,4545,-19,-19,0,0,106
1000,a1603,20150603,4545,4545,0,0,0,4567,4567,22,22,0,0,106
1001,a1603,20150604,4567,4567,0,0,0,4532,4532,-35,-35,0,0,106
1002,a1603,20150605,4532,4532,0,0,0,4488,4488,-44,-44,0,0,106
1003,a1603,20150608,4488,4488,4445,4450,4437,4450,4444,-38,-44,12,533320,102
1004,a1603,20150609,4450,4444,4470,4470,4446,4446,4455,2,11,14,623720,104
1005,a1603,20150610,4446,4455,4462,4462,4444,4454,4451,-1,-4,22,979380,108
1006,a1603,20150611,4454,4451,0,0,0,4458,4458,7,7,0,0,108
1007,a1603,20150612,4458,4458,4437,4437,4359,4363,4394,-95,-64,38,1669860,110
1008,a1603,20150615,4363,4394,4360,4360,4356,4356,4358,-38,-36,12,522960,110
1009,a1603,20150616,4356,4358,4347,4374,4342,4356,4353,-2,-5,10,435380,110
1010,a1603,20150617,4356,4353,4420,4423,4389,4390,4409,37,56,12,529080,112
1011,a1603,20150618,4390,4409,4410,4421,4406,4409,4414,0,5,24,1059560,118
1012,a1603,20150619,4409,4414,4370,4370,4370,4370,4370,-44,-44,2,87400,118
1013,a1603,20150623,4370,4370,4424,4435,4415,4435,4424,65,54,10,442440,112
1014,a1603,20150624,4435,4424,0,0,0,4394,4394,-30,-30,0,0,112
1015,a1603,20150625,4394,4394,0,0,0,4391,4391,-3,-3,0,0,112
1016,a1603,20150626,4391,4391,4401,4415,4359,4359,4397,-32,6,12,527680,108
1017,a1603,20150629,4359,4397,0,0,0,4358,4358,-39,-39,0,0,108
1018,a1603,20150630,4358,4358,0,0,0,4321,4321,-37,-37,0,0,108
1019,a1603,20150701,4321,4321,4273,4376,4273,4350,4322,29,1,8,345780,110
1020,a1603,20150702,4350,4322,4317,4317,4317,4317,4317,-5,-5,2,86340,110
1021,a1603,20150703,4317,4317,4318,4318,4302,4302,4309,-15,-8,6,258540,110
1022,a1603,20150706,4302,4309,4263,4299,4140,4254,4256,-55,-53,30,1276920,112
1023,a1603,20150707,4254,4256,4246,4283,4200,4200,4243,-56,-13,26,1103300,106
1024,a1603,20150708,4200,4243,4111,4116,4074,4075,4080,-168,-163,26,1060920,88
1025,a1603,20150709,4075,4080,4116,4183,4116,4183,4138,103,58,22,910540,74
1026,a1603,20150710,4183,4138,4282,4303,4282,4303,4298,165,160,20,859760,70
1027,a1603,20150713,4303,4298,4326,4380,4260,4327,4319,29,21,76,3282500,70
1028,a1603,20150714,4327,4319,4326,4326,4291,4300,4309,-19,-10,20,861940,58
1029,a1603,20150715,4300,4309,4303,4303,4300,4300,4301,-9,-8,6,258060,58
1030,a1603,20150716,4300,4301,0,0,0,4243,4243,-58,-58,0,0,58
1031,a1603,20150717,4243,4243,4303,4303,4208,4248,4257,5,14,12,510900,58
1032,a1603,20150720,4248,4257,4213,4273,4213,4258,4248,1,-9,6,254880,58
1033,a1603,20150721,4258,4248,4217,4221,4212,4221,4216,-27,-32,6,253000,58
1034,a1603,20150722,4221,4216,4194,4206,4194,4197,4198,-19,-18,20,839720,58
1035,a1603,20150723,4197,4198,0,0,0,4201,4201,3,3,0,0,58
1036,a1603,20150724,4201,4201,4162,4247,4162,4247,4206,46,5,16,673000,60
1037,a1603,20150727,4247,4206,0,0,0,4191,4191,-15,-15,0,0,60
1038,a1603,20150728,4191,4191,4183,4186,4183,4186,4184,-5,-7,4,167380,60
1039,a1603,20150729,4186,4184,4245,4278,4245,4278,4261,94,77,4,170460,58
1040,a1603,20150730,4278,4261,0,0,0,4298,4298,37,37,0,0,58
1041,a1603,20150731,4298,4298,4322,4322,4322,4322,4322,24,24,2,86440,58
1042,a1603,20150803,4322,4322,4319,4319,4319,4319,4319,-3,-3,2,86380,60
1043,a1603,20150804,4319,4319,4316,4317,4302,4314,4311,-5,-8,46,1983400,64
1044,a1603,20150805,4314,4311,0,0,0,4311,4311,0,0,0,0,64
1045,a1603,20150806,4311,4311,4336,4386,4336,4386,4365,75,54,8,349220,60
1046,a1603,20150807,4386,4365,0,0,0,4365,4365,0,0,0,0,60
1047,a1603,20150810,4365,4365,0,0,0,4368,4368,3,3,0,0,60
1048,a1603,20150811,4368,4368,4500,4500,4401,4435,4438,67,70,28,1242880,60
1049,a1603,20150812,4435,4438,0,0,0,4438,4438,0,0,0,0,60
1050,a1603,20150813,4438,4438,4422,4422,4386,4386,4404,-52,-34,4,176160,58
1051,a1603,20150814,4386,4404,0,0,0,4400,4400,-4,-4,0,0,58
1052,a1603,20150817,4400,4400,0,0,0,4418,4418,18,18,0,0,58
1053,a1603,20150818,4418,4418,0,0,0,4404,4404,-14,-14,0,0,58
1054,a1603,20150819,4404,4404,0,0,0,4361,4361,-43,-43,0,0,58
1055,a1603,20150820,4361,4361,0,0,0,4345,4345,-16,-16,0,0,58
1056,a1603,20150821,4345,4345,4316,4316,4315,4315,4315,-30,-30,4,172620,58
1057,a1603,20150824,4315,4315,4232,4232,4211,4211,4225,-104,-90,6,253500,64
1058,a1603,20150825,4211,4225,4233,4348,4166,4266,4272,41,47,84,3589260,60
1059,a1603,20150826,4266,4272,0,0,0,4293,4293,21,21,0,0,60
1060,a1603,20150827,4293,4293,4265,4265,4263,4263,4264,-30,-29,6,255860,58
1061,a1603,20150828,4263,4264,4163,4213,4163,4213,4188,-51,-76,4,167520,58
1062,a1603,20150831,4213,4188,0,0,0,4190,4190,2,2,0,0,58
1063,a1603,20150901,4190,4190,0,0,0,4213,4213,23,23,0,0,58
1064,a1603,20150902,4213,4213,4218,4236,4215,4219,4220,6,7,44,1857060,72
1065,a1603,20150907,4219,4220,0,0,0,4179,4179,-41,-41,0,0,72
1066,a1603,20150908,4179,4179,4177,4211,4154,4154,4178,-25,-1,10,417840,72
1067,a1603,20150909,4154,4178,4195,4195,4133,4133,4175,-45,-3,10,417500,74
1068,a1603,20150910,4133,4175,4134,4150,4134,4150,4137,-25,-38,276,11420680,346
1069,a1603,20150911,4150,4137,4163,4163,4163,4163,4163,26,26,4,166520,346
1070,a1603,20150914,4163,4163,4151,4151,4151,4151,4151,-12,-12,4,166040,346
1071,a1603,20150915,4151,4151,4169,4169,4123,4123,4146,-28,-5,4,165840,346
1072,a1603,20150916,4123,4146,4120,4177,4120,4136,4138,-10,-8,8,331060,344
1073,a1603,20150917,4136,4138,4145,4145,4145,4145,4145,7,7,2,82900,344
1074,a1603,20150918,4145,4145,4134,4134,4134,4134,4134,-11,-11,4,165360,344
1075,a1603,20150921,4134,4134,4105,4124,4065,4124,4092,-10,-42,174,7121160,188
1076,a1603,20150922,4124,4092,4063,4120,4063,4112,4108,20,16,76,3122400,124
1077,a1603,20150923,4112,4108,4095,4098,4090,4090,4091,-18,-17,22,900060,102
1078,a1603,20150924,4090,4091,4114,4114,4114,4114,4114,23,23,4,164560,98
1079,a1603,20150925,4114,4114,4060,4090,4060,4070,4079,-44,-35,66,2692180,40
1080,a1603,20150928,4070,4079,4040,4040,4040,4040,4040,-39,-39,2,80800,38
1081,a1603,20150929,4040,4040,0,0,0,4050,4050,10,10,0,0,38
1082,a1603,20150930,4050,4050,0,0,0,4082,4082,32,32,0,0,38
1083,a1603,20151008,4082,4082,4040,4040,3951,3951,3964,-131,-118,22,872100,38
1084,a1603,20151009,3951,3964,3909,3909,3909,3909,3909,-55,-55,2,78180,38
1085,a1603,20151012,3909,3909,0,0,0,3909,3909,0,0,0,0,38
1086,a1603,20151013,3909,3909,0,0,0,3909,3909,0,0,0,0,38
1087,a1603,20151014,3909,3909,3959,4004,3836,3952,3946,43,37,20,789380,38
1088,a1603,20151015,3952,3946,3868,3951,3868,3943,3909,-3,-37,72,2814600,54
1089,a1603,20151016,3943,3909,3922,3941,3903,3910,3927,1,18,28,1099560,38
1090,a1603,20151019,3910,3927,0,0,0,3927,3927,0,0,0,0,38
1091,a1603,20151020,3927,3927,3886,3904,3885,3900,3895,-27,-32,32,1246620,24
1092,a1603,20151021,3900,3895,3915,3915,3915,3915,3915,20,20,2,78300,22
1093,a1603,20151022,3915,3915,3950,3950,3950,3950,3950,35,35,2,79000,22
1094,a1603,20151023,3950,3950,3951,3951,3917,3917,3934,-33,-16,4,157360,22
1095,a1603,20151026,3917,3934,3914,3917,3914,3917,3916,-17,-18,10,391600,18
1096,a1603,20151027,3917,3916,3813,3878,3813,3878,3845,-38,-71,20,769100,18
1097,a1603,20151028,3878,3845,3865,3892,3832,3892,3863,47,18,46,1777380,52
1098,a1603,20151029,3892,3863,3853,3853,3850,3850,3851,-13,-12,4,154060,54
1099,a1603,20151030,3850,3851,3806,3836,3806,3810,3813,-41,-38,18,686440,62
1100,a1603,20151102,3810,3813,3804,3804,3804,3804,3804,-9,-9,2,76080,60
1101,a1603,20151103,3804,3804,3805,3825,3805,3825,3820,21,16,8,305600,54
1102,a1603,20151104,3825,3820,3808,3830,3808,3830,3819,10,-1,4,152760,56
1103,a1603,20151105,3830,3819,3841,3841,3819,3819,3830,0,11,4,153200,54
1104,a1603,20151106,3819,3830,3798,3840,3738,3840,3806,10,-24,12,456760,52
1105,a1603,20151109,3840,3806,0,0,0,3806,3806,0,0,0,0,52
1106,a1603,20151110,3806,3806,3792,3816,3792,3816,3801,10,-5,6,228080,52
1107,a1603,20151111,3816,3801,3773,3784,3773,3784,3778,-17,-23,4,151140,52
1108,a1603,20151112,3784,3778,3784,3845,3784,3785,3814,7,36,8,305180,50
1109,a1603,20151113,3785,3814,3817,3820,3696,3813,3810,-1,-4,56,2133880,72
1110,a1603,20151116,3813,3810,3782,3782,3660,3709,3696,-101,-114,130,4805880,66
1111,a1603,20151117,3709,3696,3673,3688,3585,3688,3648,-8,-48,6,218920,68
1112,a1603,20151118,3688,3648,3613,3690,3613,3657,3667,9,19,24,880140,76
1113,a1603,20151119,3657,3667,3654,3654,3654,3654,3654,-13,-13,2,73080,76
1114,a1603,20151120,3654,3654,3636,3690,3573,3690,3635,36,-19,28,1017800,76
1115,a1603,20151123,3690,3635,3618,3699,3601,3686,3651,51,16,8,292080,76
1116,a1603,20151124,3686,3651,3741,3742,3741,3742,3741,91,90,6,224500,72
1117,a1603,20151125,3742,3741,3676,3700,3676,3700,3698,-41,-43,64,2367040,128
1118,a1603,20151126,3700,3698,3677,3678,3656,3674,3667,-24,-31,54,1980440,160
1119,a1603,20151127,3674,3667,3654,3660,3607,3629,3634,-38,-33,56,2035420,160
1120,a1603,20151130,3629,3634,3607,3655,3607,3645,3627,11,-7,32,1160780,172
1121,a1603,20151201,3645,3627,3629,3633,3614,3626,3628,-1,1,58,2104720,208
1122,a1603,20151202,3626,3628,3645,3645,3618,3628,3631,0,3,98,3558900,222
1123,a1603,20151203,3628,3631,3629,3636,3621,3636,3631,5,0,100,3631640,290
1124,a1603,20151204,3636,3631,3634,3659,3631,3647,3645,16,14,218,7948260,446
1125,a1603,20151207,3647,3645,3640,3658,3630,3658,3647,13,2,82,2991120,522
1126,a1603,20151208,3658,3647,3636,3647,3632,3635,3642,-12,-5,118,4297680,546
1127,a1603,20151209,3635,3642,3636,3640,3635,3637,3637,-5,-5,62,2255220,562
1128,a1603,20151210,3637,3637,3634,3635,3622,3635,3631,-2,-6,26,944240,568
1129,a1603,20151211,3635,3631,3635,3642,3631,3641,3634,10,3,24,872260,576
1130,a1603,20151214,3641,3634,0,0,0,3634,3634,0,0,0,0,576
1131,a1603,20151215,3634,3634,3601,3628,3581,3581,3605,-53,-29,16,576920,574
1132,a1603,20151216,3581,3605,3613,3613,3613,3613,3613,8,8,2,72260,572
1133,a1603,20151217,3613,3613,0,0,0,3613,3613,0,0,0,0,572
1134,a1603,20151218,3613,3613,3655,3660,3619,3637,3636,24,23,22,800040,574
1135,a1603,20151221,3637,3636,3630,3665,3630,3641,3648,5,12,42,1532380,588
1136,a1603,20151222,3641,3648,3636,3653,3630,3647,3643,-1,-5,50,1821560,618
1137,a1603,20151223,3647,3643,3625,3632,3612,3629,3622,-14,-21,68,2463280,654
1138,a1603,20151224,3629,3622,3625,3625,3595,3595,3620,-27,-2,12,434400,654
1139,a1603,20151225,3595,3620,3622,3629,3477,3553,3578,-67,-42,156,5581760,772
1140,a1603,20151228,3553,3578,3559,3579,3481,3519,3540,-59,-38,36,1274740,776
1141,a1603,20151229,3519,3540,3550,3550,3492,3500,3507,-40,-33,104,3647380,852
1142,a1603,20151230,3500,3507,3505,3505,3462,3483,3493,-24,-14,302,10549300,1018
1143,a1603,20151231,3483,3493,3484,3493,3470,3474,3482,-19,-11,16362,569826520,1116
1144,a1605,20150105,4455,4455,4455,4457,4440,4440,4449,-15,-6,8,355940,64
1145,a1605,20150106,4440,4449,4458,4458,4451,4451,4454,2,5,4,178180,66
1146,a1605,20150107,4451,4454,0,0,0,4457,4457,3,3,0,0,66
1147,a1605,20150108,4457,4457,0,0,0,4457,4457,0,0,0,0,66
1148,a1605,20150109,4457,4457,0,0,0,4457,4457,0,0,0,0,66
1149,a1605,20150112,4457,4457,4460,4480,4460,4460,4466,3,9,8,357320,70
1150,a1605,20150113,4460,4466,4442,4445,4420,4420,4433,-46,-33,14,620660,72
1151,a1605,20150114,4420,4433,4416,4437,4416,4418,4425,-15,-8,18,796560,76
1152,a1605,20150115,4418,4425,4408,4439,4408,4439,4420,14,-5,16,707220,82
1153,a1605,20150116,4439,4420,0,0,0,4420,4420,0,0,0,0,82
1154,a1605,20150119,4420,4420,4439,4440,4398,4413,4416,-7,-4,28,1236700,72
1155,a1605,20150120,4413,4416,4400,4400,4375,4376,4390,-40,-26,16,702520,78
1156,a1605,20150121,4376,4390,4361,4380,4359,4380,4367,-10,-23,24,1048080,88
1157,a1605,20150122,4380,4367,4344,4345,4338,4338,4342,-29,-25,6,260540,90
1158,a1605,20150123,4338,4342,4323,4323,4317,4319,4319,-23,-23,26,1123040,106
1159,a1605,20150126,4319,4319,4305,4334,4305,4312,4315,-7,-4,38,1639740,106
1160,a1605,20150127,4312,4315,4326,4343,4326,4343,4332,28,17,10,433280,96
1161,a1605,20150128,4343,4332,4341,4341,4339,4339,4340,7,8,6,260420,96
1162,a1605,20150129,4339,4340,4321,4366,4316,4364,4354,24,14,202,8795520,210
1163,a1605,20150130,4364,4354,4375,4375,4375,4375,4378,21,24,22,963280,202
1164,a1605,20150202,4375,4378,4363,4380,4363,4380,4375,2,-3,30,1312580,190
1165,a1605,20150203,4380,4375,4383,4398,4383,4391,4387,16,12,38,1667160,172
1166,a1605,20150204,4391,4387,4406,4406,4396,4396,4401,9,14,4,176040,172
1167,a1605,20150205,4396,4401,4379,4398,4378,4380,4385,-21,-16,16,701680,168
1168,a1605,20150206,4380,4385,4385,4397,4385,4397,4391,12,6,20,878340,164
1169,a1605,20150209,4397,4391,4388,4388,4380,4384,4384,-7,-7,6,263040,164
1170,a1605,20150210,4384,4384,4380,4380,4380,4380,4380,-4,-4,2,87600,166
1171,a1605,20150211,4380,4380,0,0,0,4380,4380,0,0,0,0,166
1172,a1605,20150212,4380,4380,0,0,0,4380,4380,0,0,2,87820,166
1173,a1605,20150213,4380,4380,4398,4426,4206,4206,4337,-174,-43,84,3643900,210
1174,a1605,20150216,4206,4337,4206,4397,4206,4367,4367,30,30,152,6638460,174
1175,a1605,20150217,4367,4367,0,0,0,4367,4367,0,0,0,0,174
1176,a1605,20150225,4367,4367,4358,4358,4354,4354,4354,-13,-13,24,1045040,198
1177,a1605,20150226,4354,4354,4352,4360,4348,4358,4351,4,-3,60,2610720,240
1178,a1605,20150227,4358,4351,4375,4399,4365,4391,4382,40,31,62,2717340,256
1179,a1605,20150302,4391,4382,4404,4410,4388,4401,4400,19,18,88,3872640,286
1180,a1605,20150303,4401,4400,4413,4413,4386,4400,4400,0,0,88,3872780,242
1181,a1605,20150304,4400,4400,4405,4405,4405,4405,4405,5,5,2,88100,244
1182,a1605,20150305,4405,4405,4402,4404,4362,4367,4380,-38,-25,104,4555260,298
1183,a1605,20150306,4367,4380,4367,4367,4365,4365,4366,-15,-14,4,174640,298
1184,a1605,20150309,4365,4366,4357,4374,4355,4365,4366,-1,0,44,1921180,300
1185,a1605,20150310,4365,4366,4373,4375,4322,4338,4343,-28,-23,186,8079120,462
1186,a1605,20150311,4338,4343,4326,4364,4325,4364,4351,21,8,66,2871700,450
1187,a1605,20150312,4364,4351,4364,4368,4356,4357,4362,6,11,18,785240,458
1188,a1605,20150313,4357,4362,4350,4350,4344,4344,4347,-18,-15,4,173880,458
1189,a1605,20150316,4344,4347,4349,4352,4331,4331,4338,-16,-9,28,1214780,480
1190,a1605,20150317,4331,4338,4355,4355,4355,4355,4355,17,17,2,87100,480
1191,a1605,20150318,4355,4355,4354,4354,4340,4340,4348,-15,-7,6,260880,480
1192,a1605,20150319,4340,4348,4349,4369,4339,4350,4354,2,6,144,6270740,600
1193,a1605,20150320,4350,4354,4345,4358,4339,4348,4345,-6,-9,230,9995280,806
1194,a1605,20150323,4348,4345,4351,4365,4348,4351,4357,6,12,72,3137560,836
1195,a1605,20150324,4351,4357,4353,4363,4303,4342,4338,-15,-19,182,7896900,968
1196,a1605,20150325,4342,4338,4330,4354,4310,4310,4325,-28,-13,228,9862840,1174
1197,a1605,20150326,4310,4325,4319,4328,4300,4304,4308,-21,-17,374,16113180,1434
1198,a1605,20150327,4304,4308,4305,4328,4305,4320,4311,12,3,116,5001160,1444
1199,a1605,20150330,4320,4311,4311,4320,4286,4320,4294,9,-17,216,9276840,1632
1200,a1605,20150331,4320,4294,4299,4302,4296,4302,4299,8,5,12,515940,1630
1201,a1605,20150401,4302,4299,4320,4337,4320,4321,4324,22,25,22,951480,1636
1202,a1605,20150402,4321,4324,4320,4332,4304,4304,4317,-20,-7,24,1036100,1650
1203,a1605,20150403,4304,4317,4252,4285,4252,4278,4274,-39,-43,248,10599800,1870
1204,a1605,20150407,4278,4274,4271,4271,4247,4247,4256,-27,-18,62,2638860,1904
1205,a1605,20150408,4247,4256,4234,4234,4193,4200,4209,-56,-47,104,4377460,1940
1206,a1605,20150409,4200,4209,4202,4205,4166,4167,4173,-42,-36,204,8514820,2000
1207,a1605,20150410,4167,4173,4197,4197,4168,4173,4181,0,8,126,5269180,1986
1208,a1605,20150413,4173,4181,4182,4247,4181,4235,4213,54,32,182,7668500,2108
1209,a1605,20150414,4235,4213,4247,4271,4241,4271,4247,58,34,114,4842480,2152
1210,a1605,20150415,4271,4247,4266,4288,4259,4259,4272,12,25,62,2648780,2158
1211,a1605,20150416,4259,4272,4266,4280,4266,4266,4270,-6,-2,18,768600,2160
1212,a1605,20150417,4266,4270,4256,4264,4225,4225,4239,-45,-31,864,36626320,2596
1213,a1605,20150420,4225,4239,4233,4233,4160,4196,4192,-43,-47,200,8384860,2598
1214,a1605,20150421,4196,4192,4203,4245,4203,4240,4231,48,39,614,25979060,2322
1215,a1605,20150422,4240,4231,4264,4338,4261,4338,4296,107,65,864,37121240,2236
1216,a1605,20150423,4338,4296,4332,4351,4305,4328,4327,32,31,600,25966560,2364
1217,a1605,20150424,4328,4327,4355,4407,4355,4387,4390,60,63,72,3160820,2386
1218,a1605,20150427,4387,4390,4387,4414,4376,4399,4394,9,4,38,1669720,2390
1219,a1605,20150428,4399,4394,4400,4406,4379,4400,4394,6,0,48,2109200,2392
1220,a1605,20150429,4400,4394,4414,4414,4384,4403,4396,9,2,112,4924140,2330
1221,a1605,20150430,4403,4396,4457,4478,4413,4478,4455,82,59,702,31274660,2154
1222,a1605,20150504,4478,4455,4437,4443,4434,4442,4443,-13,-12,38,1688480,2148
1223,a1605,20150505,4442,4443,4442,4462,4411,4439,4448,-4,5,66,2935800,2152
1224,a1605,20150506,4439,4448,4449,4489,4434,4463,4463,15,15,180,8034980,2124
1225,a1605,20150507,4463,4463,4451,4461,4438,4461,4456,-2,-7,42,1871860,2132
1226,a1605,20150508,4461,4456,4442,4452,4420,4452,4438,-4,-18,44,1952820,2140
1227,a1605,20150511,4452,4438,4467,4515,4445,4508,4494,70,56,224,10067700,2188
1228,a1605,20150512,4508,4494,4502,4528,4494,4512,4503,18,9,336,15131220,2134
1229,a1605,20150513,4512,4503,4503,4529,4500,4523,4523,20,20,868,39264740,2510
1230,a1605,20150514,4523,4523,4524,4544,4500,4533,4527,10,4,564,25533180,2762
1231,a1605,20150515,4533,4527,4532,4536,4523,4532,4529,5,2,120,5435980,2782
1232,a1605,20150518,4532,4529,4520,4520,4492,4514,4503,-15,-26,708,31882420,3144
1233,a1605,20150519,4514,4503,4516,4529,4510,4511,4519,8,16,890,40222920,3656
1234,a1605,20150520,4511,4519,4505,4514,4470,4485,4494,-34,-25,1504,67604140,4704
1235,a1605,20150521,4485,4494,4486,4516,4472,4493,4492,-1,-2,970,43573380,5086
1236,a1605,20150522,4493,4492,4500,4651,4500,4629,4594,137,102,3698,169902680,7490
1237,a1605,20150525,4629,4594,4639,4646,4596,4615,4618,21,24,3280,151477780,8952
1238,a1605,20150526,4615,4618,4607,4640,4606,4608,4621,-10,3,1258,58144200,9608
1239,a1605,20150527,4608,4621,4611,4625,4580,4583,4594,-38,-27,634,29127440,9778
1240,a1605,20150528,4583,4594,4606,4627,4586,4602,4611,8,17,1426,65761080,10452
1241,a1605,20150529,4602,4611,4606,4618,4591,4605,4603,-6,-8,682,31393140,10446
1242,a1605,20150601,4605,4603,4608,4615,4535,4546,4583,-57,-20,1146,52523940,10796
1243,a1605,20150602,4546,4583,4542,4575,4532,4570,4560,-13,-23,680,31011120,10962
1244,a1605,20150603,4570,4560,4574,4601,4574,4584,4587,24,27,1658,76066320,10886
1245,a1605,20150604,4584,4587,4584,4584,4536,4555,4556,-32,-31,552,25153860,10754
1246,a1605,20150605,4555,4556,4555,4557,4476,4479,4508,-77,-48,950,42829400,10712
1247,a1605,20150608,4479,4508,4490,4508,4467,4472,4489,-36,-19,892,40046100,10602
1248,a1605,20150609,4472,4489,4480,4523,4478,4478,4501,-11,12,704,31691380,10584
1249,a1605,20150610,4478,4501,4489,4510,4479,4486,4496,-15,-5,812,36512640,10394
1250,a1605,20150611,4486,4496,4505,4506,4483,4486,4493,-10,-3,802,36035360,10378
1251,a1605,20150612,4486,4493,4487,4487,4380,4380,4423,-113,-70,1550,68568140,10436
1252,a1605,20150615,4380,4423,4399,4399,4351,4353,4378,-70,-45,1002,43872280,10612
1253,a1605,20150616,4353,4378,4358,4424,4350,4386,4394,8,16,1108,48688280,10760
1254,a1605,20150617,4386,4394,4386,4445,4377,4425,4417,31,23,1130,49917460,10798
1255,a1605,20150618,4425,4417,4446,4468,4415,4428,4447,11,30,834,37094780,10918
1256,a1605,20150619,4428,4447,4435,4437,4403,4427,4415,-20,-32,384,16956240,10778
1257,a1605,20150623,4427,4415,4465,4477,4431,4445,4445,30,30,832,36985820,11062
1258,a1605,20150624,4445,4445,4445,4445,4400,4416,4418,-29,-27,430,18999360,11018
1259,a1605,20150625,4416,4418,4416,4444,4402,4410,4416,-8,-2,550,24289820,11016
1260,a1605,20150626,4410,4416,4418,4433,4371,4383,4410,-33,-6,1222,53892060,11190
1261,a1605,20150629,4383,4410,4415,4434,4351,4375,4378,-35,-32,1022,44746280,11298
1262,a1605,20150630,4375,4378,4375,4375,4314,4318,4341,-60,-37,678,29432480,11146
1263,a1605,20150701,4318,4341,4318,4436,4297,4385,4380,44,39,1950,85425940,11192
1264,a1605,20150702,4385,4380,4372,4384,4353,4370,4365,-10,-15,874,38156460,11156
1265,a1605,20150703,4370,4365,4362,4390,4362,4377,4381,12,16,1374,60198820,11138
1266,a1605,20150706,4377,4381,4351,4365,4316,4330,4339,-51,-42,1292,56070400,11138
1267,a1605,20150707,4330,4339,4323,4345,4300,4303,4321,-36,-18,1256,54278980,11274
1268,a1605,20150708,4303,4321,4295,4295,4149,4181,4199,-140,-122,6078,255263320,10936
1269,a1605,20150709,4181,4199,4202,4366,4184,4352,4280,153,81,4112,176025340,11200
1270,a1605,20150710,4352,4280,4352,4450,4350,4416,4402,136,122,4274,188159000,11766
1271,a1605,20150713,4416,4402,4419,4429,4363,4398,4392,-4,-10,2102,92327320,11352
1272,a1605,20150714,4398,4392,4398,4418,4379,4398,4397,6,5,2768,121723800,11538
1273,a1605,20150715,4398,4397,4397,4401,4350,4360,4368,-37,-29,618,26995220,11488
1274,a1605,20150716,4360,4368,4353,4369,4285,4347,4332,-21,-36,2112,91496180,11586
1275,a1605,20150717,4347,4332,4372,4372,4312,4339,4340,7,8,988,42887200,11546
1276,a1605,20150720,4339,4340,4338,4339,4270,4288,4306,-52,-34,1378,59346880,11910
1277,a1605,20150721,4288,4306,4277,4317,4277,4296,4298,-10,-8,572,24585960,12036
1278,a1605,20150722,4296,4298,4288,4300,4259,4284,4275,-14,-23,2260,96632260,12442
1279,a1605,20150723,4284,4275,4280,4306,4259,4296,4285,21,10,1554,66589320,12216
1280,a1605,20150724,4296,4285,4296,4324,4281,4300,4304,15,19,2896,124667300,12704
1281,a1605,20150727,4300,4304,4290,4308,4262,4268,4278,-36,-26,2218,94890880,12866
1282,a1605,20150728,4268,4278,4230,4305,4227,4303,4267,25,-11,1990,84926780,13036
1283,a1605,20150729,4303,4267,4320,4371,4308,4371,4347,104,80,5670,246498320,15432
1284,a1605,20150730,4371,4347,4361,4403,4357,4361,4376,14,29,1670,73095540,15296
1285,a1605,20150731,4361,4376,4375,4390,4355,4376,4370,0,-6,1418,61969920,15698
1286,a1605,20150803,4376,4370,4380,4388,4310,4340,4342,-30,-28,1988,86330160,15686
1287,a1605,20150804,4340,4342,4341,4376,4329,4375,4358,33,16,1746,76094160,15882
1288,a1605,20150805,4375,4358,4381,4390,4356,4370,4370,12,12,1630,71240400,15846
1289,a1605,20150806,4370,4370,4381,4454,4366,4445,4417,75,47,7966,351887520,18630
1290,a1605,20150807,4445,4417,4433,4454,4397,4435,4421,18,4,5248,232038620,20156
1291,a1605,20150810,4435,4421,4435,4482,4430,4471,4460,50,39,5246,234006760,22368
1292,a1605,20150811,4471,4460,4474,4497,4460,4485,4485,25,25,5810,260602160,24476
1293,a1605,20150812,4485,4485,4477,4496,4462,4494,4480,9,-5,2850,127704940,24412
1294,a1605,20150813,4494,4480,4499,4527,4390,4449,4455,-31,-25,4086,182035800,24332
1295,a1605,20150814,4449,4455,4453,4477,4440,4461,4461,6,6,2696,120284460,25646
1296,a1605,20150817,4461,4461,4471,4485,4453,4476,4470,15,9,4274,191065360,27054
1297,a1605,20150818,4476,4470,4478,4491,4421,4421,4455,-49,-15,6044,269277880,26592
1298,a1605,20150819,4421,4455,4421,4445,4401,4429,4422,-26,-33,7816,345629240,26126
1299,a1605,20150820,4429,4422,4440,4447,4395,4412,4431,-10,9,13574,601582320,29220
1300,a1605,20150821,4412,4431,4413,4450,4409,4422,4429,-9,-2,9420,417220600,30606
1301,a1605,20150824,4422,4429,4423,4424,4319,4337,4361,-92,-68,13454,586791560,29724
1302,a1605,20150825,4337,4361,4300,4377,4293,4343,4346,-18,-15,13582,590373060,28860
1303,a1605,20150826,4343,4346,4366,4400,4332,4339,4361,-7,15,13840,603630620,30740
1304,a1605,20150827,4339,4361,4340,4355,4296,4339,4330,-22,-31,10008,433372680,28296
1305,a1605,20150828,4339,4330,4339,4371,4266,4275,4308,-55,-22,19642,846277380,31868
1306,a1605,20150831,4275,4308,4273,4310,4254,4281,4282,-27,-26,16298,697960320,32484
1307,a1605,20150901,4281,4282,4275,4319,4269,4309,4302,27,20,15160,652302580,35394
1308,a1605,20150902,4309,4302,4300,4324,4290,4316,4308,14,6,5832,251269180,35694
1309,a1605,20150907,4316,4308,4302,4305,4257,4262,4275,-46,-33,6304,269550040,35104
1310,a1605,20150908,4262,4275,4266,4288,4240,4281,4259,6,-16,8210,349710960,35962
1311,a1605,20150909,4281,4259,4275,4310,4259,4263,4288,4,29,10694,458601140,36240
1312,a1605,20150910,4263,4288,4275,4298,4251,4290,4273,2,-15,7640,326507920,36298
1313,a1605,20150911,4290,4273,4273,4336,4271,4303,4305,30,32,12814,551730920,36880
1314,a1605,20150914,4303,4305,4300,4316,4276,4280,4301,-25,-4,8026,345265420,37454
1315,a1605,20150915,4280,4301,4282,4307,4270,4275,4293,-26,-8,9666,414984300,37678
1316,a1605,20150916,4275,4293,4256,4301,4251,4300,4273,7,-20,11370,485858020,36450
1317,a1605,20150917,4300,4273,4300,4307,4280,4281,4292,8,19,8732,374785800,36274
1318,a1605,20150918,4281,4292,4278,4300,4260,4262,4280,-30,-12,7638,326918840,36296
1319,a1605,20150921,4262,4280,4260,4270,4195,4230,4217,-50,-63,20894,881274020,38786
1320,a1605,20150922,4230,4217,4232,4239,4189,4198,4208,-19,-9,10258,431710620,38990
1321,a1605,20150923,4198,4208,4197,4199,4168,4187,4183,-21,-25,11582,484543180,39822
1322,a1605,20150924,4187,4183,4190,4208,4164,4170,4181,-13,-2,13652,570807080,43054
1323,a1605,20150925,4170,4181,4166,4198,4134,4164,4171,-17,-10,27244,1136496780,44406
1324,a1605,20150928,4164,4171,4178,4192,4144,4151,4160,-20,-11,11154,464086580,44120
1325,a1605,20150929,4151,4160,4152,4204,4119,4203,4166,43,6,22974,957203200,43288
1326,a1605,20150930,4203,4166,4199,4225,4182,4189,4202,23,36,17464,733880500,43654
1327,a1605,20151008,4189,4202,4194,4205,4020,4042,4093,-160,-109,47622,1949478020,46164
1328,a1605,20151009,4042,4093,4050,4084,3976,4030,4028,-63,-65,80860,3257209460,47442
1329,a1605,20151012,4030,4028,4038,4094,4007,4089,4050,61,22,39138,1585397620,47002
1330,a1605,20151013,4089,4050,4082,4083,4051,4064,4065,14,15,39852,1620358720,50732
1331,a1605,20151014,4064,4065,4062,4081,4011,4040,4046,-25,-19,61302,2480845640,59220
1332,a1605,20151015,4040,4046,4055,4075,4042,4056,4057,10,11,23394,949173900,58648
1333,a1605,20151016,4056,4057,4047,4058,3960,3966,3997,-91,-60,65382,2613897860,75492
1334,a1605,20151019,3966,3997,3958,3971,3925,3939,3947,-58,-50,45062,1779004180,83842
1335,a1605,20151020,3939,3947,3918,3953,3893,3919,3923,-28,-24,51198,2008742420,93144
1336,a1605,20151021,3919,3923,3925,3935,3904,3906,3918,-17,-5,34666,1358402520,91904
1337,a1605,20151022,3906,3918,3902,3952,3875,3943,3914,25,-4,74884,2931552940,92786
1338,a1605,20151023,3943,3914,3940,3992,3888,3937,3924,23,10,61112,2398331280,87742
1339,a1605,20151026,3937,3924,3950,3952,3853,3879,3898,-45,-26,68042,2652913120,103918
1340,a1605,20151027,3879,3898,3880,3881,3822,3861,3845,-37,-53,64776,2491046320,109376
1341,a1605,20151028,3861,3845,3863,3874,3818,3827,3844,-18,-1,34962,1344197600,110900
1342,a1605,20151029,3827,3844,3822,3845,3803,3822,3826,-22,-18,43542,1666115420,112584
1343,a1605,20151030,3822,3826,3814,3847,3804,3821,3819,-5,-7,62288,2379213320,121152
1344,a1605,20151102,3821,3819,3819,3841,3819,3830,3830,11,11,27240,1043460340,122240
1345,a1605,20151103,3830,3830,3827,3844,3811,3830,3825,0,-5,31334,1198807800,125328
1346,a1605,20151104,3830,3825,3826,3895,3826,3873,3868,48,43,81780,3163877020,119180
1347,a1605,20151105,3873,3868,3861,3874,3842,3848,3859,-20,-9,33788,1303894640,121478
1348,a1605,20151106,3848,3859,3848,3862,3808,3860,3835,1,-24,51936,1991996460,123744
1349,a1605,20151109,3860,3835,3859,3889,3821,3848,3855,13,20,62646,2415625120,123770
1350,a1605,20151110,3848,3855,3844,3855,3824,3836,3836,-19,-19,36134,1386161440,125250
1351,a1605,20151111,3836,3836,3836,3860,3775,3838,3814,2,-22,100396,3829406220,136102
1352,a1605,20151112,3838,3814,3843,3872,3834,3861,3854,47,40,63370,2442795780,139854
1353,a1605,20151113,3861,3854,3851,3894,3850,3873,3874,19,20,71120,2755760900,139138
1354,a1605,20151116,3873,3874,3854,3883,3766,3767,3817,-107,-57,119724,4570519220,162382
1355,a1605,20151117,3767,3817,3777,3783,3731,3754,3759,-63,-58,142882,5371681020,188138
1356,a1605,20151118,3754,3759,3756,3790,3750,3766,3770,7,11,98602,3717969160,198544
1357,a1605,20151119,3766,3770,3767,3771,3670,3678,3714,-92,-56,190854,7090082760,211938
1358,a1605,20151120,3678,3714,3675,3696,3650,3653,3674,-61,-40,121378,4460600920,212408
1359,a1605,20151123,3653,3674,3650,3722,3642,3692,3690,18,16,189190,6982901500,220588
1360,a1605,20151124,3692,3690,3696,3753,3675,3745,3722,55,32,139250,5184018120,219458
1361,a1605,20151125,3745,3722,3745,3758,3703,3718,3729,-4,7,152714,5695652520,216906
1362,a1605,20151126,3718,3729,3710,3775,3704,3757,3749,28,20,115274,4322138500,207178
1363,a1605,20151127,3757,3749,3750,3765,3709,3727,3734,-22,-15,97476,3640260100,210150
1364,a1605,20151130,3727,3734,3727,3768,3703,3758,3735,24,1,117168,4376670260,209228
1365,a1605,20151201,3758,3735,3756,3782,3747,3768,3763,33,28,109872,4135238340,204566
1366,a1605,20151202,3768,3763,3776,3820,3730,3744,3776,-19,13,226670,8559466740,195926
1367,a1605,20151203,3744,3776,3743,3793,3717,3787,3755,11,-21,173874,6530036020,187054
1368,a1605,20151204,3787,3755,3788,3808,3772,3780,3789,25,34,123458,4678477740,180952
1369,a1605,20151207,3780,3789,3784,3815,3762,3799,3792,10,3,89570,3396978120,181308
1370,a1605,20151208,3799,3792,3803,3803,3737,3747,3763,-45,-29,147062,5533981420,187380
1371,a1605,20151209,3747,3763,3750,3755,3728,3739,3742,-24,-21,97774,3659491380,183660
1372,a1605,20151210,3739,3742,3743,3749,3712,3730,3731,-12,-11,106738,3983091620,179902
1373,a1605,20151211,3730,3731,3727,3738,3696,3730,3714,-1,-17,117402,4361118880,177732
1374,a1605,20151214,3730,3714,3725,3743,3674,3677,3701,-37,-13,145634,5390824880,196244
1375,a1605,20151215,3677,3701,3668,3689,3646,3651,3667,-50,-34,166030,6089578940,228172
1376,a1605,20151216,3651,3667,3646,3695,3644,3681,3670,14,3,122280,4488771060,208500
1377,a1605,20151217,3681,3670,3680,3720,3673,3700,3699,30,29,138740,5132335200,183156
1378,a1605,20151218,3700,3699,3700,3730,3684,3726,3705,27,6,85408,3164592920,176864
1379,a1605,20151221,3726,3705,3726,3757,3725,3749,3742,44,37,90036,3369355140,167264
1380,a1605,20151222,3749,3742,3749,3763,3705,3706,3738,-36,-4,92394,3454142560,170598
1381,a1605,20151223,3706,3738,3708,3720,3689,3713,3703,-25,-35,113010,4185263240,171656
1382,a1605,20151224,3713,3703,3713,3719,3692,3701,3706,-2,3,64164,2378354160,169784
1383,a1605,20151225,3701,3706,3697,3733,3661,3668,3697,-38,-9,134840,4985238940,185548
1384,a1605,20151228,3668,3697,3668,3676,3580,3599,3619,-98,-78,256660,9290125080,217654
1385,a1605,20151229,3599,3619,3609,3635,3589,3622,3610,3,-9,192072,6934563280,209538
1386,a1605,20151230,3622,3610,3620,3658,3612,3631,3633,21,23,147836,5371991880,197838
1387,a1605,20151231,3631,3633,3626,3632,3602,3620,3615,-13,-18,174314,6301764800,197982
1388,a1607,20150119,4420,4420,0,0,0,4420,4420,0,0,0,0,0
1389,a1607,20150120,4420,4420,4584,4584,4388,4390,4440,-30,20,8,355240,6
1390,a1607,20150121,4390,4440,0,0,0,4420,4420,-20,-20,0,0,6
1391,a1607,20150122,4420,4420,0,0,0,4395,4395,-25,-25,0,0,6
1392,a1607,20150123,4395,4395,4390,4390,4390,4390,4390,-5,-5,2,87800,8
1393,a1607,20150126,4390,4390,0,0,0,4390,4390,0,0,0,0,8
1394,a1607,20150127,4390,4390,0,0,0,4407,4407,17,17,0,0,8
1395,a1607,20150128,4407,4407,0,0,0,4399,4399,-8,-8,0,0,8
1396,a1607,20150129,4399,4399,0,0,0,4413,4413,14,14,0,0,8
1397,a1607,20150130,4413,4413,0,0,0,4413,4413,0,0,0,0,8
1398,a1607,20150202,4413,4413,0,0,0,4413,4413,0,0,0,0,8
1399,a1607,20150203,4413,4413,0,0,0,4413,4413,0,0,0,0,8
1400,a1607,20150204,4413,4413,0,0,0,4413,4413,0,0,0,0,8
1401,a1607,20150205,4413,4413,0,0,0,4413,4413,0,0,0,0,8
1402,a1607,20150206,4413,4413,4385,4430,4385,4430,4407,17,-6,4,176300,8
1403,a1607,20150209,4430,4407,0,0,0,4407,4407,0,0,0,0,8
1404,a1607,20150210,4407,4407,4380,4380,4380,4380,4380,-27,-27,2,87600,6
1405,a1607,20150211,4380,4380,0,0,0,4380,4380,0,0,0,0,6
1406,a1607,20150212,4380,4380,0,0,0,4380,4380,0,0,0,0,6
1407,a1607,20150213,4380,4380,4318,4499,4318,4381,4399,1,19,8,351940,6
1408,a1607,20150216,4381,4399,0,0,0,4399,4399,0,0,0,0,6
1409,a1607,20150217,4399,4399,4421,4421,4421,4421,4421,22,22,2,88420,6
1410,a1607,20150225,4421,4421,0,0,0,4421,4421,0,0,0,0,6
1411,a1607,20150226,4421,4421,0,0,0,4421,4421,0,0,0,0,6
1412,a1607,20150227,4421,4421,0,0,0,4421,4421,0,0,0,0,6
1413,a1607,20150302,4421,4421,0,0,0,4421,4421,0,0,0,0,6
1414,a1607,20150303,4421,4421,0,0,0,4421,4421,0,0,0,0,6
1415,a1607,20150304,4421,4421,0,0,0,4421,4421,0,0,0,0,6
1416,a1607,20150305,4421,4421,0,0,0,4421,4421,0,0,0,0,6
1417,a1607,20150306,4421,4421,0,0,0,4421,4421,0,0,0,0,6
1418,a1607,20150309,4421,4421,0,0,0,4421,4421,0,0,0,0,6
1419,a1607,20150310,4421,4421,0,0,0,4421,4421,0,0,0,0,6
1420,a1607,20150311,4421,4421,4399,4442,4392,4419,4411,-2,-10,18,793980,8
1421,a1607,20150312,4419,4411,0,0,0,4411,4411,0,0,0,0,8
1422,a1607,20150313,4411,4411,0,0,0,4411,4411,0,0,0,0,8
1423,a1607,20150316,4411,4411,0,0,0,4411,4411,0,0,0,0,8
1424,a1607,20150317,4411,4411,0,0,0,4428,4428,17,17,0,0,8
1425,a1607,20150318,4428,4428,0,0,0,4428,4428,0,0,0,0,8
1426,a1607,20150319,4428,4428,0,0,0,4434,4434,6,6,0,0,8
1427,a1607,20150320,4434,4434,0,0,0,4434,4434,0,0,0,0,8
1428,a1607,20150323,4434,4434,0,0,0,4446,4446,12,12,0,0,8
1429,a1607,20150324,4446,4446,4381,4390,4381,4390,4385,-56,-61,4,175420,6
1430,a1607,20150325,4390,4385,0,0,0,4385,4385,0,0,0,0,6
1431,a1607,20150326,4385,4385,0,0,0,4385,4385,0,0,0,0,6
1432,a1607,20150327,4385,4385,0,0,0,4388,4388,3,3,0,0,6
1433,a1607,20150330,4388,4388,0,0,0,4388,4388,0,0,0,0,6
1434,a1607,20150331,4388,4388,0,0,0,4393,4393,5,5,0,0,6
1435,a1607,20150401,4393,4393,0,0,0,4393,4393,0,0,0,0,6
1436,a1607,20150402,4393,4393,0,0,0,4386,4386,-7,-7,0,0,6
1437,a1607,20150403,4386,4386,0,0,0,4386,4386,0,0,0,0,6
1438,a1607,20150407,4386,4386,0,0,0,4375,4375,-11,-11,0,0,6
1439,a1607,20150408,4375,4375,4305,4305,4305,4305,4305,-70,-70,2,86100,6
1440,a1607,20150409,4305,4305,0,0,0,4295,4295,-10,-10,0,0,6
1441,a1607,20150410,4295,4295,4271,4271,4270,4270,4270,-25,-25,4,170820,6
1442,a1607,20150413,4270,4270,4300,4337,4272,4272,4291,2,21,14,600840,14
1443,a1607,20150414,4272,4291,0,0,0,4291,4291,0,0,0,0,14
1444,a1607,20150415,4291,4291,0,0,0,4316,4316,25,25,0,0,14
1445,a1607,20150416,4316,4316,0,0,0,4316,4316,0,0,0,0,14
1446,a1607,20150417,4316,4316,4315,4315,4290,4290,4302,-26,-14,4,172100,16
1447,a1607,20150420,4290,4302,4269,4269,4269,4269,4269,-33,-33,2,85380,16
1448,a1607,20150421,4269,4269,0,0,0,4269,4269,0,0,0,0,16
1449,a1607,20150422,4269,4269,0,0,0,4334,4334,65,65,0,0,16
1450,a1607,20150423,4334,4334,4349,4349,4349,4349,4349,15,15,2,86980,16
1451,a1607,20150424,4349,4349,0,0,0,4349,4349,0,0,0,0,16
1452,a1607,20150427,4349,4349,4351,4460,4339,4350,4393,1,44,12,527160,20
1453,a1607,20150428,4350,4393,0,0,0,4393,4393,0,0,0,0,20
1454,a1607,20150429,4393,4393,0,0,0,4394,4394,1,1,0,0,20
1455,a1607,20150430,4394,4394,0,0,0,4459,4459,65,65,0,0,20
1456,a1607,20150504,4459,4459,4448,4448,4448,4448,4448,-11,-11,2,88960,18
1457,a1607,20150505,4448,4448,4449,4486,4449,4486,4473,38,25,6,268400,16
1458,a1607,20150506,4486,4473,4470,4489,4380,4489,4442,16,-31,12,533080,14
1459,a1607,20150507,4489,4442,4485,4485,4396,4481,4454,39,12,6,267240,14
1460,a1607,20150508,4481,4454,0,0,0,4437,4437,-17,-17,0,0,14
1461,a1607,20150511,4437,4437,0,0,0,4496,4496,59,59,0,0,14
1462,a1607,20150512,4496,4496,0,0,0,4496,4496,0,0,0,0,14
1463,a1607,20150513,4496,4496,4465,4539,4465,4539,4502,43,6,4,180080,14
1464,a1607,20150514,4539,4502,4510,4545,4510,4545,4527,43,25,4,181100,14
1465,a1607,20150515,4545,4527,4589,4589,4531,4531,4560,4,33,4,182400,14
1466,a1607,20150518,4531,4560,4550,4550,4515,4515,4532,-45,-28,4,181300,14
1467,a1607,20150519,4515,4532,0,0,0,4548,4548,16,16,0,0,14
1468,a1607,20150520,4548,4548,4528,4528,4528,4528,4528,-20,-20,8,362240,14
1469,a1607,20150521,4528,4528,0,0,0,4526,4526,-2,-2,0,0,14
1470,a1607,20150522,4526,4526,0,0,0,4628,4628,102,102,0,0,14
1471,a1607,20150525,4628,4628,0,0,0,4652,4652,24,24,0,0,14
1472,a1607,20150526,4652,4652,0,0,0,4655,4655,3,3,0,0,14
1473,a1607,20150527,4655,4655,0,0,0,4628,4628,-27,-27,0,0,14
1474,a1607,20150528,4628,4628,0,0,0,4628,4628,0,0,0,0,14
1475,a1607,20150529,4628,4628,4690,4690,4650,4650,4670,22,42,4,186800,16
1476,a1607,20150601,4650,4670,4610,4613,4610,4613,4611,-57,-59,4,184460,14
1477,a1607,20150602,4613,4611,0,0,0,4611,4611,0,0,0,0,14
1478,a1607,20150603,4611,4611,0,0,0,4611,4611,0,0,0,0,14
1479,a1607,20150604,4611,4611,0,0,0,4580,4580,-31,-31,0,0,14
1480,a1607,20150605,4580,4580,0,0,0,4532,4532,-48,-48,0,0,14
1481,a1607,20150608,4532,4532,0,0,0,4513,4513,-19,-19,0,0,14
1482,a1607,20150609,4513,4513,0,0,0,4513,4513,0,0,0,0,14
1483,a1607,20150610,4513,4513,0,0,0,4508,4508,-5,-5,0,0,14
1484,a1607,20150611,4508,4508,0,0,0,4508,4508,0,0,0,0,14
1485,a1607,20150612,4508,4508,0,0,0,4438,4438,-70,-70,0,0,14
1486,a1607,20150615,4438,4438,0,0,0,4430,4430,-8,-8,0,0,14
1487,a1607,20150616,4430,4430,0,0,0,4446,4446,16,16,0,0,14
1488,a1607,20150617,4446,4446,0,0,0,4446,4446,0,0,0,0,14
1489,a1607,20150618,4446,4446,0,0,0,4446,4446,0,0,0,0,14
1490,a1607,20150619,4446,4446,0,0,0,4446,4446,0,0,0,0,14
1491,a1607,20150623,4446,4446,0,0,0,4446,4446,0,0,0,0,14
1492,a1607,20150624,4446,4446,4530,4530,4400,4400,4465,-46,19,8,357220,14
1493,a1607,20150625,4400,4465,4538,4538,4538,4538,4538,73,73,4,181520,18
1494,a1607,20150626,4538,4538,0,0,0,4480,4480,-58,-58,0,0,18
1495,a1607,20150629,4480,4480,0,0,0,4450,4450,-30,-30,0,0,18
1496,a1607,20150630,4450,4450,0,0,0,4410,4410,-40,-40,0,0,18
1497,a1607,20150701,4410,4410,0,0,0,4410,4410,0,0,0,0,18
1498,a1607,20150702,4410,4410,0,0,0,4395,4395,-15,-15,0,0,18
1499,a1607,20150703,4395,4395,4494,4494,4426,4426,4460,31,65,8,356800,18
1500,a1607,20150706,4426,4460,4445,4445,4348,4382,4391,-78,-69,6,263500,18
1501,a1607,20150707,4382,4391,4320,4320,4320,4320,4320,-71,-71,2,86400,16
1502,a1607,20150708,4320,4320,4196,4268,4196,4196,4206,-124,-114,20,841280,16
1503,a1607,20150709,4196,4206,4210,4373,4158,4355,4310,149,104,38,1637820,10
1504,a1607,20150710,4355,4310,4466,4466,4465,4465,4465,155,155,4,178620,12
1505,a1607,20150713,4465,4465,4494,4494,4444,4444,4469,-21,4,4,178760,12
1506,a1607,20150714,4444,4469,4499,4499,4499,4499,4499,30,30,2,89980,10
1507,a1607,20150715,4499,4499,0,0,0,4470,4470,-29,-29,0,0,10
1508,a1607,20150716,4470,4470,0,0,0,4434,4434,-36,-36,0,0,10
1509,a1607,20150717,4434,4434,0,0,0,4442,4442,8,8,0,0,10
1510,a1607,20150720,4442,4442,4411,4411,4313,4320,4348,-122,-94,6,260880,8
1511,a1607,20150721,4320,4348,0,0,0,4340,4340,-8,-8,0,0,8
1512,a1607,20150722,4340,4340,0,0,0,4317,4317,-23,-23,0,0,8
1513,a1607,20150723,4317,4317,4339,4350,4339,4350,4344,33,27,4,173780,8
1514,a1607,20150724,4350,4344,0,0,0,4363,4363,19,19,0,0,8
1515,a1607,20150727,4363,4363,0,0,0,4363,4363,0,0,0,0,8
1516,a1607,20150728,4363,4363,4358,4358,4281,4281,4319,-82,-44,4,172780,8
1517,a1607,20150729,4281,4319,0,0,0,4399,4399,80,80,0,0,8
1518,a1607,20150730,4399,4399,0,0,0,4428,4428,29,29,0,0,8
1519,a1607,20150731,4428,4428,0,0,0,4422,4422,-6,-6,0,0,8
1520,a1607,20150803,4422,4422,0,0,0,4394,4394,-28,-28,0,0,8
1521,a1607,20150804,4394,4394,0,0,0,4410,4410,16,16,0,0,8
1522,a1607,20150805,4410,4410,0,0,0,4422,4422,12,12,0,0,8
1523,a1607,20150806,4422,4422,0,0,0,4469,4469,47,47,0,0,8
1524,a1607,20150807,4469,4469,4479,4479,4470,4470,4475,1,6,8,358000,8
1525,a1607,20150810,4470,4475,4470,4530,4470,4530,4490,55,15,6,269400,10
1526,a1607,20150811,4530,4490,0,0,0,4490,4490,0,0,0,0,10
1527,a1607,20150812,4490,4490,0,0,0,4490,4490,0,0,0,0,10
1528,a1607,20150813,4490,4490,0,0,0,4490,4490,0,0,0,0,10
1529,a1607,20150814,4490,4490,4530,4559,4461,4461,4511,-29,21,20,902220,16
1530,a1607,20150817,4461,4511,0,0,0,4511,4511,0,0,0,0,16
1531,a1607,20150818,4511,4511,0,0,0,4511,4511,0,0,0,0,16
1532,a1607,20150819,4511,4511,0,0,0,4504,4504,-7,-7,0,0,16
1533,a1607,20150820,4504,4504,4452,4453,4420,4420,4439,-84,-65,10,443960,10
1534,a1607,20150821,4420,4439,4482,4482,4439,4439,4460,0,21,4,178420,10
1535,a1607,20150824,4439,4460,0,0,0,4392,4392,-68,-68,0,0,10
1536,a1607,20150825,4392,4392,0,0,0,4392,4392,0,0,0,0,10
1537,a1607,20150826,4392,4392,0,0,0,4407,4407,15,15,0,0,10
1538,a1607,20150827,4407,4407,0,0,0,4376,4376,-31,-31,0,0,10
1539,a1607,20150828,4376,4376,0,0,0,4354,4354,-22,-22,0,0,10
1540,a1607,20150831,4354,4354,0,0,0,4328,4328,-26,-26,0,0,10
1541,a1607,20150901,4328,4328,0,0,0,4348,4348,20,20,0,0,10
1542,a1607,20150902,4348,4348,0,0,0,4354,4354,6,6,0,0,10
1543,a1607,20150907,4354,4354,0,0,0,4321,4321,-33,-33,0,0,10
1544,a1607,20150908,4321,4321,0,0,0,4305,4305,-16,-16,0,0,10
1545,a1607,20150909,4305,4305,0,0,0,4334,4334,29,29,0,0,10
1546,a1607,20150910,4334,4334,0,0,0,4319,4319,-15,-15,0,0,10
1547,a1607,20150911,4319,4319,0,0,0,4351,4351,32,32,0,0,10
1548,a1607,20150914,4351,4351,0,0,0,4347,4347,-4,-4,0,0,10
1549,a1607,20150915,4347,4347,0,0,0,4339,4339,-8,-8,0,0,10
1550,a1607,20150916,4339,4339,0,0,0,4319,4319,-20,-20,0,0,10
1551,a1607,20150917,4319,4319,0,0,0,4338,4338,19,19,0,0,10
1552,a1607,20150918,4338,4338,0,0,0,4326,4326,-12,-12,0,0,10
1553,a1607,20150921,4326,4326,0,0,0,4263,4263,-63,-63,0,0,10
1554,a1607,20150922,4263,4263,4204,4204,4204,4204,4204,-59,-59,8,336320,6
1555,a1607,20150923,4204,4204,0,0,0,4180,4180,-24,-24,0,0,6
1556,a1607,20150924,4180,4180,0,0,0,4179,4179,-1,-1,0,0,6
1557,a1607,20150925,4179,4179,0,0,0,4179,4179,0,0,0,0,6
1558,a1607,20150928,4179,4179,0,0,0,4168,4168,-11,-11,0,0,6
1559,a1607,20150929,4168,4168,4012,4191,4012,4158,4120,-10,-48,6,247220,6
1560,a1607,20150930,4158,4120,0,0,0,4155,4155,35,35,0,0,6
1561,a1607,20151008,4155,4155,0,0,0,4048,4048,-107,-107,0,0,6
1562,a1607,20151009,4048,4048,0,0,0,3984,3984,-64,-64,0,0,6
1563,a1607,20151012,3984,3984,0,0,0,4005,4005,21,21,0,0,6
1564,a1607,20151013,4005,4005,0,0,0,4005,4005,0,0,0,0,6
1565,a1607,20151014,4005,4005,0,0,0,3987,3987,-18,-18,0,0,6
1566,a1607,20151015,3987,3987,0,0,0,3997,3997,10,10,0,0,6
1567,a1607,20151016,3997,3997,0,0,0,3938,3938,-59,-59,0,0,6
1568,a1607,20151019,3938,3938,0,0,0,3889,3889,-49,-49,0,0,6
1569,a1607,20151020,3889,3889,0,0,0,3866,3866,-23,-23,0,0,6
1570,a1607,20151021,3866,3866,0,0,0,3862,3862,-4,-4,0,0,6
1571,a1607,20151022,3862,3862,0,0,0,3859,3859,-3,-3,0,0,6
1572,a1607,20151023,3859,3859,0,0,0,3868,3868,9,9,0,0,6
1573,a1607,20151026,3868,3868,0,0,0,3843,3843,-25,-25,0,0,6
1574,a1607,20151027,3843,3843,3857,3857,3857,3857,3857,14,14,6,231420,12
1575,a1607,20151028,3857,3857,0,0,0,3856,3856,-1,-1,0,0,12
1576,a1607,20151029,3856,3856,3832,3832,3832,3832,3832,-24,-24,10,383200,20
1577,a1607,20151030,3832,3832,3806,3806,3801,3801,3802,-31,-30,10,380260,12
1578,a1607,20151102,3801,3802,0,0,0,3812,3812,10,10,0,0,12
1579,a1607,20151103,3812,3812,3770,3806,3770,3806,3788,-6,-24,4,151520,12
1580,a1607,20151104,3806,3788,0,0,0,3830,3830,42,42,0,0,12
1581,a1607,20151105,3830,3830,0,0,0,3830,3830,0,0,0,0,12
1582,a1607,20151106,3830,3830,0,0,0,3807,3807,-23,-23,0,0,12
1583,a1607,20151109,3807,3807,0,0,0,3826,3826,19,19,0,0,12
1584,a1607,20151110,3826,3826,0,0,0,3808,3808,-18,-18,0,0,12
1585,a1607,20151111,3808,3808,0,0,0,3787,3787,-21,-21,0,0,12
1586,a1607,20151112,3787,3787,0,0,0,3826,3826,39,39,0,0,12
1587,a1607,20151113,3826,3826,0,0,0,3845,3845,19,19,0,0,12
1588,a1607,20151116,3845,3845,3781,3781,3781,3781,3781,-64,-64,2,75620,10
1589,a1607,20151117,3781,3781,0,0,0,3724,3724,-57,-57,0,0,10
1590,a1607,20151118,3724,3724,0,0,0,3734,3734,10,10,0,0,10
1591,a1607,20151119,3734,3734,0,0,0,3679,3679,-55,-55,0,0,10
1592,a1607,20151120,3679,3679,0,0,0,3640,3640,-39,-39,0,0,10
1593,a1607,20151123,3640,3640,0,0,0,3655,3655,15,15,0,0,10
1594,a1607,20151124,3655,3655,0,0,0,3686,3686,31,31,0,0,10
1595,a1607,20151125,3686,3686,0,0,0,3692,3692,6,6,0,0,10
1596,a1607,20151126,3692,3692,0,0,0,3711,3711,19,19,0,0,10
1597,a1607,20151127,3711,3711,0,0,0,3697,3697,-14,-14,0,0,10
1598,a1607,20151130,3697,3697,0,0,0,3697,3697,0,0,0,0,10
1599,a1607,20151201,3697,3697,3712,3790,3712,3790,3733,93,36,8,298680,10
1600,a1607,20151202,3790,3733,0,0,0,3745,3745,12,12,0,0,10
1601,a1607,20151203,3745,3745,0,0,0,3725,3725,-20,-20,0,0,10
1602,a1607,20151204,3725,3725,0,0,0,3758,3758,33,33,0,0,10
1603,a1607,20151207,3758,3758,0,0,0,3760,3760,2,2,0,0,10
1604,a1607,20151208,3760,3760,0,0,0,3760,3760,0,0,0,0,10
1605,a1607,20151209,3760,3760,0,0,0,3757,3757,-3,-3,0,0,10
1606,a1607,20151210,3757,3757,0,0,0,3755,3755,-2,-2,0,0,10
1607,a1607,20151211,3755,3755,0,0,0,3738,3738,-17,-17,0,0,10
1608,a1607,20151214,3738,3738,0,0,0,3725,3725,-13,-13,0,0,10
1609,a1607,20151215,3725,3725,3710,3710,3710,3710,3710,-15,-15,2,74200,10
1610,a1607,20151216,3710,3710,0,0,0,3713,3713,3,3,0,0,10
1611,a1607,20151217,3713,3713,0,0,0,3742,3742,29,29,0,0,10
1612,a1607,20151218,3742,3742,0,0,0,3748,3748,6,6,0,0,10
1613,a1607,20151221,3748,3748,0,0,0,3785,3785,37,37,0,0,10
1614,a1607,20151222,3785,3785,0,0,0,3781,3781,-4,-4,0,0,10
1615,a1607,20151223,3781,3781,0,0,0,3746,3746,-35,-35,0,0,10
1616,a1607,20151224,3746,3746,0,0,0,3749,3749,3,3,0,0,10
1617,a1607,20151225,3749,3749,0,0,0,3740,3740,-9,-9,0,0,10
1618,a1607,20151228,3740,3740,0,0,0,3662,3662,-78,-78,0,0,10
1619,a1607,20151229,3662,3662,0,0,0,3653,3653,-9,-9,0,0,10
1620,a1607,20151230,3653,3653,0,0,0,3676,3676,23,23,0,0,10
1621,a1607,20151231,3676,3676,3596,3596,3596,3596,3596,-80,-80,2,71920,10
1622,a1609,20150316,4362,4362,0,0,0,4353,4353,-9,-9,0,0,0
1623,a1609,20150317,4353,4353,0,0,0,4353,4353,0,0,0,0,0
1624,a1609,20150318,4353,4353,4460,4460,4460,4460,4460,107,107,20,892000,20
1625,a1609,20150319,4460,4460,4382,4382,4382,4382,4382,-78,-78,2,87640,22
1626,a1609,20150320,4382,4382,4325,4387,4325,4387,4366,5,-16,8,349280,24
1627,a1609,20150323,4387,4366,4468,4469,4440,4445,4457,79,91,64,2852920,76
1628,a1609,20150324,4445,4457,4460,4463,4423,4463,4446,6,-11,18,800300,70
1629,a1609,20150325,4463,4446,4436,4443,4369,4425,4424,-21,-22,12,530940,72
1630,a1609,20150326,4425,4424,4381,4422,4305,4305,4369,-119,-55,6,262160,74
1631,a1609,20150327,4305,4369,4368,4400,4368,4400,4384,31,15,4,175360,74
1632,a1609,20150330,4400,4384,4374,4380,4374,4380,4377,-4,-7,6,262640,74
1633,a1609,20150331,4380,4377,0,0,0,4377,4377,0,0,0,0,74
1634,a1609,20150401,4377,4377,0,0,0,4377,4377,0,0,0,0,74
1635,a1609,20150402,4377,4377,0,0,0,4377,4377,0,0,0,0,74
1636,a1609,20150403,4377,4377,4365,4387,4353,4379,4368,2,-9,16,699000,72
1637,a1609,20150407,4379,4368,4352,4368,4338,4338,4353,-30,-15,40,1741380,70
1638,a1609,20150408,4338,4353,4244,4316,4244,4302,4284,-51,-69,16,685500,64
1639,a1609,20150409,4302,4284,4201,4302,4201,4263,4262,-21,-22,8,340960,64
1640,a1609,20150410,4263,4262,4292,4292,4249,4262,4267,0,5,6,256060,66
1641,a1609,20150413,4262,4267,4300,4332,4283,4332,4304,65,37,24,1032980,76
1642,a1609,20150414,4332,4304,4310,4331,4306,4306,4317,2,13,18,777080,82
1643,a1609,20150415,4306,4317,4337,4337,4297,4297,4317,-20,0,8,345420,84
1644,a1609,20150416,4297,4317,0,0,0,4317,4317,0,0,0,0,84
1645,a1609,20150417,4317,4317,4323,4323,4307,4307,4316,-10,-1,20,863260,78
1646,a1609,20150420,4307,4316,4320,4320,4320,4320,4320,4,4,2,86400,78
1647,a1609,20150421,4320,4320,0,0,0,4320,4320,0,0,0,0,78
1648,a1609,20150422,4320,4320,4270,4369,4270,4369,4346,49,26,20,869280,70
1649,a1609,20150423,4369,4346,4363,4386,4325,4376,4360,30,14,30,1308060,76
1650,a1609,20150424,4376,4360,4377,4433,4377,4425,4418,65,58,70,3092820,76
1651,a1609,20150427,4425,4418,4430,4457,4421,4425,4436,7,18,28,1242120,84
1652,a1609,20150428,4425,4436,4447,4447,4421,4421,4434,-15,-2,4,177360,84
1653,a1609,20150429,4421,4434,4447,4447,4426,4426,4436,-8,2,4,177460,84
1654,a1609,20150430,4426,4436,4473,4525,4471,4500,4493,64,57,76,3414820,80
1655,a1609,20150504,4500,4493,4480,4495,4466,4466,4475,-27,-18,12,537100,76
1656,a1609,20150505,4466,4475,4467,4490,4435,4459,4468,-16,-7,34,1519400,76
1657,a1609,20150506,4459,4468,4461,4500,4461,4480,4479,12,11,36,1612780,84
1658,a1609,20150507,4480,4479,4487,4487,4460,4485,4479,6,0,14,627060,88
1659,a1609,20150508,4485,4479,4450,4480,4450,4470,4467,-9,-12,34,1518980,88
1660,a1609,20150511,4470,4467,4490,4532,4451,4532,4507,65,40,84,3786580,128
1661,a1609,20150512,4532,4507,4542,4542,4515,4542,4535,35,28,20,907140,132
1662,a1609,20150513,4542,4535,4492,4550,4401,4550,4526,15,-9,64,2897180,154
1663,a1609,20150514,4550,4526,4560,4560,4535,4558,4549,32,23,16,727940,156
1664,a1609,20150515,4558,4549,4560,4560,4542,4560,4553,11,4,26,1183820,164
1665,a1609,20150518,4560,4553,4550,4550,4515,4530,4536,-23,-17,30,1361000,152
1666,a1609,20150519,4530,4536,4542,4565,4542,4553,4559,17,23,84,3830300,186
1667,a1609,20150520,4553,4559,4552,4555,4527,4535,4543,-24,-16,82,3726060,170
1668,a1609,20150521,4535,4543,4536,4559,4531,4541,4545,-2,2,56,2545400,172
1669,a1609,20150522,4541,4545,4555,4688,4541,4666,4625,121,80,172,7955540,232
1670,a1609,20150525,4666,4625,4651,4678,4648,4659,4660,34,35,242,11277200,340
1671,a1609,20150526,4659,4660,4659,4670,4645,4650,4655,-10,-5,54,2513880,338
1672,a1609,20150527,4650,4655,4634,4652,4630,4632,4640,-23,-15,54,2505720,320
1673,a1609,20150528,4632,4640,4676,4676,4651,4657,4662,17,22,40,1864980,306
1674,a1609,20150529,4657,4662,4670,4681,4660,4672,4669,10,7,58,2708060,308
1675,a1609,20150601,4672,4669,4677,4691,4630,4630,4655,-39,-14,112,5214640,310
1676,a1609,20150602,4630,4655,4617,4650,4617,4632,4634,-23,-21,38,1761280,324
1677,a1609,20150603,4632,4634,4655,4677,4643,4643,4660,9,26,26,1211800,334
1678,a1609,20150604,4643,4660,4630,4633,4620,4628,4626,-32,-34,24,1110360,330
1679,a1609,20150605,4628,4626,4620,4650,4577,4589,4599,-37,-27,66,3035420,332
1680,a1609,20150608,4589,4599,4587,4621,4569,4569,4585,-30,-14,104,4768960,360
1681,a1609,20150609,4569,4585,4586,4632,4584,4584,4605,-1,20,118,5433960,384
1682,a1609,20150610,4584,4605,4589,4592,4582,4592,4586,-13,-19,10,458620,384
1683,a1609,20150611,4592,4586,4593,4609,4584,4593,4597,7,11,34,1563040,382
1684,a1609,20150612,4593,4597,4556,4579,4491,4492,4539,-105,-58,212,9624100,404
1685,a1609,20150615,4492,4539,4503,4503,4461,4461,4484,-78,-55,32,1434900,396
1686,a1609,20150616,4461,4484,4455,4517,4455,4483,4483,-1,-1,100,4483440,342
1687,a1609,20150617,4483,4483,4493,4536,4478,4499,4501,16,18,24,1080260,346
1688,a1609,20150618,4499,4501,4550,4550,4505,4516,4530,15,29,28,1268520,354
1689,a1609,20150619,4516,4530,4549,4549,4505,4519,4520,-11,-10,16,723260,358
1690,a1609,20150623,4519,4520,4516,4533,4516,4531,4527,11,7,12,543320,358
1691,a1609,20150624,4531,4527,4517,4544,4500,4522,4519,-5,-8,48,2169340,362
1692,a1609,20150625,4522,4519,4516,4534,4504,4504,4513,-15,-6,70,3159580,378
1693,a1609,20150626,4504,4513,4509,4535,4468,4468,4492,-45,-21,34,1527460,378
1694,a1609,20150629,4468,4492,4505,4520,4440,4457,4461,-35,-31,74,3301160,400
1695,a1609,20150630,4457,4461,4471,4480,4404,4404,4445,-57,-16,104,4622940,416
1696,a1609,20150701,4404,4445,4405,4500,4405,4470,4458,25,13,154,6865700,438
1697,a1609,20150702,4470,4458,4517,4517,4440,4440,4461,-18,3,92,4104540,470
1698,a1609,20150703,4440,4461,4480,4480,4458,4461,4470,0,9,44,1966920,482
1699,a1609,20150706,4461,4470,4441,4471,4419,4428,4442,-42,-28,184,8174200,508
1700,a1609,20150707,4428,4442,4424,4449,4403,4403,4424,-39,-18,106,4690200,494
1701,a1609,20150708,4403,4424,4377,4394,4248,4258,4280,-166,-144,194,8304120,472
1702,a1609,20150709,4258,4280,4156,4451,4156,4431,4370,151,90,340,14860880,516
1703,a1609,20150710,4431,4370,4477,4536,4476,4536,4494,166,124,134,6022080,494
1704,a1609,20150713,4536,4494,4526,4526,4456,4489,4484,-5,-10,110,4933380,502
1705,a1609,20150714,4489,4484,4488,4499,4470,4488,4489,4,5,154,6913160,426
1706,a1609,20150715,4488,4489,4504,4504,4452,4452,4465,-37,-24,32,1429060,426
1707,a1609,20150716,4452,4465,4431,4447,4377,4437,4423,-28,-42,86,3803900,446
1708,a1609,20150717,4437,4423,4446,4486,4403,4427,4438,4,15,118,5237280,438
1709,a1609,20150720,4427,4438,4421,4421,4350,4372,4373,-66,-65,88,3849020,470
1710,a1609,20150721,4372,4373,4420,4420,4357,4360,4373,-13,0,88,3848660,498
1711,a1609,20150722,4360,4373,4288,4386,4288,4379,4371,6,-2,154,6732220,480
1712,a1609,20150723,4379,4371,4369,4371,4361,4371,4364,0,-7,18,785680,482
1713,a1609,20150724,4371,4364,4391,4391,4378,4380,4382,16,18,64,2804580,468
1714,a1609,20150727,4380,4382,4377,4380,4314,4376,4364,-6,-18,54,2356560,476
1715,a1609,20150728,4376,4364,4324,4370,4309,4370,4332,6,-32,88,3812200,472
1716,a1609,20150729,4370,4332,4400,4447,4389,4439,4434,107,102,166,7360540,500
1717,a1609,20150730,4439,4434,4451,4478,4443,4450,4461,16,27,68,3034020,474
1718,a1609,20150731,4450,4461,4444,4470,4444,4453,4452,-8,-9,28,1246580,468
1719,a1609,20150803,4453,4452,4454,4454,4408,4408,4425,-44,-27,66,2920700,470
1720,a1609,20150804,4408,4425,4411,4433,4409,4433,4424,8,-1,34,1504180,472
1721,a1609,20150805,4433,4424,4436,4439,4424,4432,4432,8,8,28,1241000,472
1722,a1609,20150806,4432,4432,4433,4520,4424,4519,4485,87,53,84,3767920,480
1723,a1609,20150807,4519,4485,4496,4520,4458,4488,4482,3,-3,192,8606900,502
1724,a1609,20150810,4488,4482,4482,4526,4482,4526,4508,44,26,76,3426100,518
1725,a1609,20150811,4526,4508,4523,4544,4520,4529,4531,21,23,266,12053940,650
1726,a1609,20150812,4529,4531,4509,4561,4509,4533,4522,2,-9,126,5697940,686
1727,a1609,20150813,4533,4522,4558,4600,4467,4489,4506,-33,-16,190,8562540,674
1728,a1609,20150814,4489,4506,4486,4510,4483,4495,4498,-11,-8,96,4318800,688
1729,a1609,20150817,4495,4498,4502,4535,4495,4508,4506,10,8,54,2433520,684
1730,a1609,20150818,4508,4506,4514,4536,4433,4491,4503,-15,-3,90,4053380,696
1731,a1609,20150819,4491,4503,4477,4485,4447,4479,4467,-24,-36,182,8130160,706
1732,a1609,20150820,4479,4467,4471,4490,4441,4452,4469,-15,2,178,7955140,760
1733,a1609,20150821,4452,4469,4451,4500,4451,4477,4474,8,5,90,4027060,768
1734,a1609,20150824,4477,4474,4447,4499,4379,4379,4421,-95,-53,162,7162980,736
1735,a1609,20150825,4379,4421,4366,4429,4360,4395,4389,-26,-32,124,5443040,718
1736,a1609,20150826,4395,4389,4421,4443,4390,4390,4408,1,19,74,3262240,720
1737,a1609,20150827,4390,4408,4392,4415,4337,4362,4396,-46,-12,190,8353100,738
1738,a1609,20150828,4362,4396,4388,4405,4336,4336,4369,-60,-27,272,11885160,736
1739,a1609,20150831,4336,4369,4369,4444,4325,4328,4347,-41,-22,214,9302840,726
1740,a1609,20150901,4328,4347,4353,4372,4316,4366,4352,19,5,156,6790640,748
1741,a1609,20150902,4366,4352,4355,4368,4346,4365,4356,13,4,38,1655460,754
1742,a1609,20150907,4365,4356,4395,4395,4279,4309,4321,-47,-35,54,2333360,776
1743,a1609,20150908,4309,4321,4317,4327,4255,4327,4307,6,-14,274,11803380,916
1744,a1609,20150909,4327,4307,4348,4349,4307,4315,4330,8,23,160,6928860,910
1745,a1609,20150910,4315,4330,4315,4343,4310,4334,4322,4,-8,76,3284820,924
1746,a1609,20150911,4334,4322,4326,4357,4326,4339,4345,17,23,88,3823740,942
1747,a1609,20150914,4339,4345,4316,4351,4316,4329,4334,-16,-11,62,2687260,944
1748,a1609,20150915,4329,4334,4336,4347,4326,4326,4342,-8,8,48,2084180,948
1749,a1609,20150916,4326,4342,4321,4342,4301,4331,4321,-11,-21,154,6655280,948
1750,a1609,20150917,4331,4321,4325,4339,4318,4320,4330,-1,9,320,13857480,1070
1751,a1609,20150918,4320,4330,4317,4330,4293,4293,4313,-37,-17,250,10783160,1152
1752,a1609,20150921,4293,4313,4297,4305,4180,4220,4211,-93,-102,2128,89613580,2240
1753,a1609,20150922,4220,4211,4214,4214,4175,4186,4186,-25,-25,986,41275740,2626
1754,a1609,20150923,4186,4186,4174,4185,4161,4169,4172,-17,-14,550,22947980,2696
1755,a1609,20150924,4169,4172,4185,4197,4154,4154,4163,-18,-9,368,15322460,2770
1756,a1609,20150925,4154,4163,4145,4187,4131,4155,4163,-8,0,752,31309820,2706
1757,a1609,20150928,4155,4163,4166,4170,4138,4138,4150,-25,-13,300,12450000,2666
1758,a1609,20150929,4138,4150,4137,4189,4032,4188,4118,38,-32,974,40111860,2672
1759,a1609,20150930,4188,4118,4198,4218,4183,4201,4203,83,85,1922,80795300,2780
1760,a1609,20151008,4201,4203,4115,4209,4040,4060,4131,-143,-72,1246,51477020,2686
1761,a1609,20151009,4060,4131,4067,4089,3996,4027,4042,-104,-89,3168,128067460,3128
1762,a1609,20151012,4027,4042,4037,4079,4016,4079,4041,37,-1,1380,55772640,3286
1763,a1609,20151013,4079,4041,4060,4066,4032,4052,4047,11,6,1172,47438840,3236
1764,a1609,20151014,4052,4047,4058,4079,4021,4045,4049,-2,2,1176,47622260,3378
1765,a1609,20151015,4045,4049,4063,4070,4044,4053,4056,4,7,330,13387020,3318
1766,a1609,20151016,4053,4056,4045,4048,3973,3978,4007,-78,-49,1740,69735760,3844
1767,a1609,20151019,3978,4007,3951,3974,3930,3942,3952,-65,-55,1746,69005780,4196
1768,a1609,20151020,3942,3952,3943,3958,3905,3926,3928,-26,-24,2244,88151560,4584
1769,a1609,20151021,3926,3928,3925,3947,3911,3911,3927,-17,-1,1710,67167820,4632
1770,a1609,20151022,3911,3927,3914,3935,3875,3927,3903,0,-24,3124,121951280,4298
1771,a1609,20151023,3927,3903,3935,3950,3881,3920,3910,17,7,2000,78219200,4482
1772,a1609,20151026,3920,3910,3924,3930,3836,3858,3886,-52,-24,3330,129406380,5268
1773,a1609,20151027,3858,3886,3852,3852,3808,3840,3820,-46,-66,1036,39578460,5528
1774,a1609,20151028,3840,3820,3842,3846,3790,3790,3816,-30,-4,1202,45873940,5938
1775,a1609,20151029,3790,3816,3799,3819,3775,3788,3793,-28,-23,1088,41272560,6208
1776,a1609,20151030,3788,3793,3805,3810,3773,3788,3788,-5,-5,822,31143140,6386
1777,a1609,20151102,3788,3788,3793,3809,3789,3796,3801,8,13,610,23188800,6338
1778,a1609,20151103,3796,3801,3801,3809,3781,3795,3793,-6,-8,1334,50610640,6208
1779,a1609,20151104,3795,3793,3795,3838,3788,3825,3818,32,25,2320,88589680,6806
1780,a1609,20151105,3825,3818,3812,3830,3805,3815,3820,-3,2,1740,66482700,6984
1781,a1609,20151106,3815,3820,3819,3827,3790,3825,3804,5,-16,2874,109349940,8170
1782,a1609,20151109,3825,3804,3829,3855,3800,3813,3821,9,17,3488,133276980,8616
1783,a1609,20151110,3813,3821,3824,3826,3787,3788,3798,-33,-23,1472,55920180,9280
1784,a1609,20151111,3788,3798,3784,3796,3648,3796,3760,-2,-38,3830,144018240,9420
1785,a1609,20151112,3796,3760,3798,3817,3790,3806,3801,46,41,1808,68724920,9532
1786,a1609,20151113,3806,3801,3808,3837,3797,3812,3818,11,17,2066,78880200,9884
1787,a1609,20151116,3812,3818,3812,3824,3740,3744,3782,-74,-36,4390,166055020,11646
1788,a1609,20151117,3744,3782,3742,3769,3720,3738,3745,-44,-37,3230,120977520,11742
1789,a1609,20151118,3738,3745,3742,3777,3725,3734,3751,-11,6,6202,232668920,14576
1790,a1609,20151119,3734,3751,3741,3742,3643,3646,3673,-105,-78,11512,422884060,19438
1791,a1609,20151120,3646,3673,3642,3657,3608,3610,3635,-63,-38,5868,213309320,19712
1792,a1609,20151123,3610,3635,3609,3660,3607,3640,3641,5,6,7090,258200780,20680
1793,a1609,20151124,3640,3641,3645,3700,3628,3698,3670,57,29,5340,195979900,20938
1794,a1609,20151125,3698,3670,3695,3705,3658,3685,3686,15,16,3936,145112760,20970
1795,a1609,20151126,3685,3686,3678,3718,3675,3691,3692,5,6,8686,320769000,24586
1796,a1609,20151127,3691,3692,3681,3700,3657,3673,3676,-19,-16,3430,126107320,25100
1797,a1609,20151130,3673,3676,3662,3696,3653,3690,3679,14,3,3566,131216800,24154
1798,a1609,20151201,3690,3679,3689,3709,3682,3696,3693,17,14,3202,118277920,24520
1799,a1609,20151202,3696,3693,3698,3743,3665,3675,3714,-18,21,14280,530364760,25458
1800,a1609,20151203,3675,3714,3670,3734,3665,3724,3699,10,-15,10760,398054380,23012
1801,a1609,20151204,3724,3699,3727,3739,3708,3724,3726,25,27,6676,248765420,22562
1802,a1609,20151207,3724,3726,3736,3749,3705,3737,3732,11,6,4998,186565600,22630
1803,a1609,20151208,3737,3732,3736,3736,3696,3713,3715,-19,-17,7842,291369780,24706
1804,a1609,20151209,3713,3715,3725,3725,3688,3689,3705,-26,-10,4634,171707540,25754
1805,a1609,20151210,3689,3705,3689,3702,3660,3673,3681,-32,-24,6768,249188440,27962
1806,a1609,20151211,3673,3681,3658,3689,3652,3686,3670,5,-11,4356,159895600,27774
1807,a1609,20151214,3686,3670,3686,3695,3646,3647,3659,-23,-11,5660,207136380,28670
1808,a1609,20151215,3647,3659,3638,3655,3623,3626,3640,-33,-19,7932,288734100,29660
1809,a1609,20151216,3626,3640,3623,3639,3616,3632,3626,-8,-14,9724,352648440,29806
1810,a1609,20151217,3632,3626,3630,3656,3626,3641,3641,15,15,10948,398632100,27836
1811,a1609,20151218,3641,3641,3630,3665,3628,3665,3648,24,7,4800,175149180,26950
1812,a1609,20151221,3665,3648,3666,3700,3662,3696,3681,48,33,6856,252374760,27160
1813,a1609,20151222,3696,3681,3696,3706,3654,3654,3682,-27,1,8492,312701780,27644
1814,a1609,20151223,3654,3682,3660,3673,3644,3664,3656,-18,-26,7268,265788340,28010
1815,a1609,20151224,3664,3656,3671,3672,3648,3650,3659,-6,3,4794,175444060,28156
1816,a1609,20151225,3650,3659,3651,3672,3618,3619,3641,-40,-18,18188,662250360,30306
1817,a1609,20151228,3619,3641,3619,3629,3514,3518,3564,-123,-77,25944,924669040,38456
1818,a1609,20151229,3518,3564,3528,3529,3501,3525,3515,-39,-49,21218,745840420,41358
1819,a1609,20151230,3525,3515,3525,3555,3520,3533,3535,18,20,18348,648764640,40080
1820,a1609,20151231,3533,3535,3533,3535,3518,3528,3527,-7,-8,10092,356026680,39880
1821,a1611,20150518,4527,4527,0,0,0,4511,4511,-16,-16,0,0,0
1822,a1611,20150519,4511,4511,0,0,0,4533,4533,22,22,0,0,0
1823,a1611,20150520,4533,4533,0,0,0,4518,4518,-15,-15,0,0,0
1824,a1611,20150521,4518,4518,0,0,0,4519,4519,1,1,0,0,0
1825,a1611,20150522,4519,4519,0,0,0,4598,4598,79,79,0,0,0
1826,a1611,20150525,4598,4598,0,0,0,4632,4632,34,34,0,0,0
1827,a1611,20150526,4632,4632,0,0,0,4628,4628,-4,-4,0,0,0
1828,a1611,20150527,4628,4628,0,0,0,4628,4628,0,0,0,0,0
1829,a1611,20150528,4628,4628,0,0,0,4649,4649,21,21,0,0,0
1830,a1611,20150529,4649,4649,0,0,0,4655,4655,6,6,0,0,0
1831,a1611,20150601,4655,4655,0,0,0,4642,4642,-13,-13,0,0,0
1832,a1611,20150602,4642,4642,0,0,0,4642,4642,0,0,0,0,0
1833,a1611,20150603,4642,4642,0,0,0,4668,4668,26,26,0,0,0
1834,a1611,20150604,4668,4668,0,0,0,4668,4668,0,0,0,0,0
1835,a1611,20150605,4668,4668,0,0,0,4641,4641,-27,-27,0,0,0
1836,a1611,20150608,4641,4641,0,0,0,4627,4627,-14,-14,0,0,0
1837,a1611,20150609,4627,4627,0,0,0,4647,4647,20,20,0,0,0
1838,a1611,20150610,4647,4647,4739,4739,4280,4577,4575,-70,-72,12,549020,0
1839,a1611,20150611,4577,4575,0,0,0,4585,4585,10,10,0,0,0
1840,a1611,20150612,4585,4585,4430,4605,4430,4600,4536,15,-49,8,362900,0
1841,a1611,20150615,4600,4536,0,0,0,4482,4482,-54,-54,0,0,0
1842,a1611,20150616,4482,4482,0,0,0,4482,4482,0,0,0,0,0
1843,a1611,20150617,4482,4482,0,0,0,4482,4482,0,0,0,0,0
1844,a1611,20150618,4482,4482,0,0,0,4482,4482,0,0,0,0,0
1845,a1611,20150619,4482,4482,0,0,0,4473,4473,-9,-9,0,0,0
1846,a1611,20150623,4473,4473,0,0,0,4479,4479,6,6,0,0,0
1847,a1611,20150624,4479,4479,0,0,0,4472,4472,-7,-7,0,0,0
1848,a1611,20150625,4472,4472,0,0,0,4467,4467,-5,-5,0,0,0
1849,a1611,20150626,4467,4467,0,0,0,4447,4447,-20,-20,0,0,0
1850,a1611,20150629,4447,4447,0,0,0,4417,4417,-30,-30,0,0,0
1851,a1611,20150630,4417,4417,0,0,0,4402,4402,-15,-15,0,0,0
1852,a1611,20150701,4402,4402,0,0,0,4402,4402,0,0,0,0,0
1853,a1611,20150702,4402,4402,0,0,0,4404,4404,2,2,0,0,0
1854,a1611,20150703,4404,4404,0,0,0,4412,4412,8,8,0,0,0
1855,a1611,20150706,4412,4412,0,0,0,4385,4385,-27,-27,0,0,0
1856,a1611,20150707,4385,4385,4267,4485,4267,4433,4395,48,10,6,263700,0
1857,a1611,20150708,4433,4395,0,0,0,4252,4252,-143,-143,0,0,0
1858,a1611,20150709,4252,4252,0,0,0,4341,4341,89,89,0,0,0
1859,a1611,20150710,4341,4341,0,0,0,4464,4464,123,123,0,0,0
1860,a1611,20150713,4464,4464,4403,4591,4403,4474,4498,10,34,8,359900,0
1861,a1611,20150714,4474,4498,0,0,0,4503,4503,5,5,0,0,0
1862,a1611,20150715,4503,4503,0,0,0,4503,4503,0,0,0,0,0
1863,a1611,20150716,4503,4503,0,0,0,4461,4461,-42,-42,0,0,0
1864,a1611,20150717,4461,4461,0,0,0,4476,4476,15,15,0,0,0
1865,a1611,20150720,4476,4476,0,0,0,4411,4411,-65,-65,0,0,0
1866,a1611,20150721,4411,4411,0,0,0,4411,4411,0,0,0,0,0
1867,a1611,20150722,4411,4411,0,0,0,4411,4411,0,0,0,0,0
1868,a1611,20150723,4411,4411,0,0,0,4404,4404,-7,-7,0,0,0
1869,a1611,20150724,4404,4404,0,0,0,4404,4404,0,0,0,0,0
1870,a1611,20150727,4404,4404,0,0,0,4386,4386,-18,-18,0,0,0
1871,a1611,20150728,4386,4386,0,0,0,4354,4354,-32,-32,0,0,0
1872,a1611,20150729,4354,4354,0,0,0,4456,4456,102,102,0,0,0
1873,a1611,20150730,4456,4456,0,0,0,4483,4483,27,27,0,0,0
1874,a1611,20150731,4483,4483,0,0,0,4474,4474,-9,-9,0,0,0
1875,a1611,20150803,4474,4474,0,0,0,4447,4447,-27,-27,0,0,0
1876,a1611,20150804,4447,4447,0,0,0,4446,4446,-1,-1,0,0,0
1877,a1611,20150805,4446,4446,0,0,0,4454,4454,8,8,0,0,0
1878,a1611,20150806,4454,4454,4493,4632,4438,4492,4538,38,84,22,998440,2
1879,a1611,20150807,4492,4538,0,0,0,4535,4535,-3,-3,0,0,2
1880,a1611,20150810,4535,4535,4544,4544,4544,4544,4544,9,9,4,181760,4
1881,a1611,20150811,4544,4544,4570,4570,4570,4570,4570,26,26,2,91400,6
1882,a1611,20150812,4570,4570,0,0,0,4564,4564,-6,-6,0,0,6
1883,a1611,20150813,4564,4564,4535,4535,4517,4518,4525,-46,-39,14,633540,8
1884,a1611,20150814,4518,4525,0,0,0,4525,4525,0,0,0,0,8
1885,a1611,20150817,4525,4525,0,0,0,4525,4525,0,0,0,0,8
1886,a1611,20150818,4525,4525,0,0,0,4525,4525,0,0,0,0,8
1887,a1611,20150819,4525,4525,0,0,0,4489,4489,-36,-36,0,0,8
1888,a1611,20150820,4489,4489,0,0,0,4491,4491,2,2,0,0,8
1889,a1611,20150821,4491,4491,0,0,0,4491,4491,0,0,0,0,8
1890,a1611,20150824,4491,4491,0,0,0,4435,4435,-56,-56,0,0,8
1891,a1611,20150825,4435,4435,0,0,0,4403,4403,-32,-32,0,0,8
1892,a1611,20150826,4403,4403,0,0,0,4422,4422,19,19,0,0,8
1893,a1611,20150827,4422,4422,0,0,0,4410,4410,-12,-12,0,0,8
1894,a1611,20150828,4410,4410,4373,4373,4373,4373,4373,-37,-37,2,87460,8
1895,a1611,20150831,4373,4373,4293,4383,4228,4316,4332,-57,-41,32,1386420,6
1896,a1611,20150901,4316,4332,0,0,0,4336,4336,4,4,0,0,6
1897,a1611,20150902,4336,4336,0,0,0,4339,4339,3,3,0,0,6
1898,a1611,20150907,4339,4339,0,0,0,4339,4339,0,0,0,0,6
1899,a1611,20150908,4339,4339,0,0,0,4325,4325,-14,-14,0,0,6
1900,a1611,20150909,4325,4325,0,0,0,4325,4325,0,0,0,0,6
1901,a1611,20150910,4325,4325,0,0,0,4325,4325,0,0,0,0,6
1902,a1611,20150911,4325,4325,0,0,0,4325,4325,0,0,0,0,6
1903,a1611,20150914,4325,4325,0,0,0,4315,4315,-10,-10,0,0,6
1904,a1611,20150915,4315,4315,0,0,0,4322,4322,7,7,0,0,6
1905,a1611,20150916,4322,4322,4348,4349,4305,4305,4326,-17,4,8,346140,6
1906,a1611,20150917,4305,4326,0,0,0,4326,4326,0,0,0,0,6
1907,a1611,20150918,4326,4326,0,0,0,4326,4326,0,0,0,0,6
1908,a1611,20150921,4326,4326,4272,4272,4169,4169,4220,-157,-106,4,168820,6
1909,a1611,20150922,4169,4220,0,0,0,4220,4220,0,0,0,0,6
1910,a1611,20150923,4220,4220,0,0,0,4206,4206,-14,-14,0,0,6
1911,a1611,20150924,4206,4206,0,0,0,4197,4197,-9,-9,0,0,6
1912,a1611,20150925,4197,4197,0,0,0,4197,4197,0,0,0,0,6
1913,a1611,20150928,4197,4197,0,0,0,4184,4184,-13,-13,0,0,6
1914,a1611,20150929,4184,4184,0,0,0,4152,4152,-32,-32,0,0,6
1915,a1611,20150930,4152,4152,0,0,0,4237,4237,85,85,0,0,6
1916,a1611,20151008,4237,4237,4106,4160,4075,4075,4113,-162,-124,12,493640,6
1917,a1611,20151009,4075,4113,4040,4040,4040,4040,4040,-73,-73,2,80800,6
1918,a1611,20151012,4040,4040,0,0,0,4040,4040,0,0,0,0,6
1919,a1611,20151013,4040,4040,4100,4100,4100,4100,4100,60,60,2,82000,8
1920,a1611,20151014,4100,4100,0,0,0,4100,4100,0,0,0,0,8
1921,a1611,20151015,4100,4100,0,0,0,4107,4107,7,7,0,0,8
1922,a1611,20151016,4107,4107,4020,4020,4020,4020,4020,-87,-87,2,80400,8
1923,a1611,20151019,4020,4020,0,0,0,3965,3965,-55,-55,0,0,8
1924,a1611,20151020,3965,3965,3906,3906,3905,3905,3905,-60,-60,4,156220,6
1925,a1611,20151021,3905,3905,0,0,0,3905,3905,0,0,0,0,6
1926,a1611,20151022,3905,3905,0,0,0,3882,3882,-23,-23,0,0,6
1927,a1611,20151023,3882,3882,3862,3912,3862,3912,3887,30,5,4,155480,6
1928,a1611,20151026,3912,3887,0,0,0,3864,3864,-23,-23,0,0,6
1929,a1611,20151027,3864,3864,0,0,0,3799,3799,-65,-65,0,0,6
1930,a1611,20151028,3799,3799,0,0,0,3796,3796,-3,-3,0,0,6
1931,a1611,20151029,3796,3796,3706,3821,3706,3796,3759,0,-37,46,1729500,16
1932,a1611,20151030,3796,3759,3787,3787,3744,3745,3758,-14,-1,6,225520,14
1933,a1611,20151102,3745,3758,0,0,0,3770,3770,12,12,0,0,14
1934,a1611,20151103,3770,3770,0,0,0,3770,3770,0,0,0,0,14
1935,a1611,20151104,3770,3770,3800,3800,3800,3800,3800,30,30,2,76000,14
1936,a1611,20151105,3800,3800,0,0,0,3800,3800,0,0,0,0,14
1937,a1611,20151106,3800,3800,0,0,0,3785,3785,-15,-15,0,0,14
1938,a1611,20151109,3785,3785,0,0,0,3801,3801,16,16,0,0,14
1939,a1611,20151110,3801,3801,0,0,0,3801,3801,0,0,0,0,14
1940,a1611,20151111,3801,3801,0,0,0,3763,3763,-38,-38,0,0,14
1941,a1611,20151112,3763,3763,3770,3802,3770,3802,3786,39,23,4,151440,12
1942,a1611,20151113,3802,3786,0,0,0,3802,3802,16,16,0,0,12
1943,a1611,20151116,3802,3802,0,0,0,3767,3767,-35,-35,0,0,12
1944,a1611,20151117,3767,3767,0,0,0,3731,3731,-36,-36,0,0,12
1945,a1611,20151118,3731,3731,0,0,0,3736,3736,5,5,0,0,12
1946,a1611,20151119,3736,3736,0,0,0,3659,3659,-77,-77,0,0,12
1947,a1611,20151120,3659,3659,0,0,0,3622,3622,-37,-37,0,0,12
1948,a1611,20151123,3622,3622,0,0,0,3627,3627,5,5,0,0,12
1949,a1611,20151124,3627,3627,0,0,0,3655,3655,28,28,0,0,12
1950,a1611,20151125,3655,3655,0,0,0,3670,3670,15,15,0,0,12
1951,a1611,20151126,3670,3670,3702,3702,3702,3702,3702,32,32,2,74040,12
1952,a1611,20151127,3702,3702,0,0,0,3686,3686,-16,-16,0,0,12
1953,a1611,20151130,3686,3686,0,0,0,3689,3689,3,3,0,0,12
1954,a1611,20151201,3689,3689,0,0,0,3703,3703,14,14,0,0,12
1955,a1611,20151202,3703,3703,0,0,0,3724,3724,21,21,0,0,12
1956,a1611,20151203,3724,3724,3706,3706,3706,3706,3706,-18,-18,2,74120,12
1957,a1611,20151204,3706,3706,3687,3687,3687,3687,3687,-19,-19,2,73740,10
1958,a1611,20151207,3687,3687,0,0,0,3692,3692,5,5,0,0,10
1959,a1611,20151208,3692,3692,3663,3750,3663,3750,3706,58,14,4,148260,10
1960,a1611,20151209,3750,3706,0,0,0,3697,3697,-9,-9,0,0,10
1961,a1611,20151210,3697,3697,0,0,0,3674,3674,-23,-23,0,0,10
1962,a1611,20151211,3674,3674,0,0,0,3664,3664,-10,-10,0,0,10
1963,a1611,20151214,3664,3664,0,0,0,3654,3654,-10,-10,0,0,10
1964,a1611,20151215,3654,3654,0,0,0,3636,3636,-18,-18,0,0,10
1965,a1611,20151216,3636,3636,0,0,0,3623,3623,-13,-13,0,0,10
1966,a1611,20151217,3623,3623,0,0,0,3637,3637,14,14,0,0,10
1967,a1611,20151218,3637,3637,0,0,0,3643,3643,6,6,0,0,10
1968,a1611,20151221,3643,3643,0,0,0,3675,3675,32,32,0,0,10
1969,a1611,20151222,3675,3675,0,0,0,3675,3675,0,0,0,0,10
1970,a1611,20151223,3675,3675,3670,3670,3670,3670,3670,-5,-5,2,73400,8
1971,a1611,20151224,3670,3670,0,0,0,3673,3673,3,3,0,0,8
1972,a1611,20151225,3673,3673,0,0,0,3655,3655,-18,-18,0,0,8
1973,a1611,20151228,3655,3655,0,0,0,3578,3578,-77,-77,0,0,8
1974,a1611,20151229,3578,3578,0,0,0,3529,3529,-49,-49,0,0,8
1975,a1611,20151230,3529,3529,3505,3574,3505,3574,3539,45,10,4,141580,8
1976,a1611,20151231,3574,3539,3585,3585,3579,3579,3584,40,45,12,430080,18
1977,a1701,20150715,4484,4484,0,0,0,4484,4484,0,0,0,0,0
1978,a1701,20150716,4484,4484,4296,4296,4250,4250,4252,-234,-232,64,2721880,64
1979,a1701,20150717,4250,4252,4422,4422,4326,4326,4383,74,131,10,438360,66
1980,a1701,20150720,4326,4383,4325,4454,4295,4375,4346,-8,-37,74,3216320,68
1981,a1701,20150721,4375,4346,4399,4410,4338,4410,4399,64,53,22,967940,76
1982,a1701,20150722,4410,4399,4400,4420,4400,4400,4404,1,5,14,616640,74
1983,a1701,20150723,4400,4404,0,0,0,4404,4404,0,0,0,0,74
1984,a1701,20150724,4404,4404,0,0,0,4404,4404,0,0,0,0,74
1985,a1701,20150727,4404,4404,4403,4403,4321,4321,4362,-83,-42,4,174480,74
1986,a1701,20150728,4321,4362,4345,4409,4307,4330,4340,-32,-22,12,520900,74
1987,a1701,20150729,4330,4340,4400,4470,4400,4458,4437,118,97,26,1153720,90
1988,a1701,20150730,4458,4437,4500,4500,4450,4493,4471,56,34,12,536520,88
1989,a1701,20150731,4493,4471,4465,4465,4439,4439,4456,-32,-15,6,267380,88
1990,a1701,20150803,4439,4456,4463,4475,4419,4425,4445,-31,-11,8,355640,90
1991,a1701,20150804,4425,4445,4449,4449,4424,4424,4436,-21,-9,4,177460,94
1992,a1701,20150805,4424,4436,4449,4462,4426,4426,4445,-10,9,6,266740,94
1993,a1701,20150806,4426,4445,4450,4521,4450,4500,4482,55,37,18,806800,104
1994,a1701,20150807,4500,4482,4492,4540,4452,4480,4508,-2,26,116,5230020,196
1995,a1701,20150810,4480,4508,4510,4539,4510,4530,4522,22,14,112,5065700,258
1996,a1701,20150811,4530,4522,4530,4541,4530,4535,4531,13,9,66,2990560,298
1997,a1701,20150812,4535,4531,4519,4568,4514,4530,4526,-1,-5,62,2806680,332
1998,a1701,20150813,4530,4526,4535,4590,4400,4498,4505,-28,-21,62,2793240,344
1999,a1701,20150814,4498,4505,4497,4528,4497,4510,4514,5,9,28,1264000,340
2000,a1701,20150817,4510,4514,4535,4535,4515,4528,4520,14,6,14,632900,336
2001,a1701,20150818,4528,4520,4516,4517,4500,4500,4513,-20,-7,12,541640,332
2002,a1701,20150819,4500,4513,4519,4519,4466,4496,4487,-17,-26,30,1346280,320
2003,a1701,20150820,4496,4487,4500,4500,4481,4486,4488,-1,1,44,1975140,306
2004,a1701,20150821,4486,4488,4485,4514,4473,4495,4499,7,11,158,7109460,282
2005,a1701,20150824,4495,4499,4480,4486,4401,4409,4449,-90,-50,80,3559280,270
2006,a1701,20150825,4409,4449,4399,4448,4392,4420,4424,-29,-25,98,4336120,244
2007,a1701,20150826,4420,4424,4451,4469,4425,4425,4441,1,17,44,1954320,250
2008,a1701,20150827,4425,4441,4415,4442,4412,4435,4434,-6,-7,178,7893620,282
2009,a1701,20150828,4435,4434,4430,4440,4367,4367,4413,-67,-21,60,2648260,274
2010,a1701,20150831,4367,4413,4371,4371,4343,4364,4355,-49,-58,50,2177520,310
2011,a1701,20150901,4364,4355,4371,4375,4343,4361,4358,6,3,36,1568920,328
2012,a1701,20150902,4361,4358,4360,4375,4360,4375,4364,17,6,18,785660,334
2013,a1701,20150907,4375,4364,4352,4352,4308,4322,4323,-42,-41,40,1729220,348
2014,a1701,20150908,4322,4323,4331,4331,4299,4326,4314,3,-9,166,7162660,478
2015,a1701,20150909,4326,4314,4343,4344,4310,4310,4332,-4,18,12,519900,480
2016,a1701,20150910,4310,4332,4315,4330,4311,4330,4319,-2,-13,32,1382300,488
2017,a1701,20150911,4330,4319,4318,4362,4318,4345,4336,26,17,18,780520,498
2018,a1701,20150914,4345,4336,4344,4345,4334,4336,4342,0,6,22,955440,510
2019,a1701,20150915,4336,4342,4355,4355,4338,4338,4342,-4,0,14,608000,508
2020,a1701,20150916,4338,4342,4330,4340,4317,4338,4327,-4,-15,126,5452760,564
2021,a1701,20150917,4338,4327,4337,4337,4330,4333,4333,6,6,14,606640,568
2022,a1701,20150918,4333,4333,4322,4329,4290,4290,4301,-43,-32,54,2322900,604
2023,a1701,20150921,4290,4301,4270,4270,4172,4182,4190,-119,-111,222,9303460,712
2024,a1701,20150922,4182,4190,4211,4211,4144,4160,4156,-30,-34,242,10058340,820
2025,a1701,20150923,4160,4156,4138,4138,4110,4120,4121,-36,-35,202,8324920,968
2026,a1701,20150924,4120,4121,4127,4145,4110,4110,4126,-11,5,52,2146000,996
2027,a1701,20150925,4110,4126,4110,4129,4068,4123,4111,-3,-15,284,11675820,1162
2028,a1701,20150928,4123,4111,4080,4106,4080,4100,4100,-11,-11,104,4264180,1226
2029,a1701,20150929,4100,4100,4115,4118,4083,4108,4105,8,5,54,2216700,1238
2030,a1701,20150930,4108,4105,4101,4127,4083,4110,4108,5,3,212,8710080,1292
2031,a1701,20151008,4110,4108,4110,4110,3994,3994,4016,-114,-92,248,9959960,1332
2032,a1701,20151009,3994,4016,4014,4014,3960,3972,3985,-44,-31,208,8290780,1412
2033,a1701,20151012,3972,3985,3995,3995,3920,3975,3947,-10,-38,520,20525240,1768
2034,a1701,20151013,3975,3947,3960,4005,3950,3975,3983,28,36,492,19599720,1608
2035,a1701,20151014,3975,3983,3990,3999,3968,3998,3986,15,3,176,7015620,1598
2036,a1701,20151015,3998,3986,3992,3994,3981,3981,3988,-5,2,74,2951640,1626
2037,a1701,20151016,3981,3988,3983,3983,3882,3889,3918,-99,-70,1030,40356940,2258
2038,a1701,20151019,3889,3918,3871,3890,3865,3876,3875,-42,-43,312,12092900,2126
2039,a1701,20151020,3876,3875,3870,3957,3870,3877,3912,2,37,1090,42647000,1986
2040,a1701,20151021,3877,3912,3895,3897,3882,3882,3890,-30,-22,190,7392840,2038
2041,a1701,20151022,3882,3890,3873,3873,3815,3861,3842,-29,-48,1112,42727080,2378
2042,a1701,20151023,3861,3842,3870,3880,3842,3860,3860,18,18,622,24014380,2386
2043,a1701,20151026,3860,3860,3868,3871,3810,3815,3841,-45,-19,506,19436340,2370
2044,a1701,20151027,3815,3841,3816,3816,3775,3802,3798,-39,-43,924,35100860,2138
2045,a1701,20151028,3802,3798,3817,3817,3731,3736,3767,-62,-31,1702,64127140,3054
2046,a1701,20151029,3736,3767,3775,3775,3723,3725,3747,-42,-20,1688,63253600,3002
2047,a1701,20151030,3725,3747,3721,3757,3702,3725,3717,-22,-30,882,32788920,3316
2048,a1701,20151102,3725,3717,3723,3730,3710,3726,3722,9,5,350,13029420,3376
2049,a1701,20151103,3726,3722,3722,3730,3710,3716,3716,-6,-6,332,12339620,3378
2050,a1701,20151104,3716,3716,3711,3745,3709,3734,3739,18,23,1000,37398760,3366
2051,a1701,20151105,3734,3739,3722,3742,3722,3729,3733,-10,-6,382,14260560,3504
2052,a1701,20151106,3729,3733,3730,3732,3701,3732,3717,-1,-16,692,25723820,3692
2053,a1701,20151109,3732,3717,3736,3744,3716,3731,3732,14,15,1748,65239360,3840
2054,a1701,20151110,3731,3732,3726,3736,3707,3710,3716,-22,-16,742,27576620,4186
2055,a1701,20151111,3710,3716,3707,3728,3685,3704,3701,-12,-15,1034,38272680,4014
2056,a1701,20151112,3704,3701,3729,3739,3705,3715,3715,14,14,742,27567380,4182
2057,a1701,20151113,3715,3715,3715,3739,3683,3728,3726,13,11,1512,56342260,4052
2058,a1701,20151116,3728,3726,3726,3735,3692,3692,3715,-34,-11,1348,50083660,4652
2059,a1701,20151117,3692,3715,3707,3715,3671,3695,3699,-20,-16,792,29298860,4642
2060,a1701,20151118,3695,3699,3686,3725,3686,3700,3701,1,2,302,11178300,4622
2061,a1701,20151119,3700,3701,3685,3710,3629,3631,3646,-70,-55,2246,81900600,4630
2062,a1701,20151120,3631,3646,3649,3649,3616,3617,3627,-29,-19,1110,40270020,4416
2063,a1701,20151123,3617,3627,3634,3683,3613,3647,3652,20,25,1252,45731640,4386
2064,a1701,20151124,3647,3652,3646,3678,3645,3669,3660,17,8,2626,96137660,6066
2065,a1701,20151125,3669,3660,3671,3700,3655,3662,3668,2,8,430,15776520,6082
2066,a1701,20151126,3662,3668,3652,3699,3640,3685,3679,17,11,748,27525020,6246
2067,a1701,20151127,3685,3679,3690,3690,3655,3655,3665,-24,-14,270,9896180,6360
2068,a1701,20151130,3655,3665,3654,3670,3641,3668,3657,3,-8,374,13680200,6346
2069,a1701,20151201,3668,3657,3663,3700,3643,3671,3669,14,12,380,13942760,6332
2070,a1701,20151202,3671,3669,3669,3716,3669,3689,3699,20,30,1662,61480200,7226
2071,a1701,20151203,3689,3699,3683,3722,3665,3713,3706,14,7,1038,38473460,7672
2072,a1701,20151204,3713,3706,3709,3730,3690,3697,3703,-9,-3,490,18147720,7682
2073,a1701,20151207,3697,3703,3693,3714,3688,3704,3704,1,1,214,7928320,7714
2074,a1701,20151208,3704,3704,3709,3709,3671,3674,3686,-30,-18,228,8405180,7788
2075,a1701,20151209,3674,3686,3674,3685,3657,3658,3671,-28,-15,262,9619640,7762
2076,a1701,20151210,3658,3671,3663,3666,3648,3650,3656,-21,-15,368,13455200,7852
2077,a1701,20151211,3650,3656,3654,3659,3636,3653,3643,-3,-13,594,21645280,7816
2078,a1701,20151214,3653,3643,3655,3662,3640,3640,3645,-3,2,190,6927320,7860
2079,a1701,20151215,3640,3645,3640,3648,3630,3633,3636,-12,-9,566,20584160,8092
2080,a1701,20151216,3633,3636,3636,3645,3624,3644,3633,8,-3,272,9884140,8116
2081,a1701,20151217,3644,3633,3644,3656,3630,3644,3645,11,12,870,31712480,8426
2082,a1701,20151218,3644,3645,3634,3696,3631,3668,3651,23,6,1004,36659640,8658
2083,a1701,20151221,3668,3651,3673,3700,3666,3700,3686,49,35,2222,81922580,8972
2084,a1701,20151222,3700,3686,3700,3717,3670,3670,3691,-16,5,2004,73987180,9364
2085,a1701,20151223,3670,3691,3671,3684,3657,3672,3665,-19,-26,1530,56083460,9392
2086,a1701,20151224,3672,3665,3661,3678,3652,3665,3666,0,1,574,21043780,9376
2087,a1701,20151225,3665,3666,3665,3674,3619,3624,3640,-42,-26,6454,234926180,9526
2088,a1701,20151228,3624,3640,3628,3628,3495,3495,3551,-145,-89,3792,134663780,10500
2089,a1701,20151229,3495,3551,3486,3498,3478,3495,3488,-56,-63,2730,95241880,10656
2090,a1701,20151230,3495,3488,3495,3516,3484,3499,3504,11,16,3510,123010140,10784
2091,a1701,20151231,3499,3504,3499,3499,3484,3484,3491,-20,-13,1942,67796120,11048
2092,a1703,20150917,4342,4342,4420,4420,4167,4167,4293,-175,-49,4,171740,2
2093,a1703,20150918,4167,4293,0,0,0,4262,4262,-31,-31,0,0,2
2094,a1703,20150921,4262,4262,4262,4262,4141,4141,4201,-121,-61,4,168060,2
2095,a1703,20150922,4141,4201,4175,4175,4162,4162,4172,-39,-29,12,500740,12
2096,a1703,20150923,4162,4172,4105,4115,4091,4108,4107,-64,-65,90,3696300,100
2097,a1703,20150924,4108,4107,0,0,0,4107,4107,0,0,0,0,100
2098,a1703,20150925,4107,4107,0,0,0,4093,4093,-14,-14,0,0,100
2099,a1703,20150928,4093,4093,0,0,0,4083,4083,-10,-10,0,0,100
2100,a1703,20150929,4083,4083,0,0,0,4087,4087,4,4,0,0,100
2101,a1703,20150930,4087,4087,0,0,0,4089,4089,2,2,0,0,100
2102,a1703,20151008,4089,4089,3990,3991,3980,3980,3988,-109,-101,40,1595200,140
2103,a1703,20151009,3980,3988,3960,3978,3956,3978,3959,-10,-29,26,1029520,164
2104,a1703,20151012,3978,3959,0,0,0,3959,3959,0,0,0,0,164
2105,a1703,20151013,3959,3959,3926,3937,3915,3935,3927,-24,-32,14,549900,172
2106,a1703,20151014,3935,3927,3947,3990,3947,3980,3976,53,49,14,556680,178
2107,a1703,20151015,3980,3976,0,0,0,3977,3977,1,1,0,0,178
2108,a1703,20151016,3977,3977,3878,3927,3876,3876,3896,-101,-81,22,857200,192
2109,a1703,20151019,3876,3896,3796,3883,3796,3883,3864,-13,-32,28,1082140,212
2110,a1703,20151020,3883,3864,3869,3883,3770,3869,3860,5,-4,120,4633180,118
2111,a1703,20151021,3869,3860,3859,3859,3859,3859,3859,-1,-1,2,77180,118
2112,a1703,20151022,3859,3859,3810,3870,3810,3836,3841,-23,-18,18,691440,128
2113,a1703,20151023,3836,3841,3840,3840,3836,3840,3839,-1,-2,16,614320,130
2114,a1703,20151026,3840,3839,3856,3856,3798,3798,3820,-41,-19,18,687680,140
2115,a1703,20151027,3798,3820,3774,3774,3769,3770,3770,-50,-50,8,301640,138
2116,a1703,20151028,3770,3770,3784,3800,3712,3712,3767,-58,-3,90,3390760,194
2117,a1703,20151029,3712,3767,3719,3740,3712,3712,3724,-55,-43,18,670340,196
2118,a1703,20151030,3712,3724,3727,3727,3692,3697,3701,-27,-23,60,2221160,226
2119,a1703,20151102,3697,3701,0,0,0,3703,3703,2,2,0,0,226
2120,a1703,20151103,3703,3703,3692,3692,3692,3692,3692,-11,-11,2,73840,226
2121,a1703,20151104,3692,3692,3696,3725,3695,3716,3714,24,22,20,742960,236
2122,a1703,20151105,3716,3714,3709,3717,3698,3713,3709,-1,-5,14,519320,238
2123,a1703,20151106,3713,3709,3699,3716,3697,3716,3703,7,-6,28,1037080,242
2124,a1703,20151109,3716,3703,3713,3730,3704,3720,3709,17,6,34,1261160,262
2125,a1703,20151110,3720,3709,3714,3790,3700,3703,3719,-6,10,118,4388640,348
2126,a1703,20151111,3703,3719,3690,3705,3679,3705,3692,-14,-27,30,1107720,352
2127,a1703,20151112,3705,3692,3710,3715,3708,3715,3711,23,19,20,742360,354
2128,a1703,20151113,3715,3711,3709,3715,3709,3710,3712,-1,1,26,965300,346
2129,a1703,20151116,3710,3712,3711,3711,3677,3677,3692,-35,-20,50,1846240,358
2130,a1703,20151117,3677,3692,3688,3710,3661,3698,3680,6,-12,48,1766400,338
2131,a1703,20151118,3698,3680,3688,3703,3674,3681,3690,1,10,54,1992700,342
2132,a1703,20151119,3681,3690,3691,3691,3543,3617,3595,-73,-95,296,10641560,244
2133,a1703,20151120,3617,3595,3622,3624,3592,3592,3613,-3,18,26,939500,238
2134,a1703,20151123,3592,3613,3641,3641,3620,3632,3627,19,14,54,1958800,204
2135,a1703,20151124,3632,3627,3638,3665,3638,3665,3653,38,26,30,1095920,206
2136,a1703,20151125,3665,3653,3668,3693,3648,3655,3663,2,10,22,805880,200
2137,a1703,20151126,3655,3663,3647,3679,3647,3664,3665,1,2,42,1539380,198
2138,a1703,20151127,3664,3665,3677,3677,3642,3642,3660,-23,-5,24,878440,192
2139,a1703,20151130,3642,3660,0,0,0,3660,3660,0,0,0,0,192
2140,a1703,20151201,3660,3660,3648,3658,3647,3655,3654,-5,-6,54,1973500,174
2141,a1703,20151202,3655,3654,3683,3683,3642,3644,3665,-10,11,30,1099780,160
2142,a1703,20151203,3644,3665,3658,3688,3658,3688,3682,23,17,40,1473140,130
2143,a1703,20151204,3688,3682,0,0,0,3682,3682,0,0,0,0,130
2144,a1703,20151207,3682,3682,0,0,0,3688,3688,6,6,0,0,130
2145,a1703,20151208,3688,3688,3681,3691,3675,3675,3681,-13,-7,10,368140,130
2146,a1703,20151209,3675,3681,3667,3668,3667,3668,3667,-13,-14,4,146700,130
2147,a1703,20151210,3668,3667,3649,3656,3649,3650,3652,-17,-15,10,365200,130
2148,a1703,20151211,3650,3652,3646,3652,3637,3642,3644,-10,-8,16,583120,132
2149,a1703,20151214,3642,3644,3665,3665,3645,3645,3655,1,11,12,438600,132
2150,a1703,20151215,3645,3655,3652,3654,3638,3640,3647,-15,-8,10,364720,132
2151,a1703,20151216,3640,3647,3638,3651,3638,3651,3644,4,-3,14,510160,132
2152,a1703,20151217,3651,3644,0,0,0,3644,3644,0,0,0,0,132
2153,a1703,20151218,3644,3644,0,0,0,3644,3644,0,0,0,0,132
2154,a1703,20151221,3644,3644,3672,3767,3671,3709,3730,65,86,80,2984040,144
2155,a1703,20151222,3709,3730,3726,3735,3689,3689,3714,-41,-16,26,965800,150
2156,a1703,20151223,3689,3714,3682,3683,3666,3666,3674,-48,-40,12,440920,154
2157,a1703,20151224,3666,3674,0,0,0,3674,3674,0,0,0,0,154
2158,a1703,20151225,3674,3674,3676,3676,3625,3625,3665,-49,-9,14,513100,150
2159,a1703,20151228,3625,3665,3625,3625,3519,3519,3582,-146,-83,68,2436260,160
2160,a1703,20151229,3519,3582,3498,3510,3498,3510,3507,-72,-75,10,350700,160
2161,a1703,20151230,3510,3507,3520,3525,3504,3504,3515,-3,8,16,562440,160
2162,a1703,20151231,3504,3515,3502,3506,3491,3491,3501,-24,-14,22,770280,164
2163,a1705,20151116,3715,3715,3680,3835,3680,3710,3721,-5,6,102,3795520,60
2164,a1705,20151117,3710,3721,3695,3730,3695,3728,3728,7,7,178,6636560,126
2165,a1705,20151118,3728,3728,3718,3727,3652,3709,3702,-19,-26,16,592420,132
2166,a1705,20151119,3709,3702,3638,3700,3600,3629,3642,-73,-60,118,4298220,156
2167,a1705,20151120,3629,3642,3610,3645,3596,3621,3624,-21,-18,136,4929880,186
2168,a1705,20151123,3621,3624,3622,3667,3622,3630,3640,6,16,42,1529060,188
2169,a1705,20151124,3630,3640,3653,3735,3639,3686,3667,46,27,40,1466820,196
2170,a1705,20151125,3686,3667,3657,3672,3657,3671,3668,4,1,24,880380,200
2171,a1705,20151126,3671,3668,3680,3689,3671,3676,3678,8,10,58,2133500,234
2172,a1705,20151127,3676,3678,3678,3678,3660,3660,3667,-18,-11,42,1540180,244
2173,a1705,20151130,3660,3667,3652,3664,3652,3664,3659,-3,-8,22,805160,244
2174,a1705,20151201,3664,3659,3657,3678,3657,3677,3673,18,14,48,1763400,246
2175,a1705,20151202,3677,3673,3678,3720,3672,3678,3695,5,22,48,1773840,246
2176,a1705,20151203,3678,3695,3676,3708,3676,3700,3693,5,-2,80,2954500,246
2177,a1705,20151204,3700,3693,3729,3729,3680,3685,3693,-8,0,68,2511440,244
2178,a1705,20151207,3685,3693,3709,3709,3695,3695,3704,2,11,12,444520,244
2179,a1705,20151208,3695,3704,3691,3757,3671,3679,3690,-25,-14,62,2288200,246
2180,a1705,20151209,3679,3690,3678,3678,3662,3662,3670,-28,-20,24,880920,254
2181,a1705,20151210,3662,3670,3654,3669,3642,3642,3654,-28,-16,34,1242660,258
2182,a1705,20151211,3642,3654,3649,3659,3633,3659,3641,5,-13,108,3933320,226
2183,a1705,20151214,3659,3641,3647,3655,3636,3645,3644,4,3,16,583100,224
2184,a1705,20151215,3645,3644,3647,3670,3637,3637,3646,-7,2,40,1458760,228
2185,a1705,20151216,3637,3646,3666,3666,3642,3655,3654,9,8,120,4385980,298
2186,a1705,20151217,3655,3654,3656,3660,3655,3658,3656,4,2,216,7898820,232
2187,a1705,20151218,3658,3656,3631,3695,3625,3695,3674,39,18,122,4483020,254
2188,a1705,20151221,3695,3674,3692,3732,3692,3732,3713,58,39,156,5792440,302
2189,a1705,20151222,3732,3713,3741,3741,3706,3706,3726,-7,13,200,7452540,386
2190,a1705,20151223,3706,3726,3706,3708,3689,3689,3697,-37,-29,410,15158540,270
2191,a1705,20151224,3689,3697,3688,3703,3688,3697,3695,0,-2,54,1995620,284
2192,a1705,20151225,3697,3695,3696,3699,3648,3649,3670,-46,-25,308,11306240,418
2193,a1705,20151228,3649,3670,3628,3650,3524,3530,3582,-140,-88,392,14042720,482
2194,a1705,20151229,3530,3582,3526,3536,3517,3530,3528,-52,-54,382,13478060,534
2195,a1705,20151230,3530,3528,3450,3560,3450,3527,3525,-1,-3,242,8532420,518
2196,a1705,20151231,3527,3525,3530,3533,3510,3514,3517,-11,-8,184,6471620,558
