1,y1501,20150105,5498,5474,5200,5410,5170,5390,5346,-84,-128,2996,160206800,7872
2,y1501,20150106,5390,5346,5460,5638,5460,5562,5506,216,160,796,43839120,4348
3,y1501,20150107,5562,5506,5618,5668,5550,5560,5634,54,128,1108,62442720,3412
4,y1501,20150108,5560,5634,5350,5350,5350,5350,5350,-284,-284,2,107000,2412
5,y1501,20150109,5350,5350,5500,5500,5500,5500,5500,150,150,2,110000,2362
6,y1501,20150112,5500,5500,5500,5500,5500,5500,5500,0,0,200,11000000,1590
7,y1501,20150113,5500,5500,5430,5430,5430,5430,5430,-70,-70,2,108600,802
8,y1501,20150114,5430,5430,0,0,0,5430,5430,0,0,0,0,802
9,y1501,20150115,5430,5430,0,0,0,5430,5430,0,0,0,0,782
10,y1501,20150116,5430,5430,0,0,0,5440,5440,10,10,0,0,0
11,y1503,20150105,5606,5604,0,0,0,5562,5562,-42,-42,0,0,38
12,y1503,20150106,5562,5562,5576,5576,5574,5574,5574,12,12,400,22300000,438
13,y1503,20150107,5574,5574,5600,5622,5600,5622,5608,48,34,14,785360,436
14,y1503,20150108,5622,5608,5636,5690,5626,5690,5658,82,50,8,452680,36
15,y1503,20150109,5690,5658,5632,5646,5632,5642,5640,-16,-18,12,676800,32
16,y1503,20150112,5642,5640,5692,5774,5634,5692,5686,52,46,16,909960,32
17,y1503,20150113,5692,5686,0,0,0,5686,5686,0,0,0,0,32
18,y1503,20150114,5686,5686,0,0,0,5686,5686,0,0,0,0,32
19,y1503,20150115,5686,5686,5502,5524,5486,5486,5500,-200,-186,18,990200,24
20,y1503,20150116,5486,5500,5402,5402,5280,5298,5300,-202,-200,60,3180360,52
21,y1503,20150119,5298,5300,5298,5490,5268,5268,5318,-32,18,40,2127760,56
22,y1503,20150120,5268,5318,0,0,0,5318,5318,0,0,0,0,56
23,y1503,20150121,5318,5318,5384,5390,5362,5390,5378,72,60,18,968240,62
24,y1503,20150122,5390,5378,5376,5414,5356,5414,5384,36,6,20,1077120,56
25,y1503,20150123,5414,5384,5316,5462,5316,5462,5356,78,-28,12,642880,56
26,y1503,20150126,5462,5356,0,0,0,5400,5400,44,44,0,0,56
27,y1503,20150127,5400,5400,5400,5400,5400,5400,5400,0,0,2,108000,56
28,y1503,20150128,5400,5400,5488,5488,5334,5334,5410,-66,10,4,216440,54
29,y1503,20150129,5334,5410,5338,5348,5288,5300,5318,-110,-92,8,425480,54
30,y1503,20150130,5300,5318,5332,5332,5218,5218,5286,-100,-32,14,740120,56
31,y1503,20150202,5218,5286,5344,5488,5270,5488,5434,202,148,24,1304240,72
32,y1503,20150203,5488,5434,5590,5590,5434,5434,5512,0,78,4,220480,72
33,y1503,20150204,5434,5512,0,0,0,5512,5512,0,0,0,0,72
34,y1503,20150205,5512,5512,5430,5430,5294,5294,5412,-218,-100,28,1515600,54
35,y1503,20150206,5294,5412,0,0,0,5412,5412,0,0,0,0,54
36,y1503,20150209,5412,5412,0,0,0,5412,5412,0,0,0,0,54
37,y1503,20150210,5412,5412,0,0,0,5412,5412,0,0,0,0,54
38,y1503,20150211,5412,5412,0,0,0,5412,5412,0,0,0,0,54
39,y1503,20150212,5412,5412,0,0,0,5412,5412,0,0,0,0,54
40,y1503,20150213,5412,5412,0,0,0,5412,5412,0,0,0,0,54
41,y1503,20150216,5412,5412,5500,5610,5196,5610,5478,198,66,8,438320,54
42,y1503,20150217,5610,5478,5244,5244,5244,5244,5244,-234,-234,4,209760,52
43,y1503,20150225,5244,5244,4950,4950,4950,4950,4950,-294,-294,4,198000,52
44,y1503,20150226,4950,4950,5140,5148,5140,5148,5144,198,194,8,411560,54
45,y1503,20150227,5148,5144,5448,5448,5448,5448,5448,304,304,2,108960,52
46,y1503,20150302,5448,5448,5350,5350,5350,5350,5350,-98,-98,4,214000,28
47,y1503,20150303,5350,5350,5350,5350,5350,5350,5350,0,0,4,214000,28
48,y1503,20150304,5350,5350,0,0,0,5350,5350,0,0,0,0,28
49,y1503,20150305,5350,5350,0,0,0,5350,5350,0,0,0,0,28
50,y1503,20150306,5350,5350,0,0,0,5350,5350,0,0,0,0,28
51,y1503,20150309,5350,5350,0,0,0,5350,5350,0,0,0,0,28
52,y1503,20150310,5350,5350,0,0,0,5350,5350,0,0,0,0,28
53,y1503,20150311,5350,5350,0,0,0,5350,5350,0,0,0,0,28
54,y1503,20150312,5350,5350,0,0,0,5350,5350,0,0,0,0,28
55,y1503,20150313,5350,5350,5030,5030,5030,5030,5286,-320,-64,2,100600,0
56,y1505,20150105,5744,5728,5670,5690,5610,5650,5650,-78,-78,267922,15140928520,656812
57,y1505,20150106,5650,5650,5622,5716,5622,5702,5684,52,34,317880,18068374240,664274
58,y1505,20150107,5702,5684,5696,5736,5670,5692,5700,8,16,273406,15588931360,666324
59,y1505,20150108,5692,5700,5736,5772,5712,5736,5742,36,42,434430,24949548240,677466
60,y1505,20150109,5736,5742,5752,5778,5716,5740,5748,-2,6,385642,22174058320,677210
61,y1505,20150112,5740,5748,5740,5766,5728,5742,5746,-6,-2,241866,13902191680,671472
62,y1505,20150113,5742,5746,5736,5738,5636,5646,5680,-100,-66,288724,16401042400,667594
63,y1505,20150114,5646,5680,5652,5676,5596,5614,5630,-66,-50,384290,21638793400,682980
64,y1505,20150115,5614,5630,5614,5650,5576,5636,5618,6,-12,390866,21961867040,708976
65,y1505,20150116,5636,5618,5636,5682,5596,5612,5624,-6,6,408148,22962097120,710654
66,y1505,20150119,5612,5624,5610,5692,5434,5584,5604,-40,-20,921850,51675873120,679392
67,y1505,20150120,5584,5604,5580,5614,5554,5604,5586,0,-18,342626,19141999480,691060
68,y1505,20150121,5604,5586,5608,5654,5582,5630,5616,44,30,516624,29023560160,702504
69,y1505,20150122,5630,5616,5616,5640,5586,5592,5616,-24,0,433788,24369761080,735694
70,y1505,20150123,5592,5616,5608,5612,5540,5556,5566,-60,-50,498812,27764916840,725658
71,y1505,20150126,5556,5566,5560,5562,5506,5510,5526,-56,-40,315804,17455345360,714920
72,y1505,20150127,5510,5526,5522,5540,5478,5484,5510,-42,-16,365636,20149046160,702280
73,y1505,20150128,5484,5510,5508,5520,5452,5482,5482,-28,-28,380232,20849857200,673868
74,y1505,20150129,5482,5482,5480,5480,5396,5426,5436,-56,-46,429904,23370834000,649072
75,y1505,20150130,5426,5436,5390,5418,5308,5348,5356,-88,-80,598826,32077158320,664592
76,y1505,20150202,5348,5356,5372,5438,5322,5392,5378,36,22,477786,25702206400,680444
77,y1505,20150203,5392,5378,5436,5456,5410,5442,5428,64,50,389682,21155385760,690164
78,y1505,20150204,5442,5428,5466,5524,5426,5436,5470,8,42,448740,24549795320,657336
79,y1505,20150205,5436,5470,5442,5492,5410,5446,5444,-24,-26,500812,27271255760,658624
80,y1505,20150206,5446,5444,5512,5572,5474,5510,5516,66,72,697738,38491527120,632942
81,y1505,20150209,5510,5516,5536,5538,5488,5500,5506,-16,-10,319444,17593763880,628664
82,y1505,20150210,5500,5506,5474,5528,5470,5516,5504,10,-2,232768,12812218520,615542
83,y1505,20150211,5516,5504,5500,5510,5468,5498,5488,-6,-16,238132,13072765240,611672
84,y1505,20150212,5498,5488,5478,5496,5456,5474,5478,-14,-10,199094,10906373320,603066
85,y1505,20150213,5474,5478,5490,5582,5480,5572,5538,94,60,316532,17532792280,566204
86,y1505,20150216,5572,5538,5562,5604,5544,5566,5574,28,36,195888,10920478800,550176
87,y1505,20150217,5566,5574,5556,5590,5556,5566,5568,-8,-6,65210,3631520080,542420
88,y1505,20150225,5566,5568,5570,5570,5428,5520,5504,-48,-64,124168,6834488320,539634
89,y1505,20150226,5520,5504,5512,5570,5512,5558,5548,54,44,175304,9728516560,548012
90,y1505,20150227,5558,5548,5564,5672,5540,5666,5610,118,62,334744,18782321320,565776
91,y1505,20150302,5666,5610,5690,5758,5672,5740,5716,130,106,411866,23545230680,547382
92,y1505,20150303,5740,5716,5740,5784,5634,5662,5696,-54,-20,405772,23116518120,502932
93,y1505,20150304,5662,5696,5672,5704,5626,5672,5670,-24,-26,187716,10645185800,470708
94,y1505,20150305,5672,5670,5650,5652,5548,5552,5576,-118,-94,179860,10030683520,447996
95,y1505,20150306,5552,5576,5532,5552,5476,5480,5508,-96,-68,137150,7556533320,419908
96,y1505,20150309,5480,5508,5490,5550,5452,5534,5498,26,-10,158028,8689554440,380050
97,y1505,20150310,5534,5498,5526,5556,5500,5506,5522,8,24,148396,8196375560,351800
98,y1505,20150311,5506,5522,5496,5516,5466,5506,5494,-16,-28,119630,6572484360,340924
99,y1505,20150312,5506,5494,5520,5536,5490,5518,5510,24,16,96586,5322329440,333058
100,y1505,20150313,5518,5510,5494,5528,5474,5484,5490,-26,-20,69098,3794842440,329086
101,y1505,20150316,5484,5490,5480,5480,5312,5420,5406,-70,-84,126486,6840153240,323432
102,y1505,20150317,5420,5406,5416,5460,5404,5460,5436,54,30,71982,3913315360,312172
103,y1505,20150318,5460,5436,5430,5462,5396,5452,5422,16,-14,94564,5128966280,310296
104,y1505,20150319,5452,5422,5470,5560,5468,5530,5508,108,86,122904,6770688360,293936
105,y1505,20150320,5530,5508,5510,5512,5458,5468,5482,-40,-26,66180,3628905840,279242
106,y1505,20150323,5468,5482,5450,5510,5434,5494,5474,12,-8,68586,3755397920,259278
107,y1505,20150324,5494,5474,5492,5546,5480,5510,5504,36,30,82984,4569008480,239242
108,y1505,20150325,5510,5504,5530,5530,5482,5486,5498,-18,-6,33188,1824876960,235986
109,y1505,20150326,5486,5498,5514,5528,5474,5520,5504,22,6,27590,1518648440,232594
110,y1505,20150327,5520,5504,5510,5552,5486,5494,5510,-10,6,34070,1877295640,231658
111,y1505,20150330,5494,5510,5494,5504,5416,5444,5448,-66,-62,46302,2523143720,223656
112,y1505,20150331,5444,5448,5456,5460,5408,5414,5430,-34,-18,42618,2314427320,207438
113,y1505,20150401,5414,5430,5398,5454,5384,5406,5416,-24,-14,31232,1691743080,197568
114,y1505,20150402,5406,5416,5414,5466,5388,5466,5438,50,22,29058,1580393960,190554
115,y1505,20150403,5466,5438,5440,5466,5426,5448,5444,10,6,16898,920020000,186968
116,y1505,20150407,5448,5444,5448,5522,5448,5498,5494,54,50,13688,752129680,182090
117,y1505,20150408,5498,5494,5448,5504,5448,5478,5484,-16,-10,21558,1182440000,170794
118,y1505,20150409,5478,5484,5476,5476,5426,5434,5444,-50,-40,24022,1307965160,161754
119,y1505,20150410,5434,5444,5432,5468,5418,5458,5444,14,0,37726,2054291800,142354
120,y1505,20150413,5458,5444,5464,5542,5464,5522,5516,78,72,40628,2241320640,127672
121,y1505,20150414,5522,5516,5520,5542,5492,5506,5506,-10,-10,53100,2923901880,117600
122,y1505,20150415,5506,5506,5520,5620,5510,5612,5564,106,58,58842,3275075440,99062
123,y1505,20150416,5612,5564,5612,5674,5594,5626,5628,62,64,23352,1314382720,87716
124,y1505,20150417,5626,5628,5620,5630,5570,5574,5588,-54,-40,34994,1956162880,68052
125,y1505,20150420,5574,5588,5562,5620,5544,5596,5592,8,4,46266,2587353800,37092
126,y1505,20150421,5596,5592,5580,5662,5580,5652,5626,60,34,13008,731902280,29970
127,y1505,20150422,5652,5626,5642,5674,5588,5626,5622,0,-4,9228,518939640,26284
128,y1505,20150423,5626,5622,5626,5638,5586,5590,5608,-32,-14,7704,432172920,22926
129,y1505,20150424,5590,5608,5562,5626,5562,5582,5602,-26,-6,8826,494464080,21438
130,y1505,20150427,5582,5602,5650,5650,5544,5602,5584,0,-18,6062,338614040,19618
131,y1505,20150428,5602,5584,5570,5630,5570,5606,5598,22,14,4566,255678880,18206
132,y1505,20150429,5606,5598,5600,5614,5572,5600,5590,2,-8,2802,156687040,16546
133,y1505,20150430,5600,5590,5598,5612,5566,5574,5590,-16,0,3546,198271200,15142
134,y1505,20150504,5574,5590,5550,5720,5550,5720,5666,130,76,3760,213082720,13544
135,y1505,20150505,5720,5666,5818,5818,5768,5810,5800,144,134,248,14387240,13434
136,y1505,20150506,5810,5800,5898,5902,5866,5866,5876,66,76,138,8110840,13296
137,y1505,20150507,5866,5876,0,0,0,5876,5876,0,0,0,0,13296
138,y1505,20150508,5876,5876,0,0,0,5876,5876,0,0,0,0,13296
139,y1505,20150511,5876,5876,0,0,0,5876,5876,0,0,0,0,13296
140,y1505,20150512,5876,5876,5810,5810,5810,5810,5810,-66,-66,1708,99234800,13296
141,y1505,20150513,5810,5810,5810,5820,5810,5820,5812,10,2,1104,64182400,11290
142,y1505,20150514,5820,5812,5810,5810,5810,5810,5810,-2,-2,864,50198400,11290
143,y1505,20150515,5810,5810,0,0,0,5742,5742,-68,-68,0,0,0
144,y1507,20150105,5790,5790,5686,5772,5680,5704,5718,-86,-72,34,1944520,28
145,y1507,20150106,5704,5718,5724,5752,5724,5750,5740,32,22,22,1262800,20
146,y1507,20150107,5750,5740,5802,5802,5768,5768,5784,28,44,4,231400,20
147,y1507,20150108,5768,5784,5744,5810,5728,5754,5760,-30,-24,18,1036920,22
148,y1507,20150109,5754,5760,0,0,0,5760,5760,0,0,0,0,22
149,y1507,20150112,5760,5760,5784,5784,5784,5784,5784,24,24,2,115680,20
150,y1507,20150113,5784,5784,5730,5740,5700,5716,5712,-68,-72,18,1028320,6
151,y1507,20150114,5716,5712,5578,5578,5578,5578,5578,-134,-134,2,111560,4
152,y1507,20150115,5578,5578,5570,5628,5570,5628,5598,50,20,4,223960,2
153,y1507,20150116,5628,5598,0,0,0,5598,5598,0,0,0,0,2
154,y1507,20150119,5598,5598,0,0,0,5598,5598,0,0,0,0,2
155,y1507,20150120,5598,5598,5580,5580,5580,5580,5580,-18,-18,2,111600,4
156,y1507,20150121,5580,5580,0,0,0,5580,5580,0,0,0,0,4
157,y1507,20150122,5580,5580,0,0,0,5586,5586,6,6,0,0,4
158,y1507,20150123,5586,5586,5608,5608,5608,5608,5608,22,22,2,112160,2
159,y1507,20150126,5608,5608,0,0,0,5608,5608,0,0,0,0,2
160,y1507,20150127,5608,5608,5570,5570,5570,5570,5570,-38,-38,2,111400,2
161,y1507,20150128,5570,5570,0,0,0,5570,5570,0,0,0,0,2
162,y1507,20150129,5570,5570,0,0,0,5524,5524,-46,-46,0,0,2
163,y1507,20150130,5524,5524,0,0,0,5412,5412,-112,-112,0,0,2
164,y1507,20150202,5412,5412,5438,5438,5400,5400,5418,-12,6,4,216760,2
165,y1507,20150203,5400,5418,0,0,0,5418,5418,0,0,0,0,2
166,y1507,20150204,5418,5418,0,0,0,5418,5418,0,0,0,0,2
167,y1507,20150205,5418,5418,0,0,0,5418,5418,0,0,0,0,2
168,y1507,20150206,5418,5418,5570,5570,5570,5570,5570,152,152,10,557000,12
169,y1507,20150209,5570,5570,0,0,0,5560,5560,-10,-10,0,0,12
170,y1507,20150210,5560,5560,0,0,0,5558,5558,-2,-2,0,0,12
171,y1507,20150211,5558,5558,0,0,0,5542,5542,-16,-16,0,0,12
172,y1507,20150212,5542,5542,0,0,0,5532,5532,-10,-10,0,0,12
173,y1507,20150213,5532,5532,0,0,0,5580,5580,48,48,0,0,12
174,y1507,20150216,5580,5580,0,0,0,5616,5616,36,36,0,0,12
175,y1507,20150217,5616,5616,0,0,0,5610,5610,-6,-6,0,0,12
176,y1507,20150225,5610,5610,0,0,0,5546,5546,-64,-64,0,0,12
177,y1507,20150226,5546,5546,0,0,0,5590,5590,44,44,0,0,12
178,y1507,20150227,5590,5590,0,0,0,5652,5652,62,62,0,0,12
179,y1507,20150302,5652,5652,5816,5816,5720,5720,5768,68,116,12,692160,12
180,y1507,20150303,5720,5768,5834,5834,5708,5708,5770,-60,2,4,230840,14
181,y1507,20150304,5708,5770,0,0,0,5744,5744,-26,-26,0,0,14
182,y1507,20150305,5744,5744,0,0,0,5650,5650,-94,-94,0,0,14
183,y1507,20150306,5650,5650,0,0,0,5582,5582,-68,-68,0,0,14
184,y1507,20150309,5582,5582,0,0,0,5572,5572,-10,-10,0,0,14
185,y1507,20150310,5572,5572,0,0,0,5596,5596,24,24,0,0,14
186,y1507,20150311,5596,5596,0,0,0,5500,5500,-96,-96,0,0,14
187,y1507,20150312,5500,5500,5580,5580,5484,5484,5536,-16,36,32,1771920,18
188,y1507,20150313,5484,5536,0,0,0,5516,5516,-20,-20,0,0,18
189,y1507,20150316,5516,5516,0,0,0,5470,5470,-46,-46,0,0,18
190,y1507,20150317,5470,5470,5386,5386,5386,5386,5386,-84,-84,2,107720,16
191,y1507,20150318,5386,5386,0,0,0,5374,5374,-12,-12,0,0,16
192,y1507,20150319,5374,5374,0,0,0,5458,5458,84,84,0,0,16
193,y1507,20150320,5458,5458,0,0,0,5434,5434,-24,-24,0,0,16
194,y1507,20150323,5434,5434,5538,5538,5538,5538,5538,104,104,2,110760,18
195,y1507,20150324,5538,5538,0,0,0,5568,5568,30,30,0,0,18
196,y1507,20150325,5568,5568,0,0,0,5562,5562,-6,-6,0,0,18
197,y1507,20150326,5562,5562,5442,5566,5442,5480,5500,-82,-62,110,6051320,12
198,y1507,20150327,5480,5500,0,0,0,5472,5472,-28,-28,0,0,12
199,y1507,20150330,5472,5472,5468,5468,5382,5382,5424,-90,-48,26,1410360,16
200,y1507,20150331,5382,5424,0,0,0,5390,5390,-34,-34,0,0,16
201,y1507,20150401,5390,5390,0,0,0,5390,5390,0,0,0,0,16
202,y1507,20150402,5390,5390,0,0,0,5390,5390,0,0,0,0,16
203,y1507,20150403,5390,5390,0,0,0,5394,5394,4,4,0,0,16
204,y1507,20150407,5394,5394,0,0,0,5426,5426,32,32,0,0,16
205,y1507,20150408,5426,5426,5468,5472,5376,5376,5446,-50,20,18,980560,12
206,y1507,20150409,5376,5446,0,0,0,5406,5406,-40,-40,0,0,12
207,y1507,20150410,5406,5406,0,0,0,5406,5406,0,0,0,0,12
208,y1507,20150413,5406,5406,0,0,0,5476,5476,70,70,0,0,12
209,y1507,20150414,5476,5476,0,0,0,5476,5476,0,0,0,0,12
210,y1507,20150415,5476,5476,0,0,0,5550,5550,74,74,0,0,12
211,y1507,20150416,5550,5550,0,0,0,5612,5612,62,62,0,0,12
212,y1507,20150417,5612,5612,0,0,0,5602,5602,-10,-10,0,0,12
213,y1507,20150420,5602,5602,0,0,0,5618,5618,16,16,0,0,12
214,y1507,20150421,5618,5618,0,0,0,5652,5652,34,34,0,0,12
215,y1507,20150422,5652,5652,0,0,0,5648,5648,-4,-4,0,0,12
216,y1507,20150423,5648,5648,5726,5770,5652,5658,5716,10,68,30,1715000,12
217,y1507,20150424,5658,5716,5692,5692,5692,5692,5692,-24,-24,2,113840,10
218,y1507,20150427,5692,5692,5600,5722,5588,5608,5618,-84,-74,30,1685480,8
219,y1507,20150428,5608,5618,0,0,0,5618,5618,0,0,0,0,8
220,y1507,20150429,5618,5618,5684,5684,5528,5648,5632,30,14,8,450560,6
221,y1507,20150430,5648,5632,0,0,0,5632,5632,0,0,0,0,6
222,y1507,20150504,5632,5632,0,0,0,5684,5684,52,52,0,0,6
223,y1507,20150505,5684,5684,0,0,0,5720,5720,36,36,0,0,6
224,y1507,20150506,5720,5720,5948,5948,5806,5948,5926,228,206,16,948320,4
225,y1507,20150507,5948,5926,5816,6032,5816,5904,5916,-22,-10,6,355040,4
226,y1507,20150508,5904,5916,0,0,0,5916,5916,0,0,0,0,4
227,y1507,20150511,5916,5916,0,0,0,5916,5916,0,0,0,0,4
228,y1507,20150512,5916,5916,0,0,0,5850,5850,-66,-66,0,0,4
229,y1507,20150513,5850,5850,5958,5958,5892,5892,5936,42,86,6,356160,6
230,y1507,20150514,5892,5936,0,0,0,5934,5934,-2,-2,0,0,6
231,y1507,20150515,5934,5934,0,0,0,5934,5934,0,0,0,0,6
232,y1507,20150518,5934,5934,0,0,0,5934,5934,0,0,0,0,6
233,y1507,20150519,5934,5934,0,0,0,5934,5934,0,0,0,0,6
234,y1507,20150520,5934,5934,0,0,0,5934,5934,0,0,0,0,6
235,y1507,20150521,5934,5934,5704,5704,5698,5698,5700,-236,-234,4,228040,6
236,y1507,20150522,5698,5700,5696,5740,5660,5664,5698,-36,-2,12,683840,2
237,y1507,20150525,5664,5698,0,0,0,5698,5698,0,0,0,0,2
238,y1507,20150526,5698,5698,5760,5760,5686,5686,5722,-12,24,4,228920,2
239,y1507,20150527,5686,5722,0,0,0,5722,5722,0,0,0,0,2
240,y1507,20150528,5722,5722,0,0,0,5722,5722,0,0,0,0,2
241,y1507,20150529,5722,5722,5816,5816,5816,5816,5816,94,94,4,232640,6
242,y1507,20150601,5816,5816,0,0,0,5816,5816,0,0,0,0,6
243,y1507,20150602,5816,5816,0,0,0,5816,5816,0,0,0,0,6
244,y1507,20150603,5816,5816,6022,6022,5866,5866,5970,50,154,6,358200,8
245,y1507,20150604,5866,5970,5836,5836,5834,5834,5834,-136,-136,4,233400,4
246,y1507,20150605,5834,5834,0,0,0,5834,5834,0,0,0,0,4
247,y1507,20150608,5834,5834,0,0,0,5834,5834,0,0,0,0,4
248,y1507,20150609,5834,5834,0,0,0,5834,5834,0,0,0,0,4
249,y1507,20150610,5834,5834,0,0,0,5834,5834,0,0,0,0,4
250,y1507,20150611,5834,5834,0,0,0,5834,5834,0,0,0,0,4
251,y1507,20150612,5834,5834,0,0,0,5834,5834,0,0,0,0,4
252,y1507,20150615,5834,5834,0,0,0,5834,5834,0,0,0,0,4
253,y1507,20150616,5834,5834,0,0,0,5834,5834,0,0,0,0,4
254,y1507,20150617,5834,5834,0,0,0,5834,5834,0,0,0,0,4
255,y1507,20150618,5834,5834,5690,6066,5680,6056,5872,222,38,8,469840,4
256,y1507,20150619,6056,5872,0,0,0,5872,5872,0,0,0,0,4
257,y1507,20150623,5872,5872,5988,5988,5650,5650,5818,-222,-54,4,232760,2
258,y1507,20150624,5650,5818,0,0,0,5818,5818,0,0,0,0,2
259,y1507,20150625,5818,5818,0,0,0,5818,5818,0,0,0,0,2
260,y1507,20150626,5818,5818,5586,5586,5586,5586,5586,-232,-232,2,111720,0
261,y1507,20150629,5586,5586,0,0,0,5586,5586,0,0,0,0,0
262,y1507,20150630,5586,5586,0,0,0,5586,5586,0,0,0,0,0
263,y1507,20150701,5586,5586,0,0,0,5586,5586,0,0,0,0,0
264,y1507,20150702,5586,5586,0,0,0,5586,5586,0,0,0,0,0
265,y1507,20150703,5586,5586,0,0,0,5586,5586,0,0,0,0,0
266,y1507,20150706,5586,5586,0,0,0,5586,5586,0,0,0,0,0
267,y1507,20150707,5586,5586,0,0,0,5586,5586,0,0,0,0,0
268,y1507,20150708,5586,5586,0,0,0,5586,5586,0,0,0,0,0
269,y1507,20150709,5586,5586,0,0,0,5586,5586,0,0,0,0,0
270,y1507,20150710,5586,5586,0,0,0,5586,5586,0,0,0,0,0
271,y1507,20150713,5586,5586,0,0,0,5586,5586,0,0,0,0,0
272,y1507,20150714,5586,5586,0,0,0,5586,5586,0,0,0,0,0
273,y1508,20150105,5810,5810,0,0,0,5778,5778,-32,-32,0,0,20
274,y1508,20150106,5778,5778,0,0,0,5778,5778,0,0,0,0,20
275,y1508,20150107,5778,5778,0,0,0,5778,5778,0,0,0,0,20
276,y1508,20150108,5778,5778,0,0,0,5820,5820,42,42,0,0,20
277,y1508,20150109,5820,5820,0,0,0,5820,5820,0,0,0,0,20
278,y1508,20150112,5820,5820,5868,5868,5840,5842,5858,22,38,60,3515520,24
279,y1508,20150113,5842,5858,0,0,0,5816,5816,-42,-42,0,0,24
280,y1508,20150114,5816,5816,0,0,0,5680,5680,-136,-136,0,0,24
281,y1508,20150115,5680,5680,0,0,0,5698,5698,18,18,0,0,24
282,y1508,20150116,5698,5698,0,0,0,5704,5704,6,6,0,0,24
283,y1508,20150119,5704,5704,5670,5670,5628,5628,5638,-76,-66,8,451080,24
284,y1508,20150120,5628,5638,5666,5666,5666,5666,5666,28,28,2,113320,24
285,y1508,20150121,5666,5666,0,0,0,5684,5684,18,18,0,0,24
286,y1508,20150122,5684,5684,0,0,0,5684,5684,0,0,0,0,24
287,y1508,20150123,5684,5684,5662,5662,5622,5640,5642,-44,-42,24,1354480,32
288,y1508,20150126,5640,5642,5592,5594,5592,5592,5592,-50,-50,22,1230280,32
289,y1508,20150127,5592,5592,0,0,0,5586,5586,-6,-6,0,0,32
290,y1508,20150128,5586,5586,0,0,0,5572,5572,-14,-14,0,0,32
291,y1508,20150129,5572,5572,0,0,0,5510,5510,-62,-62,0,0,32
292,y1508,20150130,5510,5510,0,0,0,5430,5430,-80,-80,0,0,32
293,y1508,20150202,5430,5430,0,0,0,5430,5430,0,0,0,0,32
294,y1508,20150203,5430,5430,0,0,0,5456,5456,26,26,0,0,32
295,y1508,20150204,5456,5456,5534,5534,5496,5496,5514,40,58,4,220600,32
296,y1508,20150205,5496,5514,0,0,0,5514,5514,0,0,0,0,32
297,y1508,20150206,5514,5514,5620,5620,5620,5620,5620,106,106,16,899200,48
298,y1508,20150209,5620,5620,5618,5618,5572,5582,5588,-38,-32,16,894160,36
299,y1508,20150210,5582,5588,0,0,0,5588,5588,0,0,0,0,36
300,y1508,20150211,5588,5588,0,0,0,5588,5588,0,0,0,0,36
301,y1508,20150212,5588,5588,0,0,0,5578,5578,-10,-10,0,0,36
302,y1508,20150213,5578,5578,5606,5636,5600,5600,5614,22,36,14,786000,30
303,y1508,20150216,5600,5614,5642,5642,5638,5638,5638,24,24,8,451120,30
304,y1508,20150217,5638,5638,0,0,0,5638,5638,0,0,0,0,30
305,y1508,20150225,5638,5638,0,0,0,5574,5574,-64,-64,0,0,30
306,y1508,20150226,5574,5574,5614,5614,5578,5578,5588,4,14,8,447120,26
307,y1508,20150227,5578,5588,5656,5656,5656,5656,5656,68,68,2,113120,26
308,y1508,20150302,5656,5656,5700,5760,5684,5760,5708,104,52,16,913440,12
309,y1508,20150303,5760,5708,5720,5720,5720,5720,5720,12,12,2,114400,10
310,y1508,20150304,5720,5720,5732,5732,5686,5686,5708,-34,-12,4,228360,12
311,y1508,20150305,5686,5708,0,0,0,5622,5622,-86,-86,0,0,12
312,y1508,20150306,5622,5622,0,0,0,5536,5536,-86,-86,0,0,12
313,y1508,20150309,5536,5536,0,0,0,5536,5536,0,0,0,0,12
314,y1508,20150310,5536,5536,0,0,0,5490,5490,-46,-46,0,0,12
315,y1508,20150311,5490,5490,0,0,0,5490,5490,0,0,0,0,12
316,y1508,20150312,5490,5490,5500,5500,5458,5494,5484,4,-6,6,329040,12
317,y1508,20150313,5494,5484,0,0,0,5484,5484,0,0,0,0,12
318,y1508,20150316,5484,5484,0,0,0,5418,5418,-66,-66,0,0,12
319,y1508,20150317,5418,5418,5376,5376,5376,5376,5376,-42,-42,2,107520,12
320,y1508,20150318,5376,5376,0,0,0,5376,5376,0,0,0,0,12
321,y1508,20150319,5376,5376,0,0,0,5376,5376,0,0,0,0,12
322,y1508,20150320,5376,5376,0,0,0,5352,5352,-24,-24,0,0,12
323,y1508,20150323,5352,5352,0,0,0,5362,5362,10,10,0,0,12
324,y1508,20150324,5362,5362,5532,5532,5450,5450,5492,88,130,8,439480,12
325,y1508,20150325,5450,5492,0,0,0,5482,5482,-10,-10,0,0,12
326,y1508,20150326,5482,5482,5414,5456,5414,5456,5434,-26,-48,8,434800,10
327,y1508,20150327,5456,5434,0,0,0,5434,5434,0,0,0,0,10
328,y1508,20150330,5434,5434,0,0,0,5388,5388,-46,-46,0,0,10
329,y1508,20150331,5388,5388,5292,5380,5292,5380,5336,-8,-52,8,426880,12
330,y1508,20150401,5380,5336,5370,5386,5322,5338,5354,2,18,36,1927520,10
331,y1508,20150402,5338,5354,0,0,0,5354,5354,0,0,0,0,10
332,y1508,20150403,5354,5354,0,0,0,5354,5354,0,0,0,0,10
333,y1508,20150407,5354,5354,0,0,0,5402,5402,48,48,0,0,10
334,y1508,20150408,5402,5402,5434,5434,5434,5434,5434,32,32,2,108680,12
335,y1508,20150409,5434,5434,5350,5350,5350,5350,5350,-84,-84,2,107000,10
336,y1508,20150410,5350,5350,0,0,0,5350,5350,0,0,0,0,10
337,y1508,20150413,5350,5350,0,0,0,5392,5392,42,42,0,0,10
338,y1508,20150414,5392,5392,0,0,0,5392,5392,0,0,0,0,10
339,y1508,20150415,5392,5392,0,0,0,5442,5442,50,50,0,0,10
340,y1508,20150416,5442,5442,0,0,0,5504,5504,62,62,0,0,10
341,y1508,20150417,5504,5504,5510,5552,5510,5552,5526,48,22,10,552640,6
342,y1508,20150420,5552,5526,5536,5634,5536,5600,5580,74,54,8,446520,6
343,y1508,20150421,5600,5580,5616,5632,5614,5616,5622,36,42,20,1124440,6
344,y1508,20150422,5616,5622,0,0,0,5622,5622,0,0,0,0,6
345,y1508,20150423,5622,5622,5708,5708,5614,5702,5674,80,52,20,1134800,10
346,y1508,20150424,5702,5674,5662,5728,5662,5680,5686,6,12,8,455000,6
347,y1508,20150427,5680,5686,0,0,0,5614,5614,-72,-72,0,0,6
348,y1508,20150428,5614,5614,0,0,0,5614,5614,0,0,0,0,6
349,y1508,20150429,5614,5614,5606,5626,5602,5626,5610,12,-4,6,336680,6
350,y1508,20150430,5626,5610,5622,5710,5608,5626,5642,16,32,34,1918560,4
351,y1508,20150504,5626,5642,5734,5758,5582,5726,5700,84,58,12,684000,4
352,y1508,20150505,5726,5700,0,0,0,5834,5834,134,134,0,0,4
353,y1508,20150506,5834,5834,5894,6066,5866,5918,5928,84,94,34,2015760,6
354,y1508,20150507,5918,5928,5838,5888,5838,5846,5858,-82,-70,18,1054440,8
355,y1508,20150508,5846,5858,5846,5846,5806,5806,5828,-52,-30,6,349720,6
356,y1508,20150511,5806,5828,0,0,0,5840,5840,12,12,0,0,6
357,y1508,20150512,5840,5840,5898,5898,5898,5898,5898,58,58,4,235920,6
358,y1508,20150513,5898,5898,5866,5866,5866,5866,5866,-32,-32,4,234640,6
359,y1508,20150514,5866,5866,5802,5840,5802,5840,5820,-26,-46,4,232840,4
360,y1508,20150515,5840,5820,0,0,0,5820,5820,0,0,0,0,4
361,y1508,20150518,5820,5820,5834,5834,5792,5832,5818,12,-2,6,349160,6
362,y1508,20150519,5832,5818,5812,5812,5800,5808,5806,-10,-12,8,464560,4
363,y1508,20150520,5808,5806,5650,5670,5596,5636,5638,-170,-168,38,2143080,6
364,y1508,20150521,5636,5638,5718,5718,5718,5718,5718,80,80,6,343080,10
365,y1508,20150522,5718,5718,0,0,0,5718,5718,0,0,0,0,10
366,y1508,20150525,5718,5718,5676,5676,5654,5654,5664,-64,-54,4,226600,10
367,y1508,20150526,5654,5664,5760,5760,5760,5760,5760,96,96,6,345600,4
368,y1508,20150527,5760,5760,0,0,0,5760,5760,0,0,0,0,4
369,y1508,20150528,5760,5760,0,0,0,5760,5760,0,0,0,0,4
370,y1508,20150529,5760,5760,0,0,0,5854,5854,94,94,0,0,4
371,y1508,20150601,5854,5854,5828,5888,5820,5820,5852,-34,-2,14,819360,8
372,y1508,20150602,5820,5852,0,0,0,5852,5852,0,0,0,0,8
373,y1508,20150603,5852,5852,5942,5942,5804,5804,5862,-48,10,14,820880,4
374,y1508,20150604,5804,5862,5876,5876,5728,5728,5802,-134,-60,10,580320,4
375,y1508,20150605,5728,5802,0,0,0,5802,5802,0,0,0,0,4
376,y1508,20150608,5802,5802,0,0,0,5802,5802,0,0,0,0,4
377,y1508,20150609,5802,5802,0,0,0,5802,5802,0,0,0,0,4
378,y1508,20150610,5802,5802,5746,5746,5664,5664,5718,-138,-84,10,571840,4
379,y1508,20150611,5664,5718,0,0,0,5718,5718,0,0,0,0,4
380,y1508,20150612,5718,5718,0,0,0,5718,5718,0,0,0,0,4
381,y1508,20150615,5718,5718,0,0,0,5718,5718,0,0,0,0,4
382,y1508,20150616,5718,5718,0,0,0,5718,5718,0,0,0,0,4
383,y1508,20150617,5718,5718,0,0,0,5718,5718,0,0,0,0,4
384,y1508,20150618,5718,5718,5756,5756,5690,5690,5724,-28,6,8,458040,4
385,y1508,20150619,5690,5724,0,0,0,5724,5724,0,0,0,0,4
386,y1508,20150623,5724,5724,0,0,0,5672,5672,-52,-52,0,0,4
387,y1508,20150624,5672,5672,5680,5680,5654,5654,5666,-18,-6,4,226680,4
388,y1508,20150625,5654,5666,0,0,0,5666,5666,0,0,0,0,4
389,y1508,20150626,5666,5666,0,0,0,5442,5442,-224,-224,0,0,4
390,y1508,20150629,5442,5442,5574,5652,5570,5636,5616,194,174,22,1235760,4
391,y1508,20150630,5636,5616,0,0,0,5616,5616,0,0,0,0,4
392,y1508,20150701,5616,5616,5600,5600,5560,5560,5580,-56,-36,4,223200,4
393,y1508,20150702,5560,5580,0,0,0,5580,5580,0,0,0,0,4
394,y1508,20150703,5580,5580,0,0,0,5580,5580,0,0,0,0,4
395,y1508,20150706,5580,5580,5590,5590,5590,5590,5590,10,10,2,111800,4
396,y1508,20150707,5590,5590,0,0,0,5590,5590,0,0,0,0,4
397,y1508,20150708,5590,5590,0,0,0,5590,5590,0,0,0,0,4
398,y1508,20150709,5590,5590,5368,5466,5368,5466,5390,-124,-200,66,3557760,8
399,y1508,20150710,5466,5390,0,0,0,5390,5390,0,0,0,0,8
400,y1508,20150713,5390,5390,5486,5486,5406,5406,5446,16,56,4,217840,6
401,y1508,20150714,5406,5446,5406,5634,5406,5628,5528,182,82,10,552920,6
402,y1508,20150715,5628,5528,5524,5524,5524,5524,5524,-4,-4,2,110480,4
403,y1508,20150716,5524,5524,0,0,0,5524,5524,0,0,0,0,4
404,y1508,20150717,5524,5524,5524,5524,5524,5524,5524,0,0,2,110480,2
405,y1508,20150720,5524,5524,0,0,0,5524,5524,0,0,0,0,2
406,y1508,20150721,5524,5524,0,0,0,5524,5524,0,0,0,0,2
407,y1508,20150722,5524,5524,0,0,0,5524,5524,0,0,0,0,2
408,y1508,20150723,5524,5524,0,0,0,5524,5524,0,0,0,0,2
409,y1508,20150724,5524,5524,0,0,0,5524,5524,0,0,0,0,2
410,y1508,20150727,5524,5524,0,0,0,5524,5524,0,0,0,0,2
411,y1508,20150728,5524,5524,0,0,0,5524,5524,0,0,0,0,2
412,y1508,20150729,5524,5524,0,0,0,5524,5524,0,0,0,0,2
413,y1508,20150730,5524,5524,5524,5666,5524,5524,5558,0,34,8,444760,0
414,y1508,20150731,5524,5558,0,0,0,5558,5558,0,0,0,0,0
415,y1508,20150803,5558,5558,0,0,0,5558,5558,0,0,0,0,0
416,y1508,20150804,5558,5558,0,0,0,5558,5558,0,0,0,0,0
417,y1508,20150805,5558,5558,0,0,0,5558,5558,0,0,0,0,0
418,y1508,20150806,5558,5558,0,0,0,5558,5558,0,0,0,0,0
419,y1508,20150807,5558,5558,0,0,0,5558,5558,0,0,0,0,0
420,y1508,20150810,5558,5558,0,0,0,5558,5558,0,0,0,0,0
421,y1508,20150811,5558,5558,0,0,0,5558,5558,0,0,0,0,0
422,y1508,20150812,5558,5558,0,0,0,5558,5558,0,0,0,0,0
423,y1508,20150813,5558,5558,0,0,0,5558,5558,0,0,0,0,0
424,y1508,20150814,5558,5558,0,0,0,5558,5558,0,0,0,0,0
425,y1509,20150105,5826,5814,5730,5772,5700,5724,5732,-90,-82,49200,2820934760,165222
426,y1509,20150106,5724,5732,5718,5792,5704,5778,5754,46,22,51336,2954383960,170632
427,y1509,20150107,5778,5754,5768,5810,5756,5772,5778,18,24,52658,3043202320,169904
428,y1509,20150108,5772,5778,5808,5856,5794,5824,5826,46,48,66950,3901390800,168894
429,y1509,20150109,5824,5826,5848,5864,5802,5822,5834,-4,8,67400,3933321560,170362
430,y1509,20150112,5822,5834,5820,5848,5812,5826,5832,-8,-2,28308,1651057280,169648
431,y1509,20150113,5826,5832,5820,5822,5724,5732,5766,-100,-66,53660,3095058120,165864
432,y1509,20150114,5732,5766,5706,5762,5684,5704,5718,-62,-48,57654,3297587120,174046
433,y1509,20150115,5704,5718,5698,5738,5666,5726,5706,8,-12,71808,4097718640,187778
434,y1509,20150116,5726,5706,5740,5762,5678,5696,5708,-10,2,67006,3824799480,201716
435,y1509,20150119,5696,5708,5702,5774,5524,5666,5692,-42,-16,99816,5682843160,198162
436,y1509,20150120,5666,5692,5672,5696,5642,5686,5668,-6,-24,68464,3881035160,210502
437,y1509,20150121,5686,5668,5700,5730,5666,5706,5698,38,30,93076,5305200160,230740
438,y1509,20150122,5706,5698,5700,5712,5650,5658,5690,-40,-8,99580,5666159280,255980
439,y1509,20150123,5658,5690,5662,5674,5576,5588,5610,-102,-80,185190,10392411160,301286
440,y1509,20150126,5588,5610,5598,5600,5530,5534,5558,-76,-52,109850,6107173680,310642
441,y1509,20150127,5534,5558,5524,5560,5502,5506,5534,-52,-24,133504,7388463080,331622
442,y1509,20150128,5506,5534,5528,5536,5490,5506,5506,-28,-28,122462,6743967360,338288
443,y1509,20150129,5506,5506,5500,5500,5418,5440,5452,-66,-54,159442,8695885600,365984
444,y1509,20150130,5440,5452,5402,5426,5326,5364,5374,-88,-78,211738,11379648040,398456
445,y1509,20150202,5364,5374,5382,5442,5334,5402,5384,28,10,147490,7942511920,400196
446,y1509,20150203,5402,5384,5462,5472,5418,5454,5446,70,62,153486,8361603240,415108
447,y1509,20150204,5454,5446,5488,5534,5450,5454,5488,8,42,150986,8288220440,413344
448,y1509,20150205,5454,5488,5476,5508,5428,5470,5466,-18,-22,200656,10968031880,432250
449,y1509,20150206,5470,5466,5530,5596,5520,5544,5550,78,84,243760,13531611440,417076
450,y1509,20150209,5544,5550,5568,5580,5528,5536,5544,-14,-6,149800,8306851560,423220
451,y1509,20150210,5536,5544,5524,5556,5498,5540,5534,-4,-10,119178,6595333160,437310
452,y1509,20150211,5540,5534,5512,5530,5486,5518,5506,-16,-28,104430,5750996520,439652
453,y1509,20150212,5518,5506,5498,5520,5478,5498,5500,-8,-6,96462,5305564120,438968
454,y1509,20150213,5498,5500,5512,5598,5502,5588,5558,88,58,149422,8306863000,425370
455,y1509,20150216,5588,5558,5580,5618,5568,5586,5590,28,32,113392,6340489080,432662
456,y1509,20150217,5586,5590,5600,5606,5580,5594,5590,4,0,48904,2733734280,428372
457,y1509,20150225,5594,5590,5548,5570,5470,5540,5534,-50,-56,92802,5135988440,429390
458,y1509,20150226,5540,5534,5538,5580,5534,5568,5562,34,28,147332,8196810440,466930
459,y1509,20150227,5568,5562,5580,5666,5560,5656,5612,94,50,272234,15281963360,502190
460,y1509,20150302,5656,5612,5666,5772,5660,5754,5710,142,98,378112,21596051480,537088
461,y1509,20150303,5754,5710,5750,5802,5668,5692,5724,-18,14,438090,25078388160,560898
462,y1509,20150304,5692,5724,5712,5736,5654,5704,5700,-20,-24,310000,17674176600,560780
463,y1509,20150305,5704,5700,5682,5684,5566,5584,5604,-116,-96,396500,22220952200,555394
464,y1509,20150306,5584,5604,5572,5582,5492,5496,5534,-108,-70,341882,18922662120,558416
465,y1509,20150309,5496,5534,5500,5532,5466,5520,5506,-14,-28,371016,20431287520,589892
466,y1509,20150310,5520,5506,5506,5524,5456,5464,5492,-42,-14,423398,23259372920,632864
467,y1509,20150311,5464,5492,5460,5488,5436,5468,5462,-24,-30,366742,20032146880,648626
468,y1509,20150312,5468,5462,5482,5500,5450,5474,5472,12,10,386024,21123795400,665498
469,y1509,20150313,5474,5472,5466,5490,5444,5448,5460,-24,-12,316368,17276214120,684914
470,y1509,20150316,5448,5460,5438,5444,5270,5378,5386,-82,-74,524046,28231082440,716036
471,y1509,20150317,5378,5386,5380,5412,5356,5406,5386,20,0,379048,20416652480,742312
472,y1509,20150318,5406,5386,5360,5380,5338,5362,5358,-24,-28,477086,25566680880,778628
473,y1509,20150319,5362,5358,5400,5482,5384,5444,5434,86,76,731406,39752601000,793950
474,y1509,20150320,5444,5434,5422,5456,5394,5412,5422,-22,-12,514352,27895765880,821390
475,y1509,20150323,5412,5422,5390,5464,5372,5452,5436,30,14,570804,31032872320,845462
476,y1509,20150324,5452,5436,5468,5518,5452,5470,5484,34,48,708316,38849088520,881874
477,y1509,20150325,5470,5484,5480,5494,5440,5444,5464,-40,-20,456022,24919957920,884280
478,y1509,20150326,5444,5464,5474,5484,5426,5472,5460,8,-4,495072,27037207560,884392
479,y1509,20150327,5472,5460,5470,5480,5416,5436,5446,-24,-14,426910,23257416520,877232
480,y1509,20150330,5436,5446,5436,5446,5360,5372,5392,-74,-54,437892,23614367280,878876
481,y1509,20150331,5372,5392,5386,5408,5342,5352,5372,-40,-20,424180,22794256720,884134
482,y1509,20150401,5352,5372,5332,5404,5326,5360,5364,-12,-8,548278,29416096920,906360
483,y1509,20150402,5360,5364,5370,5428,5336,5394,5386,30,22,606874,32694249240,905922
484,y1509,20150403,5394,5386,5386,5408,5368,5398,5386,12,0,363632,19587832760,903030
485,y1509,20150407,5398,5386,5426,5478,5420,5448,5444,62,58,284570,15493035400,895846
486,y1509,20150408,5448,5444,5420,5446,5392,5414,5418,-30,-26,364436,19748893800,905794
487,y1509,20150409,5414,5418,5394,5406,5360,5366,5378,-52,-40,370920,19955466240,899430
488,y1509,20150410,5366,5378,5360,5394,5346,5368,5370,-10,-8,400348,21505772920,897416
489,y1509,20150413,5368,5370,5368,5462,5368,5452,5428,82,58,647318,35142407840,924354
490,y1509,20150414,5452,5428,5438,5472,5414,5432,5442,4,14,462312,25166710720,905368
491,y1509,20150415,5432,5442,5450,5588,5440,5570,5526,128,84,1307738,72286522360,1002888
492,y1509,20150416,5570,5526,5560,5642,5542,5584,5590,58,64,1135694,63502233320,983842
493,y1509,20150417,5584,5590,5570,5608,5556,5560,5578,-30,-12,626078,34926456920,973268
494,y1509,20150420,5560,5578,5560,5652,5554,5638,5608,60,30,1041920,58431567280,983362
495,y1509,20150421,5638,5608,5622,5696,5608,5686,5658,78,50,1014494,57413904680,1002352
496,y1509,20150422,5686,5658,5682,5716,5606,5652,5662,-6,4,944158,53458980680,977686
497,y1509,20150423,5652,5662,5660,5718,5632,5674,5670,12,8,1031080,58479327360,1006140
498,y1509,20150424,5674,5670,5690,5744,5646,5672,5702,2,32,1205596,68745520440,936134
499,y1509,20150427,5672,5702,5676,5712,5622,5698,5670,-4,-32,849102,48158601600,975890
500,y1509,20150428,5698,5670,5690,5746,5660,5678,5700,8,30,942670,53746252880,986638
501,y1509,20150429,5678,5700,5686,5700,5628,5648,5666,-52,-34,660264,37414123800,980530
502,y1509,20150430,5648,5666,5662,5716,5632,5696,5684,30,18,755276,42938461720,999972
503,y1509,20150504,5696,5684,5684,5812,5674,5806,5768,122,84,908668,52421732920,1094554
504,y1509,20150505,5806,5768,5818,5934,5816,5878,5872,110,104,1425754,83729941000,1118866
505,y1509,20150506,5878,5872,5896,5988,5892,5946,5930,74,58,1398154,82916973400,1112446
506,y1509,20150507,5946,5930,5950,5958,5860,5890,5904,-40,-26,1119022,66086586360,1083092
507,y1509,20150508,5890,5904,5886,5886,5810,5814,5842,-90,-62,934224,54589139640,1035280
508,y1509,20150511,5814,5842,5840,5924,5822,5920,5880,78,38,979014,57570328040,1055362
509,y1509,20150512,5920,5880,5916,5946,5868,5890,5908,10,28,970910,57379266480,1030986
510,y1509,20150513,5890,5908,5920,5942,5882,5888,5916,-20,8,966702,57191489200,1024852
511,y1509,20150514,5888,5916,5886,5898,5836,5884,5862,-32,-54,818794,48006743240,1028274
512,y1509,20150515,5884,5862,5898,5918,5850,5880,5886,18,24,1070172,63007425640,986326
513,y1509,20150518,5880,5886,5852,5870,5826,5864,5840,-22,-46,637412,37232667160,950424
514,y1509,20150519,5864,5840,5860,5866,5762,5772,5806,-68,-34,662408,38468437000,920682
515,y1509,20150520,5772,5806,5752,5754,5626,5674,5680,-132,-126,883958,50226151440,884216
516,y1509,20150521,5674,5680,5690,5724,5668,5704,5702,24,22,539460,30766027480,877568
517,y1509,20150522,5704,5702,5724,5750,5684,5706,5718,4,16,528966,30254374840,870116
518,y1509,20150525,5706,5718,5678,5694,5632,5672,5660,-46,-58,512664,29020959720,874936
519,y1509,20150526,5672,5660,5662,5820,5662,5762,5750,102,90,888554,51100843120,835906
520,y1509,20150527,5762,5750,5750,5806,5744,5756,5772,6,22,714074,41225843560,795406
521,y1509,20150528,5756,5772,5722,5810,5720,5754,5760,-18,-12,703746,40542311440,773168
522,y1509,20150529,5754,5760,5760,5776,5732,5738,5752,-22,-8,466280,26827657080,756410
523,y1509,20150601,5738,5752,5752,5892,5742,5856,5836,104,84,1220394,71237575080,734678
524,y1509,20150602,5856,5836,5878,5950,5878,5912,5914,76,78,1041176,61576202040,699784
525,y1509,20150603,5912,5914,5908,5936,5828,5832,5882,-82,-32,762444,44848446360,642050
526,y1509,20150604,5832,5882,5832,5866,5768,5822,5822,-60,-60,663920,38662220320,616910
527,y1509,20150605,5822,5822,5822,5842,5750,5808,5792,-14,-30,616906,35739636480,593358
528,y1509,20150608,5808,5792,5822,5852,5766,5780,5804,-12,12,607636,35272135200,597008
529,y1509,20150609,5780,5804,5766,5792,5694,5722,5742,-82,-62,544706,31281756920,563260
530,y1509,20150610,5722,5742,5730,5756,5712,5742,5736,0,-6,356548,20453298240,544440
531,y1509,20150611,5742,5736,5760,5782,5736,5764,5756,28,20,363006,20895925360,531674
532,y1509,20150612,5764,5756,5754,5756,5662,5666,5698,-90,-58,412330,23499341320,496792
533,y1509,20150615,5666,5698,5698,5708,5630,5672,5678,-26,-20,269038,15277397040,467490
534,y1509,20150616,5672,5678,5678,5750,5646,5748,5708,70,30,313746,17909207680,443962
535,y1509,20150617,5748,5708,5758,5780,5712,5752,5750,44,42,230502,13257831840,423254
536,y1509,20150618,5752,5750,5748,5784,5686,5694,5730,-56,-20,201698,11558570120,415234
537,y1509,20150619,5694,5730,5690,5700,5650,5686,5676,-44,-54,171878,9755810520,407786
538,y1509,20150623,5686,5676,5730,5744,5674,5694,5708,18,32,102934,5876363000,405172
539,y1509,20150624,5694,5708,5670,5724,5658,5700,5690,-8,-18,143752,8181319360,397066
540,y1509,20150625,5700,5690,5710,5746,5680,5682,5716,-8,26,171758,9821112080,389644
541,y1509,20150626,5682,5716,5680,5726,5612,5650,5680,-66,-36,221246,12567986120,370594
542,y1509,20150629,5650,5680,5690,5710,5600,5612,5648,-68,-32,186700,10546327760,353064
543,y1509,20150630,5612,5648,5628,5638,5538,5576,5588,-72,-60,205500,11486457200,322552
544,y1509,20150701,5576,5588,5576,5770,5564,5694,5676,106,88,161470,9167331920,300212
545,y1509,20150702,5694,5676,5688,5706,5604,5656,5646,-20,-30,127086,7175320080,288696
546,y1509,20150703,5656,5646,5658,5690,5640,5664,5668,18,22,87514,4960940520,279324
547,y1509,20150706,5664,5668,5656,5710,5518,5594,5582,-74,-86,141750,7914425520,260234
548,y1509,20150707,5594,5582,5582,5620,5530,5548,5572,-34,-10,136844,7625153360,257746
549,y1509,20150708,5548,5572,5530,5530,5350,5350,5412,-222,-160,142182,7697234600,228898
550,y1509,20150709,5350,5412,5104,5516,5088,5456,5322,44,-90,232064,12353649800,192240
551,y1509,20150710,5456,5322,5472,5534,5472,5534,5520,212,198,92576,5111825240,186766
552,y1509,20150713,5534,5520,5600,5620,5490,5540,5554,20,34,118166,6564528360,174398
553,y1509,20150714,5540,5554,5530,5656,5514,5626,5598,72,44,89100,4988576680,164984
554,y1509,20150715,5626,5598,5610,5646,5564,5588,5604,-10,6,60750,3405423120,164090
555,y1509,20150716,5588,5604,5582,5606,5514,5560,5552,-44,-52,69046,3833622360,152126
556,y1509,20150717,5560,5552,5570,5598,5506,5542,5542,-10,-10,51160,2835471840,153648
557,y1509,20150720,5542,5542,5520,5568,5492,5568,5536,26,-6,51310,2840846880,151828
558,y1509,20150721,5568,5536,5552,5598,5550,5590,5572,54,36,48560,2706725560,143106
559,y1509,20150722,5590,5572,5592,5614,5558,5590,5588,18,16,34898,1950717480,139260
560,y1509,20150723,5590,5588,5560,5564,5522,5528,5540,-60,-48,35414,1962302560,136306
561,y1509,20150724,5528,5540,5532,5554,5496,5526,5522,-14,-18,33704,1861534960,130374
562,y1509,20150727,5526,5522,5520,5528,5430,5446,5468,-76,-54,47202,2581277000,120732
563,y1509,20150728,5446,5468,5418,5462,5386,5450,5426,-18,-42,36944,2004974680,114376
564,y1509,20150729,5450,5426,5450,5514,5446,5482,5480,56,54,31484,1725350240,109610
565,y1509,20150730,5482,5480,5434,5494,5434,5458,5472,-22,-8,20102,1100061120,106744
566,y1509,20150731,5458,5472,5488,5504,5454,5454,5472,-18,0,22198,1214943680,104930
567,y1509,20150803,5454,5472,5456,5480,5382,5384,5416,-88,-56,31850,1725196000,96614
568,y1509,20150804,5384,5416,5360,5436,5356,5426,5402,10,-14,20650,1115559400,92092
569,y1509,20150805,5426,5402,5454,5472,5422,5458,5444,56,42,18298,996472520,87626
570,y1509,20150806,5458,5444,5450,5462,5398,5408,5424,-36,-20,12058,654141960,86140
571,y1509,20150807,5408,5424,5422,5466,5374,5458,5422,34,-2,15550,843361240,80658
572,y1509,20150810,5458,5422,5448,5548,5420,5494,5478,72,56,14772,809368560,74536
573,y1509,20150811,5494,5478,5482,5590,5478,5570,5542,92,64,14736,816807000,67214
574,y1509,20150812,5570,5542,5560,5594,5506,5594,5552,52,10,14226,789843680,63440
575,y1509,20150813,5594,5552,5600,5644,5434,5542,5524,-10,-28,23902,1320462360,56478
576,y1509,20150814,5542,5524,5532,5540,5490,5490,5512,-34,-12,9336,514711120,55760
577,y1509,20150817,5490,5512,5482,5532,5482,5520,5508,8,-4,21100,1162513480,42310
578,y1509,20150818,5520,5508,5520,5554,5478,5488,5514,-20,6,5772,318293880,40606
579,y1509,20150819,5488,5514,5488,5562,5456,5554,5512,40,-2,13950,769074200,40236
580,y1509,20150820,5554,5512,5554,5582,5494,5534,5544,22,32,9344,518195160,37066
581,y1509,20150821,5534,5544,5550,5600,5530,5574,5558,30,14,4522,251364560,34390
582,y1509,20150824,5574,5558,5562,5572,5336,5384,5444,-174,-114,7622,415044320,32656
583,y1509,20150825,5384,5444,5326,5444,5264,5380,5390,-64,-54,11444,616934000,29640
584,y1509,20150826,5380,5390,5446,5604,5422,5456,5500,66,110,8178,449863160,28800
585,y1509,20150827,5456,5500,5430,5558,5426,5548,5520,48,20,14438,796987880,25412
586,y1509,20150828,5548,5520,5522,5600,5512,5522,5536,2,16,4152,229871600,23012
587,y1509,20150831,5522,5536,5500,5536,5438,5452,5500,-84,-36,3532,194287920,21356
588,y1509,20150901,5452,5500,5520,5560,5200,5466,5456,-34,-44,274,14953320,18724
589,y1509,20150902,5466,5456,5452,5570,5452,5510,5516,54,60,1112,61343480,18376
590,y1509,20150907,5510,5516,5600,5650,5520,5640,5602,124,86,222,12438400,18244
591,y1509,20150908,5640,5602,5602,5660,5600,5660,5604,58,2,2278,127687600,18096
592,y1509,20150909,5660,5604,5670,5806,5640,5800,5710,196,106,2334,133295120,17620
593,y1509,20150910,5800,5710,5606,5606,5604,5604,5604,-106,-106,302,16924840,16620
594,y1509,20150911,5604,5604,5620,5620,5620,5620,5620,16,16,20,1124000,16620
595,y1509,20150914,5620,5620,0,0,0,5620,5620,0,0,0,0,16620
596,y1509,20150915,5620,5620,5600,5600,5600,5600,5600,-20,-20,2,112000,16620
597,y1509,20150916,5600,5600,5598,5598,5264,5264,5486,-336,-114,6342,339191320,0
598,y1511,20150105,5776,5776,0,0,0,5776,5776,0,0,0,0,2
599,y1511,20150106,5776,5776,0,0,0,5776,5776,0,0,0,0,2
600,y1511,20150107,5776,5776,0,0,0,5800,5800,24,24,0,0,2
601,y1511,20150108,5800,5800,0,0,0,5800,5800,0,0,0,0,2
602,y1511,20150109,5800,5800,0,0,0,5800,5800,0,0,0,0,2
603,y1511,20150112,5800,5800,0,0,0,5800,5800,0,0,0,0,2
604,y1511,20150113,5800,5800,0,0,0,5800,5800,0,0,0,0,2
605,y1511,20150114,5800,5800,5786,5786,5784,5784,5784,-16,-16,10,578520,12
606,y1511,20150115,5784,5784,0,0,0,5772,5772,-12,-12,0,0,12
607,y1511,20150116,5772,5772,5722,5792,5722,5780,5770,8,-2,8,461720,12
608,y1511,20150119,5780,5770,5800,5800,5776,5800,5792,30,22,8,463400,6
609,y1511,20150120,5800,5792,0,0,0,5768,5768,-24,-24,0,0,6
610,y1511,20150121,5768,5768,0,0,0,5768,5768,0,0,0,0,6
611,y1511,20150122,5768,5768,0,0,0,5768,5768,0,0,0,0,6
612,y1511,20150123,5768,5768,0,0,0,5694,5694,-74,-74,0,0,6
613,y1511,20150126,5694,5694,0,0,0,5634,5634,-60,-60,0,0,6
614,y1511,20150127,5634,5634,0,0,0,5612,5612,-22,-22,0,0,6
615,y1511,20150128,5612,5612,0,0,0,5606,5606,-6,-6,0,0,6
616,y1511,20150129,5606,5606,0,0,0,5540,5540,-66,-66,0,0,6
617,y1511,20150130,5540,5540,0,0,0,5494,5494,-46,-46,0,0,6
618,y1511,20150202,5494,5494,0,0,0,5494,5494,0,0,0,0,6
619,y1511,20150203,5494,5494,5544,5544,5486,5486,5514,-8,20,4,220600,4
620,y1511,20150204,5486,5514,0,0,0,5514,5514,0,0,0,0,4
621,y1511,20150205,5514,5514,0,0,0,5514,5514,0,0,0,0,4
622,y1511,20150206,5514,5514,0,0,0,5514,5514,0,0,0,0,4
623,y1511,20150209,5514,5514,0,0,0,5514,5514,0,0,0,0,4
624,y1511,20150210,5514,5514,0,0,0,5514,5514,0,0,0,0,4
625,y1511,20150211,5514,5514,0,0,0,5514,5514,0,0,0,0,4
626,y1511,20150212,5514,5514,0,0,0,5514,5514,0,0,0,0,4
627,y1511,20150213,5514,5514,5504,5662,5504,5572,5558,58,44,26,1445320,6
628,y1511,20150216,5572,5558,0,0,0,5580,5580,22,22,0,0,6
629,y1511,20150217,5580,5580,0,0,0,5580,5580,0,0,0,0,6
630,y1511,20150225,5580,5580,0,0,0,5580,5580,0,0,0,0,6
631,y1511,20150226,5580,5580,0,0,0,5582,5582,2,2,0,0,6
632,y1511,20150227,5582,5582,0,0,0,5644,5644,62,62,0,0,6
633,y1511,20150302,5644,5644,5760,5838,5692,5838,5762,194,118,56,3227320,44
634,y1511,20150303,5838,5762,5844,5844,5758,5758,5774,-4,12,50,2887120,16
635,y1511,20150304,5758,5774,0,0,0,5750,5750,-24,-24,0,0,16
636,y1511,20150305,5750,5750,5642,5706,5642,5706,5684,-44,-66,6,341080,16
637,y1511,20150306,5706,5684,5612,5612,5612,5612,5612,-72,-72,2,112240,16
638,y1511,20150309,5612,5612,5598,5640,5598,5618,5618,6,6,12,674280,24
639,y1511,20150310,5618,5618,5634,5634,5634,5634,5634,16,16,4,225360,28
640,y1511,20150311,5634,5634,5600,5602,5600,5602,5600,-32,-34,6,336080,32
641,y1511,20150312,5602,5600,0,0,0,5610,5610,10,10,0,0,32
642,y1511,20150313,5610,5610,5554,5608,5554,5608,5604,-2,-6,30,1681320,60
643,y1511,20150316,5608,5604,5540,5540,5468,5468,5498,-136,-106,6,329920,56
644,y1511,20150317,5468,5498,5532,5532,5448,5448,5492,-50,-6,92,5053520,28
645,y1511,20150318,5448,5492,0,0,0,5492,5492,0,0,0,0,28
646,y1511,20150319,5492,5492,0,0,0,5534,5534,42,42,0,0,28
647,y1511,20150320,5534,5534,5524,5524,5524,5524,5524,-10,-10,2,110480,28
648,y1511,20150323,5524,5524,0,0,0,5536,5536,12,12,0,0,28
649,y1511,20150324,5536,5536,5536,5606,5530,5540,5554,4,18,16,888640,28
650,y1511,20150325,5540,5554,0,0,0,5562,5562,8,8,0,0,28
651,y1511,20150326,5562,5562,0,0,0,5562,5562,0,0,0,0,28
652,y1511,20150327,5562,5562,5534,5540,5488,5488,5516,-74,-46,16,882720,28
653,y1511,20150330,5488,5516,5500,5500,5482,5482,5492,-34,-24,18,988800,24
654,y1511,20150331,5482,5492,5466,5480,5466,5480,5472,-12,-20,4,218920,24
655,y1511,20150401,5480,5472,0,0,0,5464,5464,-8,-8,0,0,24
656,y1511,20150402,5464,5464,5516,5516,5516,5516,5516,52,52,16,882560,40
657,y1511,20150403,5516,5516,0,0,0,5516,5516,0,0,0,0,40
658,y1511,20150407,5516,5516,0,0,0,5574,5574,58,58,0,0,40
659,y1511,20150408,5574,5574,0,0,0,5574,5574,0,0,0,0,40
660,y1511,20150409,5574,5574,0,0,0,5534,5534,-40,-40,0,0,40
661,y1511,20150410,5534,5534,0,0,0,5526,5526,-8,-8,0,0,40
662,y1511,20150413,5526,5526,5516,5516,5516,5516,5516,-10,-10,4,220640,36
663,y1511,20150414,5516,5516,5550,5572,5536,5572,5552,56,36,20,1110480,24
664,y1511,20150415,5572,5552,5624,5668,5624,5668,5646,116,94,14,790560,24
665,y1511,20150416,5668,5646,0,0,0,5664,5664,18,18,0,0,24
666,y1511,20150417,5664,5664,5672,5694,5622,5670,5664,6,0,34,1926200,26
667,y1511,20150420,5670,5664,0,0,0,5712,5712,48,48,0,0,26
668,y1511,20150421,5712,5712,5688,5776,5688,5762,5746,50,34,12,689520,24
669,y1511,20150422,5762,5746,5768,5768,5768,5768,5768,22,22,2,115360,24
670,y1511,20150423,5768,5768,5792,5792,5792,5792,5792,24,24,6,347520,24
671,y1511,20150424,5792,5792,5770,5842,5770,5842,5816,50,24,8,465360,26
672,y1511,20150427,5842,5816,5778,5778,5778,5778,5778,-38,-38,6,346680,28
673,y1511,20150428,5778,5778,5798,5798,5798,5798,5798,20,20,2,115960,28
674,y1511,20150429,5798,5798,0,0,0,5788,5788,-10,-10,0,0,28
675,y1511,20150430,5788,5788,5774,5820,5774,5820,5796,32,8,4,231880,28
676,y1511,20150504,5820,5796,0,0,0,5880,5880,84,84,0,0,28
677,y1511,20150505,5880,5880,0,0,0,5888,5888,8,8,0,0,28
678,y1511,20150506,5888,5888,6030,6034,6018,6034,6026,146,138,12,723120,32
679,y1511,20150507,6034,6026,0,0,0,6000,6000,-26,-26,0,0,32
680,y1511,20150508,6000,6000,5976,5976,5976,5976,5976,-24,-24,2,119520,30
681,y1511,20150511,5976,5976,0,0,0,6014,6014,38,38,0,0,30
682,y1511,20150512,6014,6014,6050,6050,6050,6050,6050,36,36,2,121000,30
683,y1511,20150513,6050,6050,0,0,0,6058,6058,8,8,0,0,30
684,y1511,20150514,6058,6058,6058,6058,5936,5936,6000,-122,-58,8,480040,28
685,y1511,20150515,5936,6000,0,0,0,6000,6000,0,0,0,0,28
686,y1511,20150518,6000,6000,0,0,0,5954,5954,-46,-46,0,0,28
687,y1511,20150519,5954,5954,5852,5898,5852,5898,5874,-56,-80,10,587400,28
688,y1511,20150520,5898,5874,5800,5800,5800,5800,5800,-74,-74,4,232000,28
689,y1511,20150521,5800,5800,5802,5802,5802,5802,5802,2,2,4,232080,28
690,y1511,20150522,5802,5802,5862,5862,5862,5862,5862,60,60,4,234480,28
691,y1511,20150525,5862,5862,0,0,0,5804,5804,-58,-58,0,0,28
692,y1511,20150526,5804,5804,0,0,0,5896,5896,92,92,0,0,28
693,y1511,20150527,5896,5896,0,0,0,5918,5918,22,22,0,0,28
694,y1511,20150528,5918,5918,0,0,0,5906,5906,-12,-12,0,0,28
695,y1511,20150529,5906,5906,0,0,0,5898,5898,-8,-8,0,0,28
696,y1511,20150601,5898,5898,6022,6024,6022,6024,6022,126,124,40,2409160,30
697,y1511,20150602,6024,6022,6034,6034,6034,6034,6034,12,12,2,120680,28
698,y1511,20150603,6034,6034,0,0,0,6002,6002,-32,-32,0,0,28
699,y1511,20150604,6002,6002,6032,6032,5910,5910,5980,-92,-22,12,717640,28
700,y1511,20150605,5910,5980,5902,5902,5790,5890,5838,-90,-142,28,1634960,34
701,y1511,20150608,5890,5838,5894,5896,5894,5896,5894,58,56,4,235800,32
702,y1511,20150609,5896,5894,5892,5892,5850,5870,5870,-24,-24,18,1056800,28
703,y1511,20150610,5870,5870,0,0,0,5870,5870,0,0,0,0,28
704,y1511,20150611,5870,5870,0,0,0,5890,5890,20,20,0,0,28
705,y1511,20150612,5890,5890,0,0,0,5832,5832,-58,-58,0,0,28
706,y1511,20150615,5832,5832,0,0,0,5812,5812,-20,-20,0,0,28
707,y1511,20150616,5812,5812,0,0,0,5842,5842,30,30,0,0,28
708,y1511,20150617,5842,5842,5918,5924,5860,5870,5890,28,48,48,2828080,48
709,y1511,20150618,5870,5890,0,0,0,5842,5842,-48,-48,0,0,48
710,y1511,20150619,5842,5842,0,0,0,5828,5828,-14,-14,0,0,48
711,y1511,20150623,5828,5828,5766,5846,5766,5820,5810,-8,-18,6,348640,50
712,y1511,20150624,5820,5810,0,0,0,5810,5810,0,0,0,0,50
713,y1511,20150625,5810,5810,0,0,0,5810,5810,0,0,0,0,50
714,y1511,20150626,5810,5810,5838,5838,5726,5726,5786,-84,-24,26,1504720,42
715,y1511,20150629,5726,5786,0,0,0,5754,5754,-32,-32,0,0,42
716,y1511,20150630,5754,5754,0,0,0,5694,5694,-60,-60,0,0,42
717,y1511,20150701,5694,5694,0,0,0,5782,5782,88,88,0,0,42
718,y1511,20150702,5782,5782,0,0,0,5752,5752,-30,-30,0,0,42
719,y1511,20150703,5752,5752,0,0,0,5774,5774,22,22,0,0,42
720,y1511,20150706,5774,5774,0,0,0,5688,5688,-86,-86,0,0,42
721,y1511,20150707,5688,5688,5648,5648,5648,5648,5648,-40,-40,2,112960,40
722,y1511,20150708,5648,5648,5554,5554,5424,5424,5468,-224,-180,14,765680,48
723,y1511,20150709,5424,5468,5186,5648,5186,5648,5482,180,14,20,1096680,52
724,y1511,20150710,5648,5482,0,0,0,5684,5684,202,202,0,0,52
725,y1511,20150713,5684,5684,5654,5654,5576,5634,5632,-50,-52,32,1802320,48
726,y1511,20150714,5634,5632,0,0,0,5676,5676,44,44,0,0,48
727,y1511,20150715,5676,5676,0,0,0,5682,5682,6,6,0,0,48
728,y1511,20150716,5682,5682,5584,5584,5584,5584,5584,-98,-98,6,335040,44
729,y1511,20150717,5584,5584,0,0,0,5574,5574,-10,-10,0,0,44
730,y1511,20150720,5574,5574,0,0,0,5568,5568,-6,-6,0,0,44
731,y1511,20150721,5568,5568,5648,5662,5618,5662,5644,94,76,10,564520,42
732,y1511,20150722,5662,5644,5682,5706,5624,5624,5662,-20,18,10,566360,38
733,y1511,20150723,5624,5662,0,0,0,5614,5614,-48,-48,0,0,38
734,y1511,20150724,5614,5614,0,0,0,5596,5596,-18,-18,0,0,38
735,y1511,20150727,5596,5596,5554,5592,5552,5566,5570,-30,-26,10,557000,38
736,y1511,20150728,5566,5570,5460,5550,5460,5550,5504,-20,-66,8,440400,40
737,y1511,20150729,5550,5504,0,0,0,5558,5558,54,54,0,0,40
738,y1511,20150730,5558,5558,5610,5610,5522,5600,5588,42,30,10,558800,44
739,y1511,20150731,5600,5588,0,0,0,5588,5588,0,0,0,0,44
740,y1511,20150803,5588,5588,0,0,0,5532,5532,-56,-56,0,0,44
741,y1511,20150804,5532,5532,5482,5482,5482,5482,5482,-50,-50,4,219280,40
742,y1511,20150805,5482,5482,0,0,0,5524,5524,42,42,0,0,40
743,y1511,20150806,5524,5524,0,0,0,5504,5504,-20,-20,0,0,40
744,y1511,20150807,5504,5504,0,0,0,5502,5502,-2,-2,0,0,40
745,y1511,20150810,5502,5502,0,0,0,5558,5558,56,56,0,0,40
746,y1511,20150811,5558,5558,5746,5746,5746,5746,5746,188,188,2,114920,40
747,y1511,20150812,5746,5746,0,0,0,5756,5756,10,10,0,0,40
748,y1511,20150813,5756,5756,5742,5742,5578,5586,5632,-170,-124,12,675960,42
749,y1511,20150814,5586,5632,5644,5644,5644,5644,5644,12,12,2,112880,40
750,y1511,20150817,5644,5644,5626,5626,5626,5626,5626,-18,-18,2,112520,40
751,y1511,20150818,5626,5626,0,0,0,5626,5626,0,0,0,0,40
752,y1511,20150819,5626,5626,5614,5614,5614,5614,5614,-12,-12,2,112280,38
753,y1511,20150820,5614,5614,5610,5610,5610,5610,5610,-4,-4,4,224400,38
754,y1511,20150821,5610,5610,0,0,0,5624,5624,14,14,0,0,38
755,y1511,20150824,5624,5624,5674,5686,5532,5580,5626,-44,2,26,1463240,34
756,y1511,20150825,5580,5626,5426,5426,5426,5426,5426,-200,-200,2,108520,34
757,y1511,20150826,5426,5426,5490,5490,5336,5336,5412,-90,-14,4,216520,34
758,y1511,20150827,5336,5412,5500,5500,5408,5408,5442,-4,30,8,435400,36
759,y1511,20150828,5408,5442,0,0,0,5442,5442,0,0,0,0,36
760,y1511,20150831,5442,5442,0,0,0,5408,5408,-34,-34,0,0,36
761,y1511,20150901,5408,5408,0,0,0,5408,5408,0,0,0,0,36
762,y1511,20150902,5408,5408,0,0,0,5408,5408,0,0,0,0,36
763,y1511,20150907,5408,5408,0,0,0,5492,5492,84,84,0,0,36
764,y1511,20150908,5492,5492,0,0,0,5492,5492,0,0,0,0,36
765,y1511,20150909,5492,5492,5492,5706,5492,5700,5676,208,184,44,2497840,76
766,y1511,20150910,5700,5676,5658,5658,5658,5658,5658,-18,-18,2,113160,74
767,y1511,20150911,5658,5658,0,0,0,5658,5658,0,0,0,0,74
768,y1511,20150914,5658,5658,0,0,0,5658,5658,0,0,0,0,74
769,y1511,20150915,5658,5658,5688,5756,5678,5678,5726,20,68,18,1030800,70
770,y1511,20150916,5678,5726,5630,5630,5630,5630,5630,-96,-96,2,112600,70
771,y1511,20150917,5630,5630,5644,5644,5644,5644,5644,14,14,2,112880,72
772,y1511,20150918,5644,5644,5630,5630,5630,5630,5630,-14,-14,6,337800,78
773,y1511,20150921,5630,5630,5566,5566,5500,5500,5526,-130,-104,14,773720,90
774,y1511,20150922,5500,5526,0,0,0,5526,5526,0,0,0,0,90
775,y1511,20150923,5526,5526,0,0,0,5526,5526,0,0,0,0,90
776,y1511,20150924,5526,5526,5580,5580,5580,5580,5580,54,54,2,111600,90
777,y1511,20150925,5580,5580,5628,5628,5626,5626,5626,46,46,18,1013000,84
778,y1511,20150928,5626,5626,5650,5738,5644,5712,5680,86,54,44,2499880,44
779,y1511,20150929,5712,5680,0,0,0,5680,5680,0,0,0,0,44
780,y1511,20150930,5680,5680,0,0,0,5680,5680,0,0,0,0,44
781,y1511,20151008,5680,5680,5884,5884,5720,5720,5802,40,122,20,1160400,44
782,y1511,20151009,5720,5802,0,0,0,5802,5802,0,0,0,0,44
783,y1511,20151012,5802,5802,0,0,0,5858,5858,56,56,0,0,44
784,y1511,20151013,5858,5858,5702,5766,5702,5766,5754,-92,-104,16,920920,36
785,y1511,20151014,5766,5754,5802,5802,5800,5800,5800,46,46,4,232040,32
786,y1511,20151015,5800,5800,5800,5944,5694,5694,5768,-106,-32,12,692160,24
787,y1511,20151016,5694,5768,5768,5768,5768,5768,5768,0,0,4,230720,22
788,y1511,20151019,5768,5768,0,0,0,5768,5768,0,0,0,0,22
789,y1511,20151020,5768,5768,5610,5616,5610,5616,5612,-152,-156,8,449040,20
790,y1511,20151021,5616,5612,5836,5836,5836,5836,5836,224,224,2,116720,20
791,y1511,20151022,5836,5836,5756,6030,5756,6030,5892,194,56,4,235720,20
792,y1511,20151023,6030,5892,0,0,0,5892,5892,0,0,0,0,20
793,y1511,20151026,5892,5892,5986,5986,5730,5752,5832,-140,-60,52,3033480,10
794,y1511,20151027,5752,5832,0,0,0,5832,5832,0,0,0,0,10
795,y1511,20151028,5832,5832,0,0,0,5832,5832,0,0,0,0,10
796,y1511,20151029,5832,5832,0,0,0,5832,5832,0,0,0,0,10
797,y1511,20151030,5832,5832,6010,6064,6010,6064,6030,232,198,6,361800,10
798,y1511,20151102,6064,6030,6098,6390,6098,6390,6244,360,214,4,249760,10
799,y1511,20151103,6390,6244,0,0,0,6244,6244,0,0,0,0,10
800,y1511,20151104,6244,6244,0,0,0,6244,6244,0,0,0,0,10
801,y1511,20151105,6244,6244,0,0,0,6244,6244,0,0,0,0,10
802,y1511,20151106,6244,6244,0,0,0,6244,6244,0,0,0,0,10
803,y1511,20151109,6244,6244,6500,6500,6200,6200,6380,-44,136,10,638000,10
804,y1511,20151110,6200,6380,0,0,0,6380,6380,0,0,0,0,10
805,y1511,20151111,6380,6380,0,0,0,5998,5998,-382,-382,0,0,10
806,y1511,20151112,5998,5998,0,0,0,5998,5998,0,0,0,0,10
807,y1511,20151113,5998,5998,0,0,0,6340,6340,342,342,0,0,0
808,y1512,20150105,5776,5776,0,0,0,5776,5776,0,0,0,0,0
809,y1512,20150106,5776,5776,0,0,0,5776,5776,0,0,0,0,0
810,y1512,20150107,5776,5776,0,0,0,5776,5776,0,0,0,0,0
811,y1512,20150108,5776,5776,0,0,0,5822,5822,46,46,0,0,0
812,y1512,20150109,5822,5822,0,0,0,5822,5822,0,0,0,0,0
813,y1512,20150112,5822,5822,5938,5938,5830,5830,5866,8,44,6,352000,0
814,y1512,20150113,5830,5866,5816,5816,5816,5816,5816,-50,-50,2,116320,2
815,y1512,20150114,5816,5816,0,0,0,5800,5800,-16,-16,0,0,2
816,y1512,20150115,5800,5800,5674,5836,5674,5836,5754,36,-46,4,230200,4
817,y1512,20150116,5836,5754,5792,5792,5780,5780,5784,26,30,6,347120,8
818,y1512,20150119,5780,5784,5830,5830,5714,5774,5770,-10,-14,20,1154160,4
819,y1512,20150120,5774,5770,5714,5714,5694,5694,5704,-76,-66,4,228160,2
820,y1512,20150121,5694,5704,0,0,0,5704,5704,0,0,0,0,2
821,y1512,20150122,5704,5704,0,0,0,5704,5704,0,0,0,0,2
822,y1512,20150123,5704,5704,0,0,0,5704,5704,0,0,0,0,2
823,y1512,20150126,5704,5704,0,0,0,5668,5668,-36,-36,0,0,2
824,y1512,20150127,5668,5668,0,0,0,5668,5668,0,0,0,0,2
825,y1512,20150128,5668,5668,0,0,0,5668,5668,0,0,0,0,2
826,y1512,20150129,5668,5668,0,0,0,5562,5562,-106,-106,0,0,2
827,y1512,20150130,5562,5562,0,0,0,5484,5484,-78,-78,0,0,2
828,y1512,20150202,5484,5484,0,0,0,5484,5484,0,0,0,0,2
829,y1512,20150203,5484,5484,0,0,0,5502,5502,18,18,0,0,2
830,y1512,20150204,5502,5502,0,0,0,5502,5502,0,0,0,0,2
831,y1512,20150205,5502,5502,0,0,0,5502,5502,0,0,0,0,2
832,y1512,20150206,5502,5502,0,0,0,5566,5566,64,64,0,0,2
833,y1512,20150209,5566,5566,0,0,0,5566,5566,0,0,0,0,2
834,y1512,20150210,5566,5566,0,0,0,5568,5568,2,2,0,0,2
835,y1512,20150211,5568,5568,0,0,0,5568,5568,0,0,0,0,2
836,y1512,20150212,5568,5568,0,0,0,5568,5568,0,0,0,0,2
837,y1512,20150213,5568,5568,0,0,0,5578,5578,10,10,0,0,2
838,y1512,20150216,5578,5578,0,0,0,5578,5578,0,0,0,0,2
839,y1512,20150217,5578,5578,0,0,0,5584,5584,6,6,0,0,2
840,y1512,20150225,5584,5584,0,0,0,5584,5584,0,0,0,0,2
841,y1512,20150226,5584,5584,0,0,0,5584,5584,0,0,0,0,2
842,y1512,20150227,5584,5584,0,0,0,5584,5584,0,0,0,0,2
843,y1512,20150302,5584,5584,0,0,0,5700,5700,116,116,0,0,2
844,y1512,20150303,5700,5700,0,0,0,5700,5700,0,0,0,0,2
845,y1512,20150304,5700,5700,0,0,0,5726,5726,26,26,0,0,2
846,y1512,20150305,5726,5726,0,0,0,5702,5702,-24,-24,0,0,2
847,y1512,20150306,5702,5702,0,0,0,5608,5608,-94,-94,0,0,2
848,y1512,20150309,5608,5608,0,0,0,5608,5608,0,0,0,0,2
849,y1512,20150310,5608,5608,0,0,0,5546,5546,-62,-62,0,0,2
850,y1512,20150311,5546,5546,0,0,0,5546,5546,0,0,0,0,2
851,y1512,20150312,5546,5546,0,0,0,5546,5546,0,0,0,0,2
852,y1512,20150313,5546,5546,0,0,0,5528,5528,-18,-18,0,0,2
853,y1512,20150316,5528,5528,0,0,0,5470,5470,-58,-58,0,0,2
854,y1512,20150317,5470,5470,0,0,0,5470,5470,0,0,0,0,2
855,y1512,20150318,5470,5470,5450,5450,5450,5450,5450,-20,-20,2,109000,4
856,y1512,20150319,5450,5450,5432,5488,5432,5488,5460,38,10,4,218400,4
857,y1512,20150320,5488,5460,0,0,0,5460,5460,0,0,0,0,4
858,y1512,20150323,5460,5460,5518,5518,5518,5518,5518,58,58,2,110360,6
859,y1512,20150324,5518,5518,5536,5536,5536,5536,5536,18,18,2,110720,6
860,y1512,20150325,5536,5536,5476,5476,5476,5476,5476,-60,-60,2,109520,6
861,y1512,20150326,5476,5476,5478,5478,5478,5478,5478,2,2,2,109560,4
862,y1512,20150327,5478,5478,5496,5496,5496,5496,5496,18,18,2,109920,4
863,y1512,20150330,5496,5496,0,0,0,5472,5472,-24,-24,0,0,4
864,y1512,20150331,5472,5472,5420,5494,5372,5430,5428,-42,-44,8,434320,4
865,y1512,20150401,5430,5428,0,0,0,5420,5420,-8,-8,0,0,4
866,y1512,20150402,5420,5420,0,0,0,5420,5420,0,0,0,0,4
867,y1512,20150403,5420,5420,0,0,0,5420,5420,0,0,0,0,4
868,y1512,20150407,5420,5420,0,0,0,5462,5462,42,42,0,0,4
869,y1512,20150408,5462,5462,0,0,0,5462,5462,0,0,0,0,4
870,y1512,20150409,5462,5462,0,0,0,5462,5462,0,0,0,0,4
871,y1512,20150410,5462,5462,0,0,0,5462,5462,0,0,0,0,4
872,y1512,20150413,5462,5462,0,0,0,5462,5462,0,0,0,0,4
873,y1512,20150414,5462,5462,5508,5508,5508,5508,5508,46,46,2,110160,6
874,y1512,20150415,5508,5508,5552,5602,5526,5602,5556,94,48,12,666800,8
875,y1512,20150416,5602,5556,5650,5650,5650,5650,5650,94,94,2,113000,10
876,y1512,20150417,5650,5650,0,0,0,5644,5644,-6,-6,0,0,10
877,y1512,20150420,5644,5644,5660,5660,5660,5660,5660,16,16,2,113200,10
878,y1512,20150421,5660,5660,5686,5686,5686,5686,5686,26,26,2,113720,10
879,y1512,20150422,5686,5686,5716,5722,5716,5722,5716,36,30,12,686040,14
880,y1512,20150423,5722,5716,0,0,0,5738,5738,22,22,0,0,14
881,y1512,20150424,5738,5738,0,0,0,5760,5760,22,22,0,0,14
882,y1512,20150427,5760,5760,5740,5742,5740,5742,5740,-18,-20,6,344480,20
883,y1512,20150428,5742,5740,0,0,0,5740,5740,0,0,0,0,20
884,y1512,20150429,5740,5740,0,0,0,5706,5706,-34,-34,0,0,20
885,y1512,20150430,5706,5706,0,0,0,5712,5712,6,6,0,0,20
886,y1512,20150504,5712,5712,5782,5782,5756,5756,5764,44,52,6,345880,18
887,y1512,20150505,5756,5764,5914,5914,5878,5878,5896,114,132,4,235840,18
888,y1512,20150506,5878,5896,0,0,0,6034,6034,138,138,0,0,18
889,y1512,20150507,6034,6034,6022,6022,6022,6022,6022,-12,-12,2,120440,20
890,y1512,20150508,6022,6022,0,0,0,5998,5998,-24,-24,0,0,20
891,y1512,20150511,5998,5998,0,0,0,6036,6036,38,38,0,0,20
892,y1512,20150512,6036,6036,0,0,0,6072,6072,36,36,0,0,20
893,y1512,20150513,6072,6072,6012,6012,6012,6012,6012,-60,-60,6,360720,14
894,y1512,20150514,6012,6012,0,0,0,5956,5956,-56,-56,0,0,14
895,y1512,20150515,5956,5956,5918,5950,5918,5950,5934,-6,-22,4,237360,14
896,y1512,20150518,5950,5934,0,0,0,5888,5888,-46,-46,0,0,14
897,y1512,20150519,5888,5888,5910,5910,5910,5910,5910,22,22,2,118200,14
898,y1512,20150520,5910,5910,0,0,0,5836,5836,-74,-74,0,0,14
899,y1512,20150521,5836,5836,0,0,0,5838,5838,2,2,0,0,14
900,y1512,20150522,5838,5838,0,0,0,5898,5898,60,60,0,0,14
901,y1512,20150525,5898,5898,0,0,0,5840,5840,-58,-58,0,0,14
902,y1512,20150526,5840,5840,0,0,0,5932,5932,92,92,0,0,14
903,y1512,20150527,5932,5932,0,0,0,5954,5954,22,22,0,0,14
904,y1512,20150528,5954,5954,0,0,0,5942,5942,-12,-12,0,0,14
905,y1512,20150529,5942,5942,0,0,0,5934,5934,-8,-8,0,0,14
906,y1512,20150601,5934,5934,6008,6034,6008,6034,6020,100,86,4,240840,14
907,y1512,20150602,6034,6020,6114,6114,6098,6098,6106,78,86,4,244240,10
908,y1512,20150603,6098,6106,0,0,0,6074,6074,-32,-32,0,0,10
909,y1512,20150604,6074,6074,0,0,0,6052,6052,-22,-22,0,0,10
910,y1512,20150605,6052,6052,0,0,0,5910,5910,-142,-142,0,0,10
911,y1512,20150608,5910,5910,5988,5988,5988,5988,5988,78,78,8,479040,18
912,y1512,20150609,5988,5988,0,0,0,5964,5964,-24,-24,0,0,18
913,y1512,20150610,5964,5964,0,0,0,5964,5964,0,0,0,0,18
914,y1512,20150611,5964,5964,0,0,0,5984,5984,20,20,0,0,18
915,y1512,20150612,5984,5984,0,0,0,5924,5924,-60,-60,0,0,18
916,y1512,20150615,5924,5924,0,0,0,5904,5904,-20,-20,0,0,18
917,y1512,20150616,5904,5904,0,0,0,5934,5934,30,30,0,0,18
918,y1512,20150617,5934,5934,0,0,0,5982,5982,48,48,0,0,18
919,y1512,20150618,5982,5982,0,0,0,5982,5982,0,0,0,0,18
920,y1512,20150619,5982,5982,0,0,0,5926,5926,-56,-56,0,0,18
921,y1512,20150623,5926,5926,0,0,0,5926,5926,0,0,0,0,18
922,y1512,20150624,5926,5926,0,0,0,5926,5926,0,0,0,0,18
923,y1512,20150625,5926,5926,5884,5932,5884,5932,5908,6,-18,4,236320,18
924,y1512,20150626,5932,5908,5950,5950,5822,5822,5886,-86,-22,12,706320,22
925,y1512,20150629,5822,5886,5870,5870,5870,5870,5870,-16,-16,4,234800,22
926,y1512,20150630,5870,5870,0,0,0,5808,5808,-62,-62,0,0,22
927,y1512,20150701,5808,5808,5762,5870,5762,5870,5834,62,26,16,933600,20
928,y1512,20150702,5870,5834,5760,5760,5760,5760,5760,-74,-74,2,115200,18
929,y1512,20150703,5760,5760,0,0,0,5782,5782,22,22,0,0,18
930,y1512,20150706,5782,5782,0,0,0,5696,5696,-86,-86,0,0,18
931,y1512,20150707,5696,5696,0,0,0,5656,5656,-40,-40,0,0,18
932,y1512,20150708,5656,5656,0,0,0,5476,5476,-180,-180,0,0,18
933,y1512,20150709,5476,5476,0,0,0,5490,5490,14,14,0,0,18
934,y1512,20150710,5490,5490,0,0,0,5694,5694,204,204,0,0,18
935,y1512,20150713,5694,5694,5788,5796,5608,5608,5730,-86,36,50,2865920,18
936,y1512,20150714,5608,5730,5774,5774,5694,5724,5728,-6,-2,8,458320,18
937,y1512,20150715,5724,5728,5782,5782,5686,5704,5738,-24,10,8,459080,18
938,y1512,20150716,5704,5738,0,0,0,5640,5640,-98,-98,0,0,18
939,y1512,20150717,5640,5640,0,0,0,5630,5630,-10,-10,0,0,18
940,y1512,20150720,5630,5630,0,0,0,5624,5624,-6,-6,0,0,18
941,y1512,20150721,5624,5624,0,0,0,5700,5700,76,76,0,0,18
942,y1512,20150722,5700,5700,0,0,0,5718,5718,18,18,0,0,18
943,y1512,20150723,5718,5718,0,0,0,5670,5670,-48,-48,0,0,18
944,y1512,20150724,5670,5670,0,0,0,5652,5652,-18,-18,0,0,18
945,y1512,20150727,5652,5652,5506,5608,5506,5608,5556,-44,-96,4,222280,18
946,y1512,20150728,5608,5556,0,0,0,5492,5492,-64,-64,0,0,18
947,y1512,20150729,5492,5492,0,0,0,5546,5546,54,54,0,0,18
948,y1512,20150730,5546,5546,5598,5598,5502,5502,5550,-44,4,6,333040,18
949,y1512,20150731,5502,5550,0,0,0,5550,5550,0,0,0,0,18
950,y1512,20150803,5550,5550,0,0,0,5494,5494,-56,-56,0,0,18
951,y1512,20150804,5494,5494,0,0,0,5446,5446,-48,-48,0,0,18
952,y1512,20150805,5446,5446,0,0,0,5488,5488,42,42,0,0,18
953,y1512,20150806,5488,5488,0,0,0,5468,5468,-20,-20,0,0,18
954,y1512,20150807,5468,5468,0,0,0,5466,5466,-2,-2,0,0,18
955,y1512,20150810,5466,5466,5564,5588,5502,5588,5558,122,92,18,1000720,28
956,y1512,20150811,5588,5558,5586,5632,5586,5632,5608,74,50,28,1570640,10
957,y1512,20150812,5632,5608,5600,5632,5594,5594,5608,-14,0,8,448760,8
958,y1512,20150813,5594,5608,5590,5590,5590,5590,5590,-18,-18,2,111800,10
959,y1512,20150814,5590,5590,5586,5616,5542,5570,5584,-20,-6,30,1675360,10
960,y1512,20150817,5570,5584,5592,5592,5560,5568,5572,-16,-12,6,334400,10
961,y1512,20150818,5568,5572,0,0,0,5578,5578,6,6,0,0,10
962,y1512,20150819,5578,5578,0,0,0,5568,5568,-10,-10,0,0,10
963,y1512,20150820,5568,5568,5558,5558,5558,5558,5558,-10,-10,2,111160,12
964,y1512,20150821,5558,5558,5534,5594,5534,5542,5556,-16,-2,6,333400,10
965,y1512,20150824,5542,5556,5558,5584,5506,5508,5536,-48,-20,12,664400,10
966,y1512,20150825,5508,5536,5400,5410,5344,5370,5384,-166,-152,22,1184880,10
967,y1512,20150826,5370,5384,0,0,0,5372,5372,-12,-12,0,0,10
968,y1512,20150827,5372,5372,0,0,0,5400,5400,28,28,0,0,10
969,y1512,20150828,5400,5400,0,0,0,5414,5414,14,14,0,0,10
970,y1512,20150831,5414,5414,0,0,0,5380,5380,-34,-34,0,0,10
971,y1512,20150901,5380,5380,0,0,0,5338,5338,-42,-42,0,0,10
972,y1512,20150902,5338,5338,0,0,0,5396,5396,58,58,0,0,10
973,y1512,20150907,5396,5396,0,0,0,5480,5480,84,84,0,0,10
974,y1512,20150908,5480,5480,0,0,0,5480,5480,0,0,0,0,10
975,y1512,20150909,5480,5480,0,0,0,5662,5662,182,182,0,0,10
976,y1512,20150910,5662,5662,0,0,0,5646,5646,-16,-16,0,0,10
977,y1512,20150911,5646,5646,5476,5476,5476,5476,5476,-170,-170,6,328560,16
978,y1512,20150914,5476,5476,0,0,0,5476,5476,0,0,0,0,16
979,y1512,20150915,5476,5476,0,0,0,5540,5540,64,64,0,0,16
980,y1512,20150916,5540,5540,5420,5420,5420,5420,5420,-120,-120,2,108400,18
981,y1512,20150917,5420,5420,0,0,0,5432,5432,12,12,0,0,18
982,y1512,20150918,5432,5432,0,0,0,5420,5420,-12,-12,0,0,18
983,y1512,20150921,5420,5420,0,0,0,5320,5320,-100,-100,0,0,18
984,y1512,20150922,5320,5320,0,0,0,5320,5320,0,0,0,0,18
985,y1512,20150923,5320,5320,0,0,0,5320,5320,0,0,0,0,18
986,y1512,20150924,5320,5320,5342,5342,5342,5342,5342,22,22,2,106840,18
987,y1512,20150925,5342,5342,5398,5484,5398,5484,5440,142,98,4,217640,18
988,y1512,20150928,5484,5440,0,0,0,5492,5492,52,52,0,0,18
989,y1512,20150929,5492,5492,0,0,0,5492,5492,0,0,0,0,18
990,y1512,20150930,5492,5492,0,0,0,5492,5492,0,0,0,0,18
991,y1512,20151008,5492,5492,0,0,0,5608,5608,116,116,0,0,18
992,y1512,20151009,5608,5608,0,0,0,5608,5608,0,0,0,0,18
993,y1512,20151012,5608,5608,5500,5710,5496,5710,5588,102,-20,14,782480,16
994,y1512,20151013,5710,5588,5764,5764,5588,5588,5676,0,88,4,227040,16
995,y1512,20151014,5588,5676,5830,5830,5628,5672,5714,-4,38,62,3542800,14
996,y1512,20151015,5672,5714,5680,5680,5680,5680,5680,-34,-34,2,113600,14
997,y1512,20151016,5680,5680,5680,5680,5680,5680,5680,0,0,2,113600,14
998,y1512,20151019,5680,5680,5676,5676,5676,5676,5676,-4,-4,2,113520,12
999,y1512,20151020,5676,5676,0,0,0,5608,5608,-68,-68,0,0,12
1000,y1512,20151021,5608,5608,0,0,0,5614,5614,6,6,0,0,12
1001,y1512,20151022,5614,5614,5620,5714,5620,5714,5666,100,52,4,226680,12
1002,y1512,20151023,5714,5666,5714,5720,5620,5620,5666,-46,0,44,2493320,14
1003,y1512,20151026,5620,5666,5652,5670,5652,5670,5662,4,-4,6,339760,14
1004,y1512,20151027,5670,5662,0,0,0,5662,5662,0,0,0,0,14
1005,y1512,20151028,5662,5662,0,0,0,5662,5662,0,0,0,0,14
1006,y1512,20151029,5662,5662,0,0,0,5664,5664,2,2,0,0,14
1007,y1512,20151030,5664,5664,0,0,0,5664,5664,0,0,0,0,14
1008,y1512,20151102,5664,5664,0,0,0,5688,5688,24,24,0,0,14
1009,y1512,20151103,5688,5688,0,0,0,5688,5688,0,0,0,0,14
1010,y1512,20151104,5688,5688,5662,5834,5658,5832,5762,144,74,16,922200,10
1011,y1512,20151105,5832,5762,0,0,0,5762,5762,0,0,0,0,10
1012,y1512,20151106,5762,5762,5716,5990,5716,5990,5824,228,62,20,1165120,8
1013,y1512,20151109,5990,5824,0,0,0,5824,5824,0,0,0,0,8
1014,y1512,20151110,5824,5824,0,0,0,5824,5824,0,0,0,0,8
1015,y1512,20151111,5824,5824,5614,6048,5612,6048,5772,224,-52,8,461840,8
1016,y1512,20151112,6048,5772,5746,5746,5640,5640,5676,-132,-96,6,340600,8
1017,y1512,20151113,5640,5676,0,0,0,5676,5676,0,0,0,0,8
1018,y1512,20151116,5676,5676,0,0,0,5676,5676,0,0,0,0,8
1019,y1512,20151117,5676,5676,5512,5902,5496,5900,5702,224,26,8,456200,8
1020,y1512,20151118,5900,5702,5930,5930,5860,5930,5916,228,214,10,591600,8
1021,y1512,20151119,5930,5916,5700,5746,5700,5746,5736,-170,-180,12,688400,10
1022,y1512,20151120,5746,5736,5898,5898,5508,5508,5684,-228,-52,8,454840,10
1023,y1512,20151123,5508,5684,0,0,0,5684,5684,0,0,0,0,10
1024,y1512,20151124,5684,5684,5710,5710,5460,5460,5582,-224,-102,8,446680,8
1025,y1512,20151125,5460,5582,0,0,0,5582,5582,0,0,0,0,8
1026,y1512,20151126,5582,5582,0,0,0,5582,5582,0,0,0,0,8
1027,y1512,20151127,5582,5582,5482,5482,5474,5474,5480,-108,-102,8,438400,8
1028,y1512,20151130,5474,5480,5596,5596,5320,5320,5498,-160,18,8,439920,8
1029,y1512,20151201,5320,5498,5598,5598,5598,5598,5598,100,100,4,223920,8
1030,y1512,20151202,5598,5598,0,0,0,5598,5598,0,0,0,0,8
1031,y1512,20151203,5598,5598,0,0,0,5598,5598,0,0,0,0,8
1032,y1512,20151204,5598,5598,0,0,0,5598,5598,0,0,0,0,8
1033,y1512,20151207,5598,5598,0,0,0,5598,5598,0,0,0,0,8
1034,y1512,20151208,5598,5598,0,0,0,5598,5598,0,0,0,0,6
1035,y1512,20151209,5598,5598,0,0,0,5598,5598,0,0,0,0,6
1036,y1512,20151210,5598,5598,0,0,0,5598,5598,0,0,0,0,6
1037,y1512,20151211,5598,5598,0,0,0,5598,5598,0,0,0,0,6
1038,y1512,20151214,5598,5598,0,0,0,5598,5598,0,0,0,0,0
1039,y1601,20150119,5706,5706,5802,5850,5626,5750,5780,44,74,2530,146254120,1354
1040,y1601,20150120,5750,5780,5758,5780,5738,5780,5748,0,-32,1170,67269560,1936
1041,y1601,20150121,5780,5748,5784,5802,5756,5794,5780,46,32,1098,63482920,1598
1042,y1601,20150122,5794,5780,5780,5798,5740,5740,5776,-40,-4,530,30612960,1668
1043,y1601,20150123,5740,5776,5742,5742,5666,5682,5698,-94,-78,1400,79796160,2084
1044,y1601,20150126,5682,5698,5700,5700,5638,5640,5656,-58,-42,790,44697480,2594
1045,y1601,20150127,5640,5656,5640,5666,5614,5622,5648,-34,-8,982,55476200,3064
1046,y1601,20150128,5622,5648,5642,5642,5606,5616,5620,-32,-28,504,28326600,3208
1047,y1601,20150129,5616,5620,5602,5608,5534,5552,5562,-68,-58,1278,71105120,3570
1048,y1601,20150130,5552,5562,5520,5540,5442,5472,5480,-90,-82,2176,119275120,4688
1049,y1601,20150202,5472,5480,5472,5532,5442,5502,5492,22,12,1788,98205400,4290
1050,y1601,20150203,5502,5492,5540,5564,5516,5546,5534,54,42,2356,130382200,4666
1051,y1601,20150204,5546,5534,5564,5628,5550,5554,5578,20,44,1442,80462320,4694
1052,y1601,20150205,5554,5578,5622,5622,5536,5560,5566,-18,-12,2096,116693920,4576
1053,y1601,20150206,5560,5566,5626,5682,5606,5636,5638,70,72,6050,341171760,7452
1054,y1601,20150209,5636,5638,5664,5666,5626,5626,5640,-12,2,6580,371171040,9914
1055,y1601,20150210,5626,5640,5612,5642,5594,5638,5628,-2,-12,2330,131144960,9670
1056,y1601,20150211,5638,5628,5600,5624,5588,5612,5602,-16,-26,2874,161033600,8936
1057,y1601,20150212,5612,5602,5592,5610,5580,5590,5596,-12,-6,2242,125466360,9364
1058,y1601,20150213,5590,5596,5608,5690,5592,5690,5662,94,66,4294,243138960,8054
1059,y1601,20150216,5690,5662,5678,5714,5666,5696,5690,34,28,1480,84212640,7810
1060,y1601,20150217,5696,5690,5694,5714,5688,5700,5698,10,8,964,54929680,7940
1061,y1601,20150225,5700,5698,5650,5668,5620,5634,5640,-64,-58,1678,94640120,7380
1062,y1601,20150226,5634,5640,5644,5682,5638,5670,5662,30,22,3546,200832640,7838
1063,y1601,20150227,5670,5662,5686,5772,5668,5772,5718,110,56,3434,196374880,8868
1064,y1601,20150302,5772,5718,5774,5878,5768,5858,5816,140,98,6250,363571800,9760
1065,y1601,20150303,5858,5816,5852,5898,5780,5792,5826,-24,10,8672,505235000,12816
1066,y1601,20150304,5792,5826,5804,5840,5756,5800,5794,-26,-32,8500,492604280,16420
1067,y1601,20150305,5800,5794,5776,5780,5672,5684,5706,-110,-88,8722,497804600,18860
1068,y1601,20150306,5684,5706,5672,5684,5586,5586,5620,-120,-86,10674,600082000,24930
1069,y1601,20150309,5586,5620,5556,5620,5556,5598,5596,-22,-24,14648,819933120,34796
1070,y1601,20150310,5598,5596,5580,5590,5524,5536,5558,-60,-38,9294,516644240,38426
1071,y1601,20150311,5536,5558,5526,5556,5510,5534,5534,-24,-24,6644,367750600,40302
1072,y1601,20150312,5534,5534,5556,5564,5508,5538,5532,4,-2,8118,449219640,42090
1073,y1601,20150313,5538,5532,5438,5550,5438,5518,5526,-14,-6,9972,551068320,43876
1074,y1601,20150316,5518,5526,5510,5510,5348,5456,5450,-70,-76,11886,647803400,47872
1075,y1601,20150317,5456,5450,5462,5482,5424,5480,5452,30,2,26246,1431357840,63238
1076,y1601,20150318,5480,5452,5402,5448,5402,5426,5424,-26,-28,17952,973864920,72818
1077,y1601,20150319,5426,5424,5452,5546,5452,5502,5508,78,84,17446,961048080,74946
1078,y1601,20150320,5502,5508,5492,5520,5456,5468,5484,-40,-24,18082,991894200,80442
1079,y1601,20150323,5468,5484,5452,5514,5428,5502,5492,18,8,17138,941328360,85384
1080,y1601,20150324,5502,5492,5516,5568,5502,5520,5532,28,40,17994,995598160,84328
1081,y1601,20150325,5520,5532,5534,5542,5490,5492,5514,-40,-18,13110,723103040,86292
1082,y1601,20150326,5492,5514,5510,5526,5474,5512,5504,-2,-10,14564,801843120,89334
1083,y1601,20150327,5512,5504,5514,5522,5460,5472,5488,-32,-16,14902,817909720,89850
1084,y1601,20150330,5472,5488,5478,5484,5414,5422,5442,-66,-46,21276,1157952920,85654
1085,y1601,20150331,5422,5442,5436,5456,5390,5410,5412,-32,-30,19110,1034607320,88554
1086,y1601,20150401,5410,5412,5388,5450,5376,5400,5416,-12,4,17218,932748960,91302
1087,y1601,20150402,5400,5416,5410,5464,5380,5432,5428,16,12,30936,1679640040,99994
1088,y1601,20150403,5432,5428,5430,5446,5408,5446,5430,18,2,20034,1087849080,95944
1089,y1601,20150407,5446,5430,5482,5532,5472,5502,5500,72,70,20290,1116263120,99268
1090,y1601,20150408,5502,5500,5472,5500,5446,5474,5474,-26,-26,21524,1178357920,103332
1091,y1601,20150409,5474,5474,5456,5470,5418,5434,5438,-40,-36,14430,784941680,104924
1092,y1601,20150410,5434,5438,5430,5454,5402,5428,5432,-10,-6,20806,1130492240,109026
1093,y1601,20150413,5428,5432,5436,5504,5436,5492,5484,60,52,64910,3560725800,124740
1094,y1601,20150414,5492,5484,5484,5508,5456,5472,5478,-12,-6,24906,1364713200,124464
1095,y1601,20150415,5472,5478,5496,5608,5478,5592,5544,114,66,72648,4027818040,126832
1096,y1601,20150416,5592,5544,5570,5662,5566,5598,5614,54,70,54024,3033336640,132062
1097,y1601,20150417,5598,5614,5600,5608,5572,5586,5590,-28,-24,51490,2879271680,137120
1098,y1601,20150420,5586,5590,5586,5676,5566,5670,5634,80,44,55698,3138588520,146206
1099,y1601,20150421,5670,5634,5650,5740,5646,5728,5700,94,66,51660,2944937760,152342
1100,y1601,20150422,5728,5700,5728,5754,5658,5708,5706,8,6,61780,3526166600,149568
1101,y1601,20150423,5708,5706,5716,5766,5680,5730,5720,24,14,61008,3490067280,150316
1102,y1601,20150424,5730,5720,5740,5798,5656,5692,5724,-28,4,167478,9587295640,182626
1103,y1601,20150427,5692,5724,5700,5736,5642,5728,5692,4,-32,75270,4284480720,192084
1104,y1601,20150428,5728,5692,5728,5768,5696,5710,5728,18,36,73224,4194622360,196814
1105,y1601,20150429,5710,5728,5712,5726,5672,5688,5702,-40,-26,55698,3176126280,201322
1106,y1601,20150430,5688,5702,5684,5748,5680,5724,5718,22,16,57202,3271193080,202846
1107,y1601,20150504,5724,5718,5714,5832,5704,5826,5792,108,74,68970,3994840840,209596
1108,y1601,20150505,5826,5792,5846,5946,5836,5894,5888,102,96,96080,5658367280,214818
1109,y1601,20150506,5894,5888,5920,6010,5914,5972,5958,84,70,128384,7650211920,221400
1110,y1601,20150507,5972,5958,5964,5982,5888,5922,5930,-36,-28,94388,5597309600,225188
1111,y1601,20150508,5922,5930,5902,5918,5852,5856,5880,-74,-50,74964,4408084600,222086
1112,y1601,20150511,5856,5880,5880,5966,5864,5960,5926,80,46,110954,6575632360,226706
1113,y1601,20150512,5960,5926,5990,5994,5914,5952,5958,26,32,109948,6550720640,234920
1114,y1601,20150513,5952,5958,6014,6060,5970,5982,6010,24,52,221618,13323188840,263066
1115,y1601,20150514,5982,6010,5998,5998,5924,5970,5954,-40,-56,104656,6233235160,265444
1116,y1601,20150515,5970,5954,5982,6020,5954,5998,5992,44,38,161310,9666555840,279588
1117,y1601,20150518,5998,5992,5970,5972,5930,5966,5946,-26,-46,94072,5594059080,279490
1118,y1601,20150519,5966,5946,5960,5966,5870,5884,5906,-62,-40,105760,6246451080,266300
1119,y1601,20150520,5884,5906,5870,5870,5726,5778,5782,-128,-124,168066,9718251640,249722
1120,y1601,20150521,5778,5782,5790,5830,5774,5814,5808,32,26,78458,4557626960,251936
1121,y1601,20150522,5814,5808,5840,5866,5790,5818,5828,10,20,103304,6021041040,271892
1122,y1601,20150525,5818,5828,5768,5810,5742,5788,5772,-40,-56,87898,5073519640,273206
1123,y1601,20150526,5788,5772,5788,5948,5784,5884,5876,112,104,198604,11671379680,293712
1124,y1601,20150527,5884,5876,5880,5936,5864,5904,5904,28,28,205308,12122941960,337608
1125,y1601,20150528,5904,5904,5890,5962,5866,5908,5910,4,6,183246,10832853520,348686
1126,y1601,20150529,5908,5910,5924,5930,5884,5884,5906,-26,-4,115846,6843562920,353310
1127,y1601,20150601,5884,5906,5912,6080,5898,6046,6024,140,118,447752,26972652240,424098
1128,y1601,20150602,6046,6024,6098,6166,6076,6100,6116,76,92,440076,26920420320,473668
1129,y1601,20150603,6100,6116,6092,6140,6006,6014,6066,-102,-50,365310,22160487960,473176
1130,y1601,20150604,6014,6066,6016,6060,5942,6006,6004,-60,-62,361860,21731018200,484930
1131,y1601,20150605,6006,6004,6022,6036,5928,5996,5976,-8,-28,359146,21468863440,509280
1132,y1601,20150608,5996,5976,5994,6050,5944,5962,5990,-14,14,335606,20104483160,513760
1133,y1601,20150609,5962,5990,5942,5966,5870,5900,5912,-90,-78,306734,18135901120,491542
1134,y1601,20150610,5900,5912,5912,5944,5884,5926,5914,14,2,235522,13930739280,499246
1135,y1601,20150611,5926,5914,5944,5972,5900,5952,5934,38,20,327872,19460732120,505726
1136,y1601,20150612,5952,5934,5922,5940,5820,5824,5866,-110,-68,393382,23082066800,482030
1137,y1601,20150615,5824,5866,5850,5874,5792,5828,5836,-38,-30,348562,20348726360,482774
1138,y1601,20150616,5828,5836,5820,5924,5790,5920,5870,84,34,479556,28157110920,507934
1139,y1601,20150617,5920,5870,5924,5956,5870,5922,5920,52,50,603032,35700136280,515608
1140,y1601,20150618,5922,5920,5920,5962,5842,5852,5902,-68,-18,595626,35155147320,521046
1141,y1601,20150619,5852,5902,5832,5868,5796,5848,5836,-54,-66,499496,29160408800,511922
1142,y1601,20150623,5848,5836,5900,5910,5844,5864,5878,28,42,272426,16014812600,519418
1143,y1601,20150624,5864,5878,5834,5902,5820,5876,5860,-2,-18,509568,29860778600,539366
1144,y1601,20150625,5876,5860,5888,5942,5862,5864,5904,4,44,594190,35085078960,557356
1145,y1601,20150626,5864,5904,5882,5918,5776,5830,5866,-74,-38,730364,42857588360,536566
1146,y1601,20150629,5830,5866,5880,5894,5762,5782,5828,-84,-38,659902,38464385880,546018
1147,y1601,20150630,5782,5828,5800,5816,5666,5716,5734,-112,-94,631540,36217399800,522948
1148,y1601,20150701,5716,5734,5708,5924,5700,5862,5828,128,94,625622,36469071760,472502
1149,y1601,20150702,5862,5828,5866,5870,5760,5812,5800,-16,-28,528954,30687342400,439468
1150,y1601,20150703,5812,5800,5798,5864,5796,5834,5832,34,32,458912,26771234880,435084
1151,y1601,20150706,5834,5832,5826,5830,5646,5726,5736,-106,-96,585762,33605844680,439378
1152,y1601,20150707,5726,5736,5720,5762,5648,5678,5702,-58,-34,563438,32135057520,450310
1153,y1601,20150708,5678,5702,5650,5654,5474,5474,5532,-228,-170,460374,25468097400,412918
1154,y1601,20150709,5474,5532,5390,5628,5202,5548,5454,16,-78,999486,54516274240,394834
1155,y1601,20150710,5548,5454,5602,5672,5582,5672,5640,218,186,492692,27795598120,433090
1156,y1601,20150713,5672,5640,5726,5750,5574,5644,5656,4,16,601050,34004283360,443936
1157,y1601,20150714,5644,5656,5638,5774,5604,5728,5706,72,50,758096,43259971520,463884
1158,y1601,20150715,5728,5706,5730,5766,5666,5690,5720,-16,14,708722,40540210120,507784
1159,y1601,20150716,5690,5720,5670,5688,5602,5658,5644,-62,-76,537944,30364477640,509568
1160,y1601,20150717,5658,5644,5680,5704,5582,5624,5638,-20,-6,606724,34210078480,529812
1161,y1601,20150720,5624,5638,5600,5656,5566,5646,5614,8,-24,667410,37477570440,523874
1162,y1601,20150721,5646,5614,5654,5692,5634,5688,5662,74,48,617350,34961022360,532490
1163,y1601,20150722,5688,5662,5698,5714,5648,5674,5686,12,24,502226,28556698960,530458
1164,y1601,20150723,5674,5686,5650,5654,5600,5604,5624,-82,-62,492832,27720444880,554282
1165,y1601,20150724,5604,5624,5610,5634,5556,5582,5594,-42,-30,512420,28667069520,555708
1166,y1601,20150727,5582,5594,5560,5592,5468,5490,5526,-104,-68,655820,36249673760,572548
1167,y1601,20150728,5490,5526,5462,5498,5420,5474,5460,-52,-66,523390,28584072240,564458
1168,y1601,20150729,5474,5460,5470,5542,5470,5502,5506,42,46,516644,28450970320,567262
1169,y1601,20150730,5502,5506,5488,5528,5468,5488,5496,-18,-10,441224,24258202360,579688
1170,y1601,20150731,5488,5496,5520,5542,5476,5484,5508,-12,12,412152,22704633320,594588
1171,y1601,20150803,5484,5508,5472,5500,5382,5402,5440,-106,-68,497370,27062846800,607606
1172,y1601,20150804,5402,5440,5382,5452,5364,5446,5412,6,-28,533788,28892634280,612258
1173,y1601,20150805,5446,5412,5470,5508,5456,5496,5480,84,68,563128,30862857400,628176
1174,y1601,20150806,5496,5480,5490,5494,5422,5432,5452,-48,-28,457588,24955851560,630424
1175,y1601,20150807,5432,5452,5438,5502,5386,5494,5450,42,-2,709186,38663811840,662390
1176,y1601,20150810,5494,5450,5476,5588,5462,5530,5512,80,62,722070,39811836800,677694
1177,y1601,20150811,5530,5512,5524,5658,5522,5612,5594,100,82,1000500,55972597560,678904
1178,y1601,20150812,5612,5594,5582,5662,5556,5662,5602,68,8,806346,45173186680,684214
1179,y1601,20150813,5662,5602,5664,5736,5466,5604,5628,2,26,992694,55874485560,644250
1180,y1601,20150814,5604,5628,5588,5622,5526,5528,5574,-100,-54,684888,38186201680,635290
1181,y1601,20150817,5528,5574,5512,5596,5512,5584,5554,10,-20,578566,32144148400,647156
1182,y1601,20150818,5584,5554,5606,5626,5522,5536,5578,-18,24,579794,32346782600,647876
1183,y1601,20150819,5536,5578,5534,5566,5486,5558,5526,-20,-52,689676,38117752920,649038
1184,y1601,20150820,5558,5526,5556,5592,5500,5520,5542,-6,16,786540,43598027640,666248
1185,y1601,20150821,5520,5542,5548,5614,5532,5564,5566,22,24,836972,46593057520,651896
1186,y1601,20150824,5564,5566,5544,5570,5344,5344,5434,-222,-132,1004028,54567890480,646874
1187,y1601,20150825,5344,5434,5274,5390,5180,5202,5298,-232,-136,1312074,69525556040,585968
1188,y1601,20150826,5202,5298,5324,5358,5224,5242,5288,-56,-10,1019384,53906444320,530804
1189,y1601,20150827,5242,5288,5268,5320,5228,5314,5274,26,-14,735532,38795569160,535760
1190,y1601,20150828,5314,5274,5340,5454,5322,5408,5390,134,116,1052194,56721310400,534416
1191,y1601,20150831,5408,5390,5412,5430,5360,5378,5388,-12,-2,725834,39120816920,525946
1192,y1601,20150901,5378,5388,5356,5440,5344,5392,5386,4,-2,607048,32704516160,505626
1193,y1601,20150902,5392,5386,5376,5392,5320,5360,5358,-26,-28,466724,25012303160,506680
1194,y1601,20150907,5360,5358,5330,5348,5300,5318,5322,-40,-36,275332,14653456600,519294
1195,y1601,20150908,5318,5322,5340,5408,5324,5394,5360,72,38,448350,24034604120,540210
1196,y1601,20150909,5394,5360,5420,5438,5398,5404,5418,44,58,584294,31666529920,545388
1197,y1601,20150910,5404,5418,5416,5448,5368,5440,5402,22,-16,641788,34677932520,543568
1198,y1601,20150911,5440,5402,5440,5470,5422,5426,5444,24,42,588360,32039203560,528300
1199,y1601,20150914,5426,5444,5402,5442,5356,5426,5408,-18,-36,645106,34899954840,526434
1200,y1601,20150915,5426,5408,5444,5492,5390,5402,5450,-6,42,807730,44023502760,538332
1201,y1601,20150916,5402,5450,5390,5418,5366,5416,5392,-34,-58,658020,35482219000,540234
1202,y1601,20150917,5416,5392,5424,5430,5382,5384,5404,-8,12,527706,28527690280,540872
1203,y1601,20150918,5384,5404,5374,5418,5368,5376,5390,-28,-14,499992,26955224640,548002
1204,y1601,20150921,5376,5390,5358,5388,5330,5382,5354,-8,-36,463540,24820319040,527650
1205,y1601,20150922,5382,5354,5390,5400,5310,5324,5354,-30,0,616492,33009999280,557136
1206,y1601,20150923,5324,5354,5310,5332,5272,5292,5302,-62,-52,677168,35911857120,562912
1207,y1601,20150924,5292,5302,5316,5342,5288,5326,5312,24,10,581564,30899712720,533880
1208,y1601,20150925,5326,5312,5312,5432,5304,5408,5386,96,74,1127426,60744528200,515878
1209,y1601,20150928,5408,5386,5452,5468,5414,5442,5436,56,50,405324,22035944040,539792
1210,y1601,20150929,5442,5436,5460,5460,5334,5362,5388,-74,-48,689774,37174507920,501942
1211,y1601,20150930,5362,5388,5402,5420,5372,5406,5400,18,12,367214,19831281560,503582
1212,y1601,20151008,5406,5400,5528,5528,5430,5442,5462,42,62,327212,17877019240,524534
1213,y1601,20151009,5442,5462,5440,5546,5438,5520,5494,58,32,634732,34875011480,595472
1214,y1601,20151012,5520,5494,5530,5650,5484,5628,5582,134,88,1009926,56393291160,578238
1215,y1601,20151013,5628,5582,5624,5666,5554,5648,5612,66,30,910656,51110601000,610900
1216,y1601,20151014,5648,5612,5658,5668,5624,5634,5644,22,32,709030,40018915760,620428
1217,y1601,20151015,5634,5644,5668,5686,5630,5650,5652,6,8,680356,38454687880,630496
1218,y1601,20151016,5650,5652,5630,5662,5590,5640,5626,-12,-26,779008,43828165520,613956
1219,y1601,20151019,5640,5626,5626,5646,5588,5596,5620,-30,-6,630380,35428340560,603456
1220,y1601,20151020,5596,5620,5578,5594,5516,5540,5546,-80,-74,663482,36799413160,570754
1221,y1601,20151021,5540,5546,5558,5584,5544,5566,5564,20,18,581018,32338622040,553058
1222,y1601,20151022,5566,5564,5568,5674,5564,5672,5626,108,62,811940,45689398880,617284
1223,y1601,20151023,5672,5626,5678,5682,5554,5604,5612,-22,-14,944928,53032870600,580092
1224,y1601,20151026,5604,5612,5606,5622,5536,5550,5572,-62,-40,765042,42631814840,570236
1225,y1601,20151027,5550,5572,5540,5580,5484,5574,5532,2,-40,741450,41017321760,569504
1226,y1601,20151028,5574,5532,5574,5580,5498,5526,5534,-6,2,659742,36519250600,525772
1227,y1601,20151029,5526,5534,5540,5596,5516,5536,5552,2,18,669770,37186144120,534036
1228,y1601,20151030,5536,5552,5550,5558,5512,5538,5534,-14,-18,503436,27867997720,547222
1229,y1601,20151102,5538,5534,5538,5582,5508,5572,5548,38,14,590514,32772214760,557954
1230,y1601,20151103,5572,5548,5550,5572,5526,5532,5546,-16,-2,595492,33031772360,535818
1231,y1601,20151104,5532,5546,5528,5616,5528,5614,5576,68,30,810430,45195211720,539600
1232,y1601,20151105,5614,5576,5620,5646,5590,5608,5612,32,36,749570,42074767840,514958
1233,y1601,20151106,5608,5612,5604,5606,5488,5532,5542,-80,-70,1030750,57142646760,485306
1234,y1601,20151109,5532,5542,5532,5540,5492,5524,5522,-18,-20,546002,30150663360,474150
1235,y1601,20151110,5524,5522,5538,5546,5488,5544,5514,22,-8,555752,30647139120,470382
1236,y1601,20151111,5544,5514,5534,5536,5430,5438,5478,-76,-36,693560,37995714920,461110
1237,y1601,20151112,5438,5478,5436,5486,5432,5468,5452,-10,-26,345550,18844548720,439316
1238,y1601,20151113,5468,5452,5450,5514,5436,5476,5476,24,24,362854,19874311520,416432
1239,y1601,20151116,5476,5476,5452,5488,5426,5450,5454,-26,-22,398416,21735679520,397170
1240,y1601,20151117,5450,5454,5456,5500,5416,5494,5460,40,6,456026,24906848800,390794
1241,y1601,20151118,5494,5460,5486,5508,5454,5468,5480,8,20,381060,20883120280,378832
1242,y1601,20151119,5468,5480,5480,5494,5404,5424,5446,-56,-34,534634,29119485720,355540
1243,y1601,20151120,5424,5446,5414,5498,5364,5494,5426,48,-20,503968,27349822200,352506
1244,y1601,20151123,5494,5426,5482,5554,5474,5512,5516,86,90,572014,31561897320,329474
1245,y1601,20151124,5512,5516,5532,5694,5498,5660,5592,144,76,473754,26494966880,319132
1246,y1601,20151125,5660,5592,5656,5666,5606,5650,5642,58,50,236186,13329778880,290712
1247,y1601,20151126,5650,5642,5630,5760,5624,5696,5692,54,50,246712,14045310720,258954
1248,y1601,20151127,5696,5692,5684,5738,5684,5728,5714,36,22,128028,7316165480,240278
1249,y1601,20151130,5728,5714,5718,5736,5650,5684,5690,-30,-24,97442,5545327880,213720
1250,y1601,20151201,5684,5690,5662,5812,5662,5750,5760,60,70,125932,7253863680,200422
1251,y1601,20151202,5750,5760,5762,5848,5736,5790,5786,30,26,89090,5156149440,181838
1252,y1601,20151203,5790,5786,5786,5828,5728,5774,5768,-12,-18,70486,4066104080,176164
1253,y1601,20151204,5774,5768,5778,5804,5758,5764,5778,-4,10,70908,4097966800,160862
1254,y1601,20151207,5764,5778,5778,5920,5742,5860,5822,82,44,53022,3087740320,150258
1255,y1601,20151208,5860,5822,5878,5878,5734,5762,5788,-60,-34,44512,2576369720,138720
1256,y1601,20151209,5762,5788,5740,5762,5700,5708,5738,-80,-50,66316,3805569000,124566
1257,y1601,20151210,5708,5738,5702,5754,5698,5712,5716,-26,-22,40562,2318678680,117456
1258,y1601,20151211,5712,5716,5710,5728,5656,5680,5682,-36,-34,69960,3975816800,83364
1259,y1601,20151214,5680,5682,5676,5718,5624,5698,5670,16,-12,38926,2207499120,70350
1260,y1601,20151215,5698,5670,5668,5744,5650,5694,5700,24,30,15728,896617360,66408
1261,y1601,20151216,5694,5700,5686,5724,5638,5696,5688,-4,-12,16854,958720280,62540
1262,y1601,20151217,5696,5688,5670,5706,5644,5652,5670,-36,-18,14556,825603520,54616
1263,y1601,20151218,5652,5670,5648,5676,5616,5670,5644,0,-26,11934,673718360,49540
1264,y1601,20151221,5670,5644,5662,5758,5662,5754,5700,110,56,14738,840300920,41420
1265,y1601,20151222,5754,5700,5756,5780,5730,5736,5744,36,44,12098,694974040,40070
1266,y1601,20151223,5736,5744,5744,5760,5704,5742,5724,-2,-20,2764,158251240,38606
1267,y1601,20151224,5742,5724,5748,5778,5728,5742,5754,18,30,5968,343409840,35534
1268,y1601,20151225,5742,5754,5746,5760,5730,5754,5744,0,-10,11576,665002480,27968
1269,y1601,20151228,5754,5744,5756,5770,5700,5702,5724,-42,-20,5240,300040920,24972
1270,y1601,20151229,5702,5724,5682,5888,5660,5888,5700,164,-24,4342,247552760,22442
1271,y1601,20151230,5888,5700,5820,5884,5792,5852,5842,152,142,7330,428328320,19910
1272,y1601,20151231,5852,5842,5858,5900,5838,5894,5860,52,18,6486,380189000,14922
1273,y1603,20150316,5532,5532,5620,5620,5314,5568,5480,36,-52,10,548080,4
1274,y1603,20150317,5568,5480,5440,5440,5430,5430,5434,-50,-46,4,217400,4
1275,y1603,20150318,5430,5434,0,0,0,5434,5434,0,0,0,0,4
1276,y1603,20150319,5434,5434,0,0,0,5434,5434,0,0,0,0,4
1277,y1603,20150320,5434,5434,5546,5546,5454,5454,5500,20,66,4,220000,6
1278,y1603,20150323,5454,5500,0,0,0,5508,5508,8,8,0,0,6
1279,y1603,20150324,5508,5508,0,0,0,5548,5548,40,40,0,0,6
1280,y1603,20150325,5548,5548,0,0,0,5530,5530,-18,-18,0,0,6
1281,y1603,20150326,5530,5530,0,0,0,5520,5520,-10,-10,0,0,6
1282,y1603,20150327,5520,5520,0,0,0,5504,5504,-16,-16,0,0,6
1283,y1603,20150330,5504,5504,5490,5490,5490,5490,5490,-14,-14,2,109800,4
1284,y1603,20150331,5490,5490,5480,5480,5480,5480,5480,-10,-10,8,438400,8
1285,y1603,20150401,5480,5480,0,0,0,5480,5480,0,0,0,0,8
1286,y1603,20150402,5480,5480,0,0,0,5492,5492,12,12,0,0,8
1287,y1603,20150403,5492,5492,0,0,0,5494,5494,2,2,0,0,8
1288,y1603,20150407,5494,5494,0,0,0,5564,5564,70,70,0,0,8
1289,y1603,20150408,5564,5564,0,0,0,5564,5564,0,0,0,0,8
1290,y1603,20150409,5564,5564,0,0,0,5530,5530,-34,-34,0,0,8
1291,y1603,20150410,5530,5530,5496,5518,5436,5482,5470,-48,-60,12,656440,10
1292,y1603,20150413,5482,5470,5488,5578,5488,5578,5536,108,66,8,442960,10
1293,y1603,20150414,5578,5536,0,0,0,5536,5536,0,0,0,0,10
1294,y1603,20150415,5536,5536,5632,5632,5632,5632,5632,96,96,2,112640,12
1295,y1603,20150416,5632,5632,0,0,0,5702,5702,70,70,0,0,12
1296,y1603,20150417,5702,5702,5678,5678,5634,5634,5656,-68,-46,4,226240,12
1297,y1603,20150420,5634,5656,5712,5712,5712,5712,5712,56,56,2,114240,12
1298,y1603,20150421,5712,5712,5728,5728,5728,5728,5728,16,16,2,114560,12
1299,y1603,20150422,5728,5728,0,0,0,5734,5734,6,6,0,0,12
1300,y1603,20150423,5734,5734,0,0,0,5748,5748,14,14,0,0,12
1301,y1603,20150424,5748,5748,0,0,0,5748,5748,0,0,0,0,12
1302,y1603,20150427,5748,5748,0,0,0,5748,5748,0,0,0,0,12
1303,y1603,20150428,5748,5748,0,0,0,5748,5748,0,0,0,0,12
1304,y1603,20150429,5748,5748,0,0,0,5748,5748,0,0,0,0,12
1305,y1603,20150430,5748,5748,0,0,0,5748,5748,0,0,0,0,12
1306,y1603,20150504,5748,5748,0,0,0,5828,5828,80,80,0,0,12
1307,y1603,20150505,5828,5828,5920,5984,5920,5984,5942,156,114,20,1188720,26
1308,y1603,20150506,5984,5942,5990,6040,5990,6040,6022,98,80,10,602200,32
1309,y1603,20150507,6040,6022,0,0,0,5994,5994,-28,-28,0,0,32
1310,y1603,20150508,5994,5994,0,0,0,5944,5944,-50,-50,0,0,32
1311,y1603,20150511,5944,5944,5974,6038,5968,6038,5986,94,42,12,718400,34
1312,y1603,20150512,6038,5986,6010,6046,6010,6046,6034,60,48,8,482840,38
1313,y1603,20150513,6046,6034,6050,6094,6050,6086,6080,52,46,12,729600,38
1314,y1603,20150514,6086,6080,0,0,0,6080,6080,0,0,0,0,38
1315,y1603,20150515,6080,6080,6086,6086,6018,6060,6048,-20,-32,10,604840,40
1316,y1603,20150518,6060,6048,0,0,0,6002,6002,-46,-46,0,0,40
1317,y1603,20150519,6002,6002,5986,5986,5986,5986,5986,-16,-16,2,119720,40
1318,y1603,20150520,5986,5986,5850,5850,5850,5850,5850,-136,-136,4,234000,40
1319,y1603,20150521,5850,5850,5924,5924,5924,5924,5924,74,74,8,473920,40
1320,y1603,20150522,5924,5924,0,0,0,5944,5944,20,20,0,0,40
1321,y1603,20150525,5944,5944,5850,5852,5846,5846,5850,-98,-94,8,468000,40
1322,y1603,20150526,5846,5850,5942,5942,5942,5942,5942,92,92,2,118840,40
1323,y1603,20150527,5942,5942,0,0,0,5964,5964,22,22,0,0,40
1324,y1603,20150528,5964,5964,6000,6000,6000,6000,6000,36,36,2,120000,40
1325,y1603,20150529,6000,6000,5988,5988,5988,5988,5988,-12,-12,2,119760,40
1326,y1603,20150601,5988,5988,6000,6132,6000,6102,6106,114,118,18,1099360,40
1327,y1603,20150602,6102,6106,6240,6240,6198,6198,6218,92,112,4,248760,40
1328,y1603,20150603,6198,6218,0,0,0,6218,6218,0,0,0,0,40
1329,y1603,20150604,6218,6218,0,0,0,6156,6156,-62,-62,0,0,40
1330,y1603,20150605,6156,6156,6060,6060,6030,6030,6044,-126,-112,4,241800,40
1331,y1603,20150608,6030,6044,6052,6060,6036,6060,6048,16,4,6,362960,44
1332,y1603,20150609,6060,6048,6000,6000,6000,6000,6000,-48,-48,4,240000,44
1333,y1603,20150610,6000,6000,0,0,0,6002,6002,2,2,0,0,44
1334,y1603,20150611,6002,6002,0,0,0,6022,6022,20,20,0,0,44
1335,y1603,20150612,6022,6022,5922,5922,5922,5922,5922,-100,-100,4,236880,44
1336,y1603,20150615,5922,5922,5982,5982,5912,5912,5938,-10,16,10,593920,46
1337,y1603,20150616,5912,5938,5954,5954,5934,5934,5950,-4,12,24,1428000,46
1338,y1603,20150617,5934,5950,5980,6010,5898,5970,5964,20,14,26,1550880,46
1339,y1603,20150618,5970,5964,5902,5924,5902,5924,5912,-40,-52,4,236520,46
1340,y1603,20150619,5924,5912,5832,5832,5832,5832,5832,-80,-80,2,116640,46
1341,y1603,20150623,5832,5832,0,0,0,5872,5872,40,40,0,0,46
1342,y1603,20150624,5872,5872,5828,5876,5828,5876,5864,4,-8,8,469120,54
1343,y1603,20150625,5876,5864,5936,5948,5936,5936,5938,72,74,18,1069160,50
1344,y1603,20150626,5936,5938,5936,5984,5936,5944,5964,6,26,28,1670160,52
1345,y1603,20150629,5944,5964,5894,5894,5824,5824,5864,-140,-100,8,469160,54
1346,y1603,20150630,5824,5864,5844,5886,5762,5764,5826,-100,-38,22,1281720,54
1347,y1603,20150701,5764,5826,5818,5932,5818,5922,5900,96,74,8,472080,56
1348,y1603,20150702,5922,5900,5922,5922,5868,5868,5894,-32,-6,4,235800,58
1349,y1603,20150703,5868,5894,5868,5868,5868,5868,5868,-26,-26,2,117360,58
1350,y1603,20150706,5868,5868,5868,5868,5746,5746,5786,-122,-82,14,810080,62
1351,y1603,20150707,5746,5786,5842,5842,5776,5776,5804,-10,18,28,1625200,62
1352,y1603,20150708,5776,5804,5662,5684,5662,5684,5672,-120,-132,4,226920,60
1353,y1603,20150709,5684,5672,5446,5660,5446,5650,5548,-22,-124,48,2663200,62
1354,y1603,20150710,5650,5548,5738,5768,5722,5768,5748,220,200,8,459920,64
1355,y1603,20150713,5768,5748,5756,5790,5650,5650,5734,-98,-14,8,458720,62
1356,y1603,20150714,5650,5734,0,0,0,5784,5784,50,50,0,0,62
1357,y1603,20150715,5784,5784,5784,5784,5724,5724,5750,-60,-34,10,575000,62
1358,y1603,20150716,5724,5750,0,0,0,5674,5674,-76,-76,0,0,62
1359,y1603,20150717,5674,5674,5650,5694,5650,5694,5666,20,-8,6,340040,62
1360,y1603,20150720,5694,5666,5710,5710,5710,5710,5710,44,44,2,114200,62
1361,y1603,20150721,5710,5710,5764,5764,5764,5764,5764,54,54,2,115280,64
1362,y1603,20150722,5764,5764,5716,5716,5716,5716,5716,-48,-48,2,114320,62
1363,y1603,20150723,5716,5716,5662,5662,5662,5662,5662,-54,-54,2,113240,64
1364,y1603,20150724,5662,5662,5606,5606,5606,5606,5606,-56,-56,2,112120,64
1365,y1603,20150727,5606,5606,0,0,0,5590,5590,-16,-16,0,0,64
1366,y1603,20150728,5590,5590,5504,5510,5504,5510,5506,-80,-84,4,220280,66
1367,y1603,20150729,5510,5506,5584,5584,5542,5542,5566,36,60,6,334000,64
1368,y1603,20150730,5542,5566,5500,5550,5500,5550,5532,-16,-34,6,332000,64
1369,y1603,20150731,5550,5532,5562,5562,5562,5562,5562,30,30,2,111240,64
1370,y1603,20150803,5562,5562,0,0,0,5562,5562,0,0,0,0,64
1371,y1603,20150804,5562,5562,0,0,0,5534,5534,-28,-28,0,0,64
1372,y1603,20150805,5534,5534,0,0,0,5602,5602,68,68,0,0,64
1373,y1603,20150806,5602,5602,5480,5480,5480,5480,5480,-122,-122,2,109600,66
1374,y1603,20150807,5480,5480,5416,5460,5416,5460,5438,-20,-42,4,217520,66
1375,y1603,20150810,5460,5438,5570,5570,5570,5570,5570,132,132,2,111400,66
1376,y1603,20150811,5570,5570,0,0,0,5652,5652,82,82,0,0,66
1377,y1603,20150812,5652,5652,5668,5672,5668,5672,5670,20,18,42,2381520,60
1378,y1603,20150813,5672,5670,5746,5746,5612,5612,5664,-58,-6,18,1019760,58
1379,y1603,20150814,5612,5664,5666,5666,5666,5666,5666,2,2,2,113320,56
1380,y1603,20150817,5666,5666,0,0,0,5646,5646,-20,-20,0,0,56
1381,y1603,20150818,5646,5646,5692,5692,5658,5658,5676,12,30,8,454080,56
1382,y1603,20150819,5658,5676,0,0,0,5624,5624,-52,-52,0,0,56
1383,y1603,20150820,5624,5624,5672,5672,5606,5606,5634,-18,10,6,338040,56
1384,y1603,20150821,5606,5634,5596,5622,5562,5622,5592,-12,-42,16,894920,56
1385,y1603,20150824,5622,5592,5624,5628,5370,5370,5534,-222,-58,28,1550040,56
1386,y1603,20150825,5370,5534,5356,5496,5356,5358,5414,-176,-120,22,1191240,58
1387,y1603,20150826,5358,5414,5392,5734,5334,5334,5390,-80,-24,22,1185880,62
1388,y1603,20150827,5334,5390,5350,5350,5350,5350,5350,-40,-40,6,321000,58
1389,y1603,20150828,5350,5350,5456,5456,5454,5454,5454,104,104,4,218200,58
1390,y1603,20150831,5454,5454,5446,5446,5436,5436,5438,-18,-16,10,543880,50
1391,y1603,20150901,5436,5438,0,0,0,5436,5436,-2,-2,0,0,50
1392,y1603,20150902,5436,5436,0,0,0,5408,5408,-28,-28,0,0,50
1393,y1603,20150907,5408,5408,5382,5382,5382,5382,5382,-26,-26,2,107640,50
1394,y1603,20150908,5382,5382,0,0,0,5420,5420,38,38,0,0,50
1395,y1603,20150909,5420,5420,5502,5502,5494,5494,5498,74,78,6,329880,50
1396,y1603,20150910,5494,5498,5478,5490,5478,5490,5484,-8,-14,4,219360,48
1397,y1603,20150911,5490,5484,0,0,0,5484,5484,0,0,0,0,48
1398,y1603,20150914,5484,5484,0,0,0,5448,5448,-36,-36,0,0,48
1399,y1603,20150915,5448,5448,5532,5536,5532,5536,5534,88,86,4,221360,48
1400,y1603,20150916,5536,5534,0,0,0,5476,5476,-58,-58,0,0,48
1401,y1603,20150917,5476,5476,0,0,0,5488,5488,12,12,0,0,48
1402,y1603,20150918,5488,5488,0,0,0,5474,5474,-14,-14,0,0,48
1403,y1603,20150921,5474,5474,5380,5424,5338,5424,5362,-50,-112,18,965320,54
1404,y1603,20150922,5424,5362,0,0,0,5362,5362,0,0,0,0,54
1405,y1603,20150923,5362,5362,0,0,0,5362,5362,0,0,0,0,54
1406,y1603,20150924,5362,5362,5376,5376,5376,5376,5376,14,14,4,215040,50
1407,y1603,20150925,5376,5376,5400,5400,5400,5400,5400,24,24,2,108000,50
1408,y1603,20150928,5400,5400,5434,5450,5348,5408,5400,8,0,28,1512120,38
1409,y1603,20150929,5408,5400,5358,5358,5358,5358,5358,-42,-42,2,107160,36
1410,y1603,20150930,5358,5358,0,0,0,5358,5358,0,0,0,0,36
1411,y1603,20151008,5358,5358,0,0,0,5418,5418,60,60,0,0,36
1412,y1603,20151009,5418,5418,0,0,0,5418,5418,0,0,0,0,36
1413,y1603,20151012,5418,5418,0,0,0,5582,5582,164,164,0,0,36
1414,y1603,20151013,5582,5582,5584,5592,5584,5592,5588,10,6,4,223520,36
1415,y1603,20151014,5592,5588,0,0,0,5618,5618,30,30,0,0,36
1416,y1603,20151015,5618,5618,0,0,0,5624,5624,6,6,0,0,36
1417,y1603,20151016,5624,5624,0,0,0,5600,5600,-24,-24,0,0,36
1418,y1603,20151019,5600,5600,0,0,0,5596,5596,-4,-4,0,0,36
1419,y1603,20151020,5596,5596,0,0,0,5524,5524,-72,-72,0,0,36
1420,y1603,20151021,5524,5524,0,0,0,5540,5540,16,16,0,0,36
1421,y1603,20151022,5540,5540,0,0,0,5600,5600,60,60,0,0,36
1422,y1603,20151023,5600,5600,5632,5632,5632,5632,5632,32,32,2,112640,34
1423,y1603,20151026,5632,5632,0,0,0,5592,5592,-40,-40,0,0,34
1424,y1603,20151027,5592,5592,5422,5532,5422,5496,5482,-96,-110,6,329000,34
1425,y1603,20151028,5496,5482,5486,5534,5486,5510,5504,28,22,22,1211040,38
1426,y1603,20151029,5510,5504,5536,5540,5536,5540,5538,36,34,10,553920,30
1427,y1603,20151030,5540,5538,0,0,0,5522,5522,-16,-16,0,0,30
1428,y1603,20151102,5522,5522,0,0,0,5534,5534,12,12,0,0,30
1429,y1603,20151103,5534,5534,0,0,0,5534,5534,0,0,0,0,30
1430,y1603,20151104,5534,5534,0,0,0,5562,5562,28,28,0,0,30
1431,y1603,20151105,5562,5562,0,0,0,5562,5562,0,0,0,0,30
1432,y1603,20151106,5562,5562,0,0,0,5494,5494,-68,-68,0,0,30
1433,y1603,20151109,5494,5494,5494,5512,5494,5512,5502,18,8,4,220120,32
1434,y1603,20151110,5512,5502,5464,5464,5464,5464,5464,-38,-38,2,109280,32
1435,y1603,20151111,5464,5464,5498,5534,5432,5432,5478,-32,14,44,2411080,24
1436,y1603,20151112,5432,5478,5448,5448,5448,5448,5448,-30,-30,2,108960,24
1437,y1603,20151113,5448,5448,0,0,0,5470,5470,22,22,0,0,24
1438,y1603,20151116,5470,5470,0,0,0,5450,5450,-20,-20,0,0,24
1439,y1603,20151117,5450,5450,5452,5462,5452,5462,5456,12,6,6,327400,24
1440,y1603,20151118,5462,5456,0,0,0,5474,5474,18,18,0,0,24
1441,y1603,20151119,5474,5474,0,0,0,5442,5442,-32,-32,0,0,24
1442,y1603,20151120,5442,5442,5442,5488,5336,5488,5438,46,-4,22,1196400,24
1443,y1603,20151123,5488,5438,5498,5498,5498,5498,5498,60,60,2,109960,24
1444,y1603,20151124,5498,5498,5540,5666,5540,5666,5586,168,88,16,894040,24
1445,y1603,20151125,5666,5586,5668,5668,5668,5668,5668,82,82,2,113360,24
1446,y1603,20151126,5668,5668,5712,5738,5712,5716,5720,48,52,8,457600,24
1447,y1603,20151127,5716,5720,0,0,0,5720,5720,0,0,0,0,24
1448,y1603,20151130,5720,5720,5692,5692,5650,5650,5664,-70,-56,6,339840,18
1449,y1603,20151201,5650,5664,0,0,0,5732,5732,68,68,0,0,18
1450,y1603,20151202,5732,5732,5850,5852,5710,5820,5802,88,70,154,8937160,20
1451,y1603,20151203,5820,5802,0,0,0,5802,5802,0,0,0,0,20
1452,y1603,20151204,5802,5802,5730,5730,5730,5730,5730,-72,-72,2,114600,20
1453,y1603,20151207,5730,5730,5782,5816,5782,5816,5798,86,68,4,231960,20
1454,y1603,20151208,5816,5798,5780,5780,5706,5706,5742,-92,-56,4,229720,16
1455,y1603,20151209,5706,5742,5604,5730,5604,5656,5658,-86,-84,12,679160,14
1456,y1603,20151210,5656,5658,5592,5592,5592,5592,5592,-66,-66,2,111840,12
1457,y1603,20151211,5592,5592,0,0,0,5560,5560,-32,-32,0,0,12
1458,y1603,20151214,5560,5560,0,0,0,5550,5550,-10,-10,0,0,12
1459,y1603,20151215,5550,5550,5680,5680,5680,5680,5680,130,130,2,113600,12
1460,y1603,20151216,5680,5680,5714,5714,5476,5486,5580,-194,-100,24,1339400,12
1461,y1603,20151217,5486,5580,5502,5576,5502,5564,5544,-16,-36,12,665440,12
1462,y1603,20151218,5564,5544,5492,5500,5492,5500,5496,-44,-48,4,219840,12
1463,y1603,20151221,5500,5496,5580,5580,5580,5580,5580,84,84,2,111600,12
1464,y1603,20151222,5580,5580,5596,5596,5596,5596,5596,16,16,2,111920,12
1465,y1603,20151223,5596,5596,0,0,0,5578,5578,-18,-18,0,0,12
1466,y1603,20151224,5578,5578,0,0,0,5606,5606,28,28,0,0,12
1467,y1603,20151225,5606,5606,0,0,0,5598,5598,-8,-8,0,0,12
1468,y1603,20151228,5598,5598,0,0,0,5580,5580,-18,-18,0,0,12
1469,y1603,20151229,5580,5580,0,0,0,5580,5580,0,0,0,0,12
1470,y1603,20151230,5580,5580,5696,5700,5696,5700,5698,120,118,4,227920,12
1471,y1603,20151231,5700,5698,0,0,0,5698,5698,0,0,0,0,12
1472,y1605,20150518,5954,5954,6052,6056,5950,6016,5992,62,38,3264,195588080,1892
1473,y1605,20150519,6016,5992,6000,6002,5922,5926,5958,-66,-34,3812,227192280,3972
1474,y1605,20150520,5926,5958,5902,5902,5776,5824,5834,-134,-124,3450,201288200,5086
1475,y1605,20150521,5824,5834,5846,5872,5824,5850,5846,16,12,2054,120098920,6366
1476,y1605,20150522,5850,5846,5882,5908,5840,5870,5870,24,24,1498,87954560,6526
1477,y1605,20150525,5870,5870,5828,5854,5794,5830,5816,-40,-54,1302,75747680,6848
1478,y1605,20150526,5830,5816,5816,5990,5816,5924,5914,108,98,4470,264371680,7794
1479,y1605,20150527,5924,5914,5914,5978,5912,5930,5944,16,30,4528,269183120,9482
1480,y1605,20150528,5930,5944,5928,5988,5904,5942,5944,-2,0,6564,390260000,12690
1481,y1605,20150529,5942,5944,5956,5964,5912,5912,5938,-32,-6,2028,120450280,13368
1482,y1605,20150601,5912,5938,5924,6110,5924,6066,6054,128,116,21330,1291327040,26034
1483,y1605,20150602,6066,6054,6090,6202,6080,6140,6162,86,108,17208,1060410720,32630
1484,y1605,20150603,6140,6162,6148,6212,6088,6092,6142,-70,-20,12598,773770960,34018
1485,y1605,20150604,6092,6142,6092,6144,6038,6094,6098,-48,-44,17992,1097315360,36432
1486,y1605,20150605,6094,6098,6120,6122,6024,6092,6068,-6,-30,9640,584970400,37606
1487,y1605,20150608,6092,6068,6098,6140,6038,6058,6080,-10,12,7020,426912200,39232
1488,y1605,20150609,6058,6080,6036,6110,5952,5982,6000,-98,-80,10062,603724480,40296
1489,y1605,20150610,5982,6000,6002,6066,5954,5998,5990,-2,-10,6962,417041720,40416
1490,y1605,20150611,5998,5990,6010,6050,5986,6030,6016,40,26,7774,467781160,41274
1491,y1605,20150612,6030,6016,6038,6038,5896,5898,5934,-118,-82,8816,523231280,42284
1492,y1605,20150615,5898,5934,5928,5944,5854,5892,5894,-42,-40,8388,494549440,44936
1493,y1605,20150616,5892,5894,5894,5982,5854,5982,5938,88,44,10918,648487200,47964
1494,y1605,20150617,5982,5938,5982,6016,5932,5988,5968,50,30,13016,776914960,48964
1495,y1605,20150618,5988,5968,5990,6028,5918,5930,5954,-38,-14,10072,599864480,46790
1496,y1605,20150619,5930,5954,5920,5940,5878,5926,5912,-28,-42,5704,337233720,46728
1497,y1605,20150623,5926,5912,5980,6000,5922,5936,5958,24,46,2784,165875680,47120
1498,y1605,20150624,5936,5958,5920,5970,5896,5948,5930,-10,-28,5930,351693000,48430
1499,y1605,20150625,5948,5930,5956,6010,5938,5944,5972,14,42,5882,351321960,48902
1500,y1605,20150626,5944,5972,5980,5988,5858,5912,5938,-60,-34,10466,621625480,48906
1501,y1605,20150629,5912,5938,5978,5978,5850,5874,5904,-64,-34,10288,607411520,48292
1502,y1605,20150630,5874,5904,5916,5916,5756,5800,5816,-104,-88,17070,993117160,47194
1503,y1605,20150701,5800,5816,5800,6000,5782,5938,5904,122,88,9126,538870600,46054
1504,y1605,20150702,5938,5904,5936,5940,5848,5892,5876,-12,-28,5608,329531480,46668
1505,y1605,20150703,5892,5876,5896,5940,5858,5910,5912,34,36,5504,325421280,47186
1506,y1605,20150706,5910,5912,5908,5908,5720,5790,5814,-122,-98,10712,622827640,45698
1507,y1605,20150707,5790,5814,5788,5838,5732,5762,5782,-52,-32,5702,329709320,45780
1508,y1605,20150708,5762,5782,5740,5740,5552,5552,5592,-230,-190,10898,609554320,44630
1509,y1605,20150709,5552,5592,5258,5682,5258,5602,5450,10,-142,27988,1525566880,44250
1510,y1605,20150710,5602,5450,5640,5668,5630,5668,5656,218,206,10884,615803640,44440
1511,y1605,20150713,5668,5656,5748,5780,5614,5676,5696,20,40,25302,1441353120,52900
1512,y1605,20150714,5676,5696,5670,5806,5640,5766,5752,70,56,13860,797458360,55820
1513,y1605,20150715,5766,5752,5760,5798,5702,5724,5750,-28,-2,11594,666735160,57314
1514,y1605,20150716,5724,5750,5722,5722,5636,5684,5680,-66,-70,11800,670299200,60484
1515,y1605,20150717,5684,5680,5712,5730,5622,5662,5664,-18,-16,8606,487491440,61226
1516,y1605,20150720,5662,5664,5632,5690,5608,5684,5652,20,-12,9100,514446720,61686
1517,y1605,20150721,5684,5652,5684,5724,5672,5718,5698,66,46,12894,734887240,65502
1518,y1605,20150722,5718,5698,5726,5746,5686,5712,5716,14,18,7240,413950400,66596
1519,y1605,20150723,5712,5716,5690,5690,5630,5640,5658,-76,-58,12200,690361720,69538
1520,y1605,20150724,5640,5658,5656,5674,5590,5614,5628,-44,-30,17358,977007920,69568
1521,y1605,20150727,5614,5628,5600,5620,5502,5522,5552,-106,-76,16094,893635400,71222
1522,y1605,20150728,5522,5552,5418,5524,5418,5502,5492,-50,-60,18196,999472240,76446
1523,y1605,20150729,5502,5492,5516,5560,5508,5530,5530,38,38,19626,1085385880,78332
1524,y1605,20150730,5530,5530,5518,5548,5498,5516,5516,-14,-14,16390,904282480,82290
1525,y1605,20150731,5516,5516,5546,5562,5504,5510,5530,-6,14,10250,566969680,80950
1526,y1605,20150803,5510,5530,5500,5526,5424,5444,5466,-86,-64,18714,1023173040,76436
1527,y1605,20150804,5444,5466,5428,5488,5408,5476,5454,10,-12,17078,931669280,74250
1528,y1605,20150805,5476,5454,5500,5532,5488,5518,5508,64,54,21650,1192862400,78048
1529,y1605,20150806,5518,5508,5516,5518,5454,5458,5480,-50,-28,21306,1167832600,78280
1530,y1605,20150807,5458,5480,5466,5528,5426,5520,5474,40,-6,26482,1450137720,78618
1531,y1605,20150810,5520,5474,5500,5612,5490,5546,5542,72,68,37200,2062203600,86240
1532,y1605,20150811,5546,5542,5544,5696,5544,5648,5630,106,88,56458,3178869160,86346
1533,y1605,20150812,5648,5630,5620,5702,5606,5702,5648,72,18,40946,2313447960,92064
1534,y1605,20150813,5702,5648,5728,5776,5516,5656,5648,8,0,64366,3636061120,91174
1535,y1605,20150814,5656,5648,5622,5668,5582,5586,5622,-62,-26,33508,1884174760,92952
1536,y1605,20150817,5586,5622,5574,5644,5572,5634,5608,12,-14,27908,1565105960,96072
1537,y1605,20150818,5634,5608,5654,5676,5576,5598,5626,-10,18,27862,1567800720,96524
1538,y1605,20150819,5598,5626,5576,5608,5542,5600,5574,-26,-52,37980,2117056320,100968
1539,y1605,20150820,5600,5574,5600,5630,5540,5552,5570,-22,-4,37162,2070206000,101656
1540,y1605,20150821,5552,5570,5572,5646,5558,5608,5604,38,34,54410,3050089720,101110
1541,y1605,20150824,5608,5604,5586,5608,5380,5380,5450,-224,-154,65914,3593226880,101472
1542,y1605,20150825,5380,5450,5258,5418,5232,5234,5328,-216,-122,85120,4535916360,102522
1543,y1605,20150826,5234,5328,5352,5388,5272,5292,5330,-36,2,67298,3587301760,101656
1544,y1605,20150827,5292,5330,5296,5356,5280,5350,5318,20,-12,44900,2388486800,104854
1545,y1605,20150828,5350,5318,5388,5480,5360,5420,5418,102,100,69302,3755218640,116294
1546,y1605,20150831,5420,5418,5428,5434,5366,5368,5390,-50,-28,61154,3296806720,121844
1547,y1605,20150901,5368,5390,5340,5400,5330,5378,5366,-12,-24,48216,2587717240,120004
1548,y1605,20150902,5378,5366,5366,5374,5304,5334,5340,-32,-26,43290,2311717280,125386
1549,y1605,20150907,5334,5340,5306,5330,5276,5298,5302,-42,-38,21094,1118735760,129176
1550,y1605,20150908,5298,5302,5316,5370,5308,5362,5334,60,32,43868,2340486400,136690
1551,y1605,20150909,5362,5334,5390,5400,5356,5360,5378,26,44,63470,3414489840,145066
1552,y1605,20150910,5360,5378,5368,5390,5310,5382,5344,4,-34,97746,5223823520,165564
1553,y1605,20150911,5382,5344,5330,5396,5330,5360,5374,16,30,85374,4589004560,169752
1554,y1605,20150914,5360,5374,5348,5366,5266,5354,5338,-20,-36,81256,4338887120,171994
1555,y1605,20150915,5354,5338,5372,5402,5318,5324,5370,-14,32,92532,4969505520,184434
1556,y1605,20150916,5324,5370,5318,5332,5288,5330,5314,-40,-56,91740,4875682120,185300
1557,y1605,20150917,5330,5314,5338,5346,5304,5304,5324,-10,10,65362,3480063040,186006
1558,y1605,20150918,5304,5324,5292,5332,5288,5296,5308,-28,-16,86828,4609952640,189606
1559,y1605,20150921,5296,5308,5278,5302,5250,5298,5274,-10,-34,73960,3901137000,190454
1560,y1605,20150922,5298,5274,5306,5314,5252,5262,5278,-12,4,92062,4859611440,197534
1561,y1605,20150923,5262,5278,5242,5274,5226,5246,5248,-32,-30,71204,3738020520,209416
1562,y1605,20150924,5246,5248,5270,5280,5232,5272,5256,24,8,81442,4281697080,213468
1563,y1605,20150925,5272,5256,5254,5352,5248,5330,5310,74,54,134454,7141421440,201190
1564,y1605,20150928,5330,5310,5394,5394,5350,5362,5362,52,52,50104,2687315160,192522
1565,y1605,20150929,5362,5362,5370,5378,5270,5300,5312,-62,-50,81080,4308029200,189432
1566,y1605,20150930,5300,5312,5336,5352,5308,5332,5332,20,20,63734,3399170400,182768
1567,y1605,20151008,5332,5332,5394,5450,5364,5372,5394,40,62,47740,2575238000,182760
1568,y1605,20151009,5372,5394,5380,5462,5368,5432,5420,38,26,88428,4793176960,189624
1569,y1605,20151012,5432,5420,5448,5552,5402,5528,5494,108,74,127190,6990056200,186924
1570,y1605,20151013,5528,5494,5510,5566,5470,5550,5520,56,26,114644,6328810280,203432
1571,y1605,20151014,5550,5520,5566,5578,5532,5544,5554,24,34,101064,5614185720,214916
1572,y1605,20151015,5544,5554,5580,5592,5534,5550,5556,-4,2,94050,5226077360,224322
1573,y1605,20151016,5550,5556,5530,5544,5484,5522,5510,-34,-46,125672,6926101600,242920
1574,y1605,20151019,5522,5510,5508,5528,5478,5480,5504,-30,-6,68758,3784723000,241104
1575,y1605,20151020,5480,5504,5460,5484,5422,5446,5448,-58,-56,82680,4505753120,244690
1576,y1605,20151021,5446,5448,5446,5496,5446,5464,5472,16,24,83440,4567458600,255088
1577,y1605,20151022,5464,5472,5488,5542,5464,5540,5510,68,38,117676,6484461680,255932
1578,y1605,20151023,5540,5510,5540,5548,5442,5476,5490,-34,-20,131514,7220528920,261684
1579,y1605,20151026,5476,5490,5496,5496,5410,5420,5442,-70,-48,108072,5882701840,265638
1580,y1605,20151027,5420,5442,5416,5438,5362,5434,5400,-8,-42,119764,6468123000,261958
1581,y1605,20151028,5434,5400,5438,5440,5380,5396,5404,-4,4,80256,4337837640,260672
1582,y1605,20151029,5396,5404,5438,5462,5394,5408,5424,4,20,85008,4612129240,264748
1583,y1605,20151030,5408,5424,5418,5428,5388,5402,5406,-22,-18,57186,3092111200,270882
1584,y1605,20151102,5402,5406,5406,5442,5376,5428,5414,22,8,74750,4048047160,270848
1585,y1605,20151103,5428,5414,5408,5424,5370,5378,5394,-36,-20,95694,5162932040,272676
1586,y1605,20151104,5378,5394,5378,5472,5366,5466,5422,72,28,156178,8469866760,267516
1587,y1605,20151105,5466,5422,5468,5520,5458,5478,5486,56,64,204966,11245139480,288262
1588,y1605,20151106,5478,5486,5480,5480,5380,5418,5426,-68,-60,211066,11456070200,320564
1589,y1605,20151109,5418,5426,5420,5452,5384,5440,5422,14,-4,176508,9571376840,342680
1590,y1605,20151110,5440,5422,5460,5470,5406,5442,5434,20,12,163268,8873538000,346660
1591,y1605,20151111,5442,5434,5438,5440,5334,5344,5376,-90,-58,290912,15643533720,365570
1592,y1605,20151112,5344,5376,5342,5362,5320,5340,5340,-36,-36,157282,8400354240,370430
1593,y1605,20151113,5340,5340,5322,5374,5304,5344,5338,4,-2,164938,8805358240,371442
1594,y1605,20151116,5344,5338,5336,5350,5286,5296,5312,-42,-26,226974,12056985440,408450
1595,y1605,20151117,5296,5312,5298,5344,5272,5330,5312,18,0,247546,13150367200,428122
1596,y1605,20151118,5330,5312,5314,5350,5290,5306,5320,-6,8,235736,12541308280,440536
1597,y1605,20151119,5306,5320,5330,5334,5262,5276,5296,-44,-24,358990,19017003880,436052
1598,y1605,20151120,5276,5296,5276,5358,5232,5356,5298,60,2,370704,19645614680,424154
1599,y1605,20151123,5356,5298,5336,5408,5328,5356,5368,58,70,489520,26277911480,443160
1600,y1605,20151124,5356,5368,5372,5564,5336,5546,5460,178,92,731302,39942763040,528710
1601,y1605,20151125,5546,5460,5536,5570,5504,5556,5534,96,74,603674,33419268440,564290
1602,y1605,20151126,5556,5534,5546,5684,5528,5612,5616,78,82,952952,53524081120,599154
1603,y1605,20151127,5612,5616,5610,5646,5596,5646,5618,30,2,724254,40695782240,599312
1604,y1605,20151130,5646,5618,5630,5644,5540,5588,5592,-30,-26,752794,42101543360,554086
1605,y1605,20151201,5588,5592,5598,5726,5592,5648,5672,56,80,1188834,67440655520,617390
1606,y1605,20151202,5648,5672,5660,5752,5636,5692,5688,20,16,914098,52000609400,638210
1607,y1605,20151203,5692,5688,5692,5738,5626,5680,5668,-8,-20,1040224,58974349760,640340
1608,y1605,20151204,5680,5668,5696,5728,5666,5676,5692,8,24,1061238,60426613080,658804
1609,y1605,20151207,5676,5692,5688,5848,5648,5766,5742,74,50,1020818,58625054560,655204
1610,y1605,20151208,5766,5742,5772,5780,5626,5656,5692,-86,-50,974540,55475660560,631572
1611,y1605,20151209,5656,5692,5640,5646,5554,5576,5608,-116,-84,1013716,56865737360,639196
1612,y1605,20151210,5576,5608,5578,5606,5538,5562,5572,-46,-36,878730,48976397240,614462
1613,y1605,20151211,5562,5572,5558,5594,5512,5588,5556,16,-16,983776,54667054440,606786
1614,y1605,20151214,5588,5556,5588,5622,5516,5578,5576,22,20,981652,54743203840,604320
1615,y1605,20151215,5578,5576,5540,5632,5522,5564,5586,-12,10,965874,53971236240,609176
1616,y1605,20151216,5564,5586,5562,5588,5524,5550,5554,-36,-32,816432,45351123240,601570
1617,y1605,20151217,5550,5554,5538,5588,5498,5512,5546,-42,-8,942942,52303028240,624354
1618,y1605,20151218,5512,5546,5520,5542,5474,5534,5514,-12,-32,811840,44767255360,607824
1619,y1605,20151221,5534,5514,5552,5622,5530,5620,5574,106,60,825378,46017580720,624642
1620,y1605,20151222,5620,5574,5614,5656,5598,5630,5626,56,52,708270,39857597640,634094
1621,y1605,20151223,5630,5626,5636,5648,5582,5624,5612,-2,-14,595254,33408780840,609306
1622,y1605,20151224,5624,5612,5636,5674,5612,5622,5638,10,26,633484,35716415480,588942
1623,y1605,20151225,5622,5638,5620,5648,5612,5640,5628,2,-10,377530,21249501280,571906
1624,y1605,20151228,5640,5628,5628,5654,5576,5584,5614,-44,-14,434798,24410395240,558348
1625,y1605,20151229,5584,5614,5562,5662,5548,5658,5586,44,-28,628456,35107808280,554354
1626,y1605,20151230,5658,5586,5646,5730,5640,5718,5690,132,104,1132472,64458932240,603926
1627,y1605,20151231,5718,5690,5702,5732,5686,5724,5706,34,16,640058,36530130600,616008
1628,y1607,20150715,5696,5696,5696,5696,5696,5696,5696,0,0,2,113920,2
1629,y1607,20150716,5696,5696,5696,5696,5696,5696,5696,0,0,2,113920,0
1630,y1607,20150717,5696,5696,0,0,0,5680,5680,-16,-16,0,0,0
1631,y1607,20150720,5680,5680,0,0,0,5668,5668,-12,-12,0,0,0
1632,y1607,20150721,5668,5668,0,0,0,5714,5714,46,46,0,0,0
1633,y1607,20150722,5714,5714,0,0,0,5732,5732,18,18,0,0,0
1634,y1607,20150723,5732,5732,0,0,0,5674,5674,-58,-58,0,0,0
1635,y1607,20150724,5674,5674,0,0,0,5644,5644,-30,-30,0,0,0
1636,y1607,20150727,5644,5644,0,0,0,5606,5606,-38,-38,0,0,0
1637,y1607,20150728,5606,5606,0,0,0,5546,5546,-60,-60,0,0,0
1638,y1607,20150729,5546,5546,0,0,0,5584,5584,38,38,0,0,0
1639,y1607,20150730,5584,5584,0,0,0,5570,5570,-14,-14,0,0,0
1640,y1607,20150731,5570,5570,0,0,0,5584,5584,14,14,0,0,0
1641,y1607,20150803,5584,5584,0,0,0,5520,5520,-64,-64,0,0,0
1642,y1607,20150804,5520,5520,0,0,0,5508,5508,-12,-12,0,0,0
1643,y1607,20150805,5508,5508,0,0,0,5562,5562,54,54,0,0,0
1644,y1607,20150806,5562,5562,0,0,0,5534,5534,-28,-28,0,0,0
1645,y1607,20150807,5534,5534,0,0,0,5528,5528,-6,-6,0,0,0
1646,y1607,20150810,5528,5528,0,0,0,5532,5532,4,4,0,0,0
1647,y1607,20150811,5532,5532,0,0,0,5618,5618,86,86,0,0,0
1648,y1607,20150812,5618,5618,0,0,0,5634,5634,16,16,0,0,0
1649,y1607,20150813,5634,5634,5808,5812,5610,5640,5726,6,92,12,687320,2
1650,y1607,20150814,5640,5726,5698,5698,5698,5698,5698,-28,-28,2,113960,2
1651,y1607,20150817,5698,5698,0,0,0,5684,5684,-14,-14,0,0,2
1652,y1607,20150818,5684,5684,5666,5666,5666,5666,5666,-18,-18,4,226640,6
1653,y1607,20150819,5666,5666,0,0,0,5614,5614,-52,-52,0,0,6
1654,y1607,20150820,5614,5614,0,0,0,5610,5610,-4,-4,0,0,6
1655,y1607,20150821,5610,5610,0,0,0,5610,5610,0,0,0,0,6
1656,y1607,20150824,5610,5610,5590,5590,5444,5444,5544,-166,-66,8,443520,10
1657,y1607,20150825,5444,5544,0,0,0,5420,5420,-124,-124,0,0,10
1658,y1607,20150826,5420,5420,5416,5416,5416,5416,5416,-4,-4,2,108320,10
1659,y1607,20150827,5416,5416,0,0,0,5404,5404,-12,-12,0,0,10
1660,y1607,20150828,5404,5404,0,0,0,5504,5504,100,100,0,0,10
1661,y1607,20150831,5504,5504,0,0,0,5476,5476,-28,-28,0,0,10
1662,y1607,20150901,5476,5476,5382,5424,5376,5424,5394,-52,-82,12,647360,6
1663,y1607,20150902,5424,5394,5406,5406,5406,5406,5406,12,12,2,108120,4
1664,y1607,20150907,5406,5406,0,0,0,5368,5368,-38,-38,0,0,4
1665,y1607,20150908,5368,5368,0,0,0,5400,5400,32,32,0,0,4
1666,y1607,20150909,5400,5400,0,0,0,5444,5444,44,44,0,0,4
1667,y1607,20150910,5444,5444,0,0,0,5410,5410,-34,-34,0,0,4
1668,y1607,20150911,5410,5410,5476,5480,5432,5480,5456,70,46,22,1200400,8
1669,y1607,20150914,5480,5456,0,0,0,5420,5420,-36,-36,0,0,8
1670,y1607,20150915,5420,5420,0,0,0,5420,5420,0,0,0,0,8
1671,y1607,20150916,5420,5420,0,0,0,5364,5364,-56,-56,0,0,8
1672,y1607,20150917,5364,5364,0,0,0,5374,5374,10,10,0,0,8
1673,y1607,20150918,5374,5374,0,0,0,5358,5358,-16,-16,0,0,8
1674,y1607,20150921,5358,5358,5398,5398,5308,5308,5352,-50,-6,4,214120,6
1675,y1607,20150922,5308,5352,0,0,0,5356,5356,4,4,0,0,6
1676,y1607,20150923,5356,5356,0,0,0,5326,5326,-30,-30,0,0,6
1677,y1607,20150924,5326,5326,0,0,0,5334,5334,8,8,0,0,6
1678,y1607,20150925,5334,5334,0,0,0,5334,5334,0,0,0,0,6
1679,y1607,20150928,5334,5334,0,0,0,5386,5386,52,52,0,0,6
1680,y1607,20150929,5386,5386,5342,5342,5342,5342,5342,-44,-44,2,106840,4
1681,y1607,20150930,5342,5342,0,0,0,5362,5362,20,20,0,0,4
1682,y1607,20151008,5362,5362,0,0,0,5424,5424,62,62,0,0,4
1683,y1607,20151009,5424,5424,0,0,0,5424,5424,0,0,0,0,4
1684,y1607,20151012,5424,5424,5472,5596,5472,5574,5530,150,106,8,442440,4
1685,y1607,20151013,5574,5530,0,0,0,5540,5540,10,10,0,0,4
1686,y1607,20151014,5540,5540,5554,5692,5554,5692,5622,152,82,8,449840,4
1687,y1607,20151015,5692,5622,5630,5630,5568,5568,5598,-54,-24,4,223960,2
1688,y1607,20151016,5568,5598,0,0,0,5552,5552,-46,-46,0,0,2
1689,y1607,20151019,5552,5552,5576,5576,5532,5532,5554,-20,2,6,333320,0
1690,y1607,20151020,5532,5554,0,0,0,5498,5498,-56,-56,0,0,0
1691,y1607,20151021,5498,5498,0,0,0,5522,5522,24,24,0,0,0
1692,y1607,20151022,5522,5522,0,0,0,5560,5560,38,38,0,0,0
1693,y1607,20151023,5560,5560,0,0,0,5540,5540,-20,-20,0,0,0
1694,y1607,20151026,5540,5540,0,0,0,5492,5492,-48,-48,0,0,0
1695,y1607,20151027,5492,5492,0,0,0,5450,5450,-42,-42,0,0,0
1696,y1607,20151028,5450,5450,0,0,0,5454,5454,4,4,0,0,0
1697,y1607,20151029,5454,5454,0,0,0,5474,5474,20,20,0,0,0
1698,y1607,20151030,5474,5474,0,0,0,5456,5456,-18,-18,0,0,0
1699,y1607,20151102,5456,5456,0,0,0,5464,5464,8,8,0,0,0
1700,y1607,20151103,5464,5464,0,0,0,5444,5444,-20,-20,0,0,0
1701,y1607,20151104,5444,5444,0,0,0,5472,5472,28,28,0,0,0
1702,y1607,20151105,5472,5472,0,0,0,5536,5536,64,64,0,0,0
1703,y1607,20151106,5536,5536,0,0,0,5476,5476,-60,-60,0,0,0
1704,y1607,20151109,5476,5476,0,0,0,5476,5476,0,0,0,0,0
1705,y1607,20151110,5476,5476,0,0,0,5488,5488,12,12,0,0,0
1706,y1607,20151111,5488,5488,0,0,0,5430,5430,-58,-58,0,0,0
1707,y1607,20151112,5430,5430,0,0,0,5394,5394,-36,-36,0,0,0
1708,y1607,20151113,5394,5394,0,0,0,5392,5392,-2,-2,0,0,0
1709,y1607,20151116,5392,5392,0,0,0,5366,5366,-26,-26,0,0,0
1710,y1607,20151117,5366,5366,0,0,0,5366,5366,0,0,0,0,0
1711,y1607,20151118,5366,5366,0,0,0,5374,5374,8,8,0,0,0
1712,y1607,20151119,5374,5374,0,0,0,5350,5350,-24,-24,0,0,0
1713,y1607,20151120,5350,5350,5260,5308,5260,5288,5276,-62,-74,16,844240,0
1714,y1607,20151123,5288,5276,0,0,0,5344,5344,68,68,0,0,0
1715,y1607,20151124,5344,5344,0,0,0,5434,5434,90,90,0,0,0
1716,y1607,20151125,5434,5434,0,0,0,5506,5506,72,72,0,0,0
1717,y1607,20151126,5506,5506,0,0,0,5586,5586,80,80,0,0,0
1718,y1607,20151127,5586,5586,0,0,0,5586,5586,0,0,0,0,0
1719,y1607,20151130,5586,5586,0,0,0,5562,5562,-24,-24,0,0,0
1720,y1607,20151201,5562,5562,0,0,0,5640,5640,78,78,0,0,0
1721,y1607,20151202,5640,5640,0,0,0,5654,5654,14,14,0,0,0
1722,y1607,20151203,5654,5654,0,0,0,5636,5636,-18,-18,0,0,0
1723,y1607,20151204,5636,5636,0,0,0,5658,5658,22,22,0,0,0
1724,y1607,20151207,5658,5658,0,0,0,5706,5706,48,48,0,0,0
1725,y1607,20151208,5706,5706,0,0,0,5658,5658,-48,-48,0,0,0
1726,y1607,20151209,5658,5658,0,0,0,5576,5576,-82,-82,0,0,0
1727,y1607,20151210,5576,5576,5458,5660,5360,5592,5556,16,-20,14,778040,0
1728,y1607,20151211,5592,5556,5566,5620,5566,5620,5592,64,36,4,223720,0
1729,y1607,20151214,5620,5592,5598,5598,5530,5530,5564,-62,-28,4,222560,0
1730,y1607,20151215,5530,5564,0,0,0,5572,5572,8,8,0,0,0
1731,y1607,20151216,5572,5572,0,0,0,5542,5542,-30,-30,0,0,0
1732,y1607,20151217,5542,5542,0,0,0,5536,5536,-6,-6,0,0,0
1733,y1607,20151218,5536,5536,0,0,0,5506,5506,-30,-30,0,0,0
1734,y1607,20151221,5506,5506,0,0,0,5564,5564,58,58,0,0,0
1735,y1607,20151222,5564,5564,5784,5784,5562,5658,5620,94,56,38,2135760,2
1736,y1607,20151223,5658,5620,0,0,0,5608,5608,-12,-12,0,0,2
1737,y1607,20151224,5608,5608,0,0,0,5632,5632,24,24,0,0,2
1738,y1607,20151225,5632,5632,5660,5660,5660,5660,5660,28,28,2,113200,0
1739,y1607,20151228,5660,5660,0,0,0,5646,5646,-14,-14,0,0,0
1740,y1607,20151229,5646,5646,0,0,0,5618,5618,-28,-28,0,0,0
1741,y1607,20151230,5618,5618,0,0,0,5722,5722,104,104,0,0,0
1742,y1607,20151231,5722,5722,0,0,0,5738,5738,16,16,0,0,0
1743,y1608,20150817,5648,5648,0,0,0,5634,5634,-14,-14,0,0,0
1744,y1608,20150818,5634,5634,0,0,0,5618,5618,-16,-16,0,0,0
1745,y1608,20150819,5618,5618,0,0,0,5568,5568,-50,-50,0,0,0
1746,y1608,20150820,5568,5568,5780,5780,5652,5652,5716,84,148,4,228640,0
1747,y1608,20150821,5652,5716,0,0,0,5750,5750,34,34,0,0,0
1748,y1608,20150824,5750,5750,0,0,0,5684,5684,-66,-66,0,0,0
1749,y1608,20150825,5684,5684,0,0,0,5558,5558,-126,-126,0,0,0
1750,y1608,20150826,5558,5558,0,0,0,5554,5554,-4,-4,0,0,0
1751,y1608,20150827,5554,5554,0,0,0,5542,5542,-12,-12,0,0,0
1752,y1608,20150828,5542,5542,0,0,0,5646,5646,104,104,0,0,0
1753,y1608,20150831,5646,5646,0,0,0,5618,5618,-28,-28,0,0,0
1754,y1608,20150901,5618,5618,0,0,0,5534,5534,-84,-84,0,0,0
1755,y1608,20150902,5534,5534,0,0,0,5546,5546,12,12,0,0,0
1756,y1608,20150907,5546,5546,5330,5400,5330,5400,5364,-146,-182,40,2146000,0
1757,y1608,20150908,5400,5364,5554,5554,5554,5554,5554,190,190,2,111080,2
1758,y1608,20150909,5554,5554,0,0,0,5598,5598,44,44,0,0,2
1759,y1608,20150910,5598,5598,0,0,0,5564,5564,-34,-34,0,0,2
1760,y1608,20150911,5564,5564,5622,5622,5622,5622,5622,58,58,2,112440,4
1761,y1608,20150914,5622,5622,0,0,0,5586,5586,-36,-36,0,0,4
1762,y1608,20150915,5586,5586,5476,5476,5476,5476,5476,-110,-110,2,109520,2
1763,y1608,20150916,5476,5476,0,0,0,5420,5420,-56,-56,0,0,2
1764,y1608,20150917,5420,5420,0,0,0,5430,5430,10,10,0,0,2
1765,y1608,20150918,5430,5430,0,0,0,5414,5414,-16,-16,0,0,2
1766,y1608,20150921,5414,5414,5350,5350,5350,5350,5350,-64,-64,2,107000,2
1767,y1608,20150922,5350,5350,0,0,0,5354,5354,4,4,0,0,2
1768,y1608,20150923,5354,5354,0,0,0,5354,5354,0,0,0,0,2
1769,y1608,20150924,5354,5354,0,0,0,5362,5362,8,8,0,0,2
1770,y1608,20150925,5362,5362,0,0,0,5362,5362,0,0,0,0,2
1771,y1608,20150928,5362,5362,0,0,0,5414,5414,52,52,0,0,2
1772,y1608,20150929,5414,5414,0,0,0,5370,5370,-44,-44,0,0,2
1773,y1608,20150930,5370,5370,0,0,0,5390,5390,20,20,0,0,2
1774,y1608,20151008,5390,5390,0,0,0,5452,5452,62,62,0,0,2
1775,y1608,20151009,5452,5452,0,0,0,5478,5478,26,26,0,0,2
1776,y1608,20151012,5478,5478,0,0,0,5478,5478,0,0,0,0,2
1777,y1608,20151013,5478,5478,5514,5520,5512,5520,5514,42,36,6,330920,4
1778,y1608,20151014,5520,5514,0,0,0,5594,5594,80,80,0,0,4
1779,y1608,20151015,5594,5594,5556,5556,5556,5556,5556,-38,-38,2,111120,4
1780,y1608,20151016,5556,5556,0,0,0,5512,5512,-44,-44,0,0,4
1781,y1608,20151019,5512,5512,0,0,0,5512,5512,0,0,0,0,4
1782,y1608,20151020,5512,5512,0,0,0,5456,5456,-56,-56,0,0,4
1783,y1608,20151021,5456,5456,0,0,0,5480,5480,24,24,0,0,4
1784,y1608,20151022,5480,5480,0,0,0,5518,5518,38,38,0,0,4
1785,y1608,20151023,5518,5518,0,0,0,5498,5498,-20,-20,0,0,4
1786,y1608,20151026,5498,5498,0,0,0,5450,5450,-48,-48,0,0,4
1787,y1608,20151027,5450,5450,0,0,0,5408,5408,-42,-42,0,0,4
1788,y1608,20151028,5408,5408,0,0,0,5412,5412,4,4,0,0,4
1789,y1608,20151029,5412,5412,0,0,0,5432,5432,20,20,0,0,4
1790,y1608,20151030,5432,5432,0,0,0,5414,5414,-18,-18,0,0,4
1791,y1608,20151102,5414,5414,0,0,0,5422,5422,8,8,0,0,4
1792,y1608,20151103,5422,5422,0,0,0,5402,5402,-20,-20,0,0,4
1793,y1608,20151104,5402,5402,0,0,0,5430,5430,28,28,0,0,4
1794,y1608,20151105,5430,5430,5458,5458,5458,5458,5458,28,28,2,109160,6
1795,y1608,20151106,5458,5458,0,0,0,5400,5400,-58,-58,0,0,6
1796,y1608,20151109,5400,5400,0,0,0,5398,5398,-2,-2,0,0,6
1797,y1608,20151110,5398,5398,5420,5420,5370,5370,5394,-28,-4,8,431600,4
1798,y1608,20151111,5370,5394,0,0,0,5338,5338,-56,-56,0,0,4
1799,y1608,20151112,5338,5338,0,0,0,5304,5304,-34,-34,0,0,4
1800,y1608,20151113,5304,5304,0,0,0,5304,5304,0,0,0,0,4
1801,y1608,20151116,5304,5304,0,0,0,5280,5280,-24,-24,0,0,4
1802,y1608,20151117,5280,5280,0,0,0,5280,5280,0,0,0,0,4
1803,y1608,20151118,5280,5280,0,0,0,5286,5286,6,6,0,0,4
1804,y1608,20151119,5286,5286,0,0,0,5264,5264,-22,-22,0,0,4
1805,y1608,20151120,5264,5264,0,0,0,5192,5192,-72,-72,0,0,4
1806,y1608,20151123,5192,5192,0,0,0,5260,5260,68,68,0,0,4
1807,y1608,20151124,5260,5260,0,0,0,5350,5350,90,90,0,0,4
1808,y1608,20151125,5350,5350,0,0,0,5422,5422,72,72,0,0,4
1809,y1608,20151126,5422,5422,0,0,0,5502,5502,80,80,0,0,4
1810,y1608,20151127,5502,5502,0,0,0,5502,5502,0,0,0,0,4
1811,y1608,20151130,5502,5502,0,0,0,5478,5478,-24,-24,0,0,4
1812,y1608,20151201,5478,5478,0,0,0,5556,5556,78,78,0,0,4
1813,y1608,20151202,5556,5556,0,0,0,5570,5570,14,14,0,0,4
1814,y1608,20151203,5570,5570,0,0,0,5552,5552,-18,-18,0,0,4
1815,y1608,20151204,5552,5552,0,0,0,5574,5574,22,22,0,0,4
1816,y1608,20151207,5574,5574,0,0,0,5622,5622,48,48,0,0,4
1817,y1608,20151208,5622,5622,0,0,0,5574,5574,-48,-48,0,0,4
1818,y1608,20151209,5574,5574,5616,5616,5562,5564,5586,-10,12,10,558640,4
1819,y1608,20151210,5564,5586,0,0,0,5566,5566,-20,-20,0,0,4
1820,y1608,20151211,5566,5566,0,0,0,5602,5602,36,36,0,0,4
1821,y1608,20151214,5602,5602,0,0,0,5574,5574,-28,-28,0,0,4
1822,y1608,20151215,5574,5574,0,0,0,5582,5582,8,8,0,0,4
1823,y1608,20151216,5582,5582,0,0,0,5552,5552,-30,-30,0,0,4
1824,y1608,20151217,5552,5552,5558,5558,5558,5558,5558,6,6,2,111160,4
1825,y1608,20151218,5558,5558,0,0,0,5526,5526,-32,-32,0,0,4
1826,y1608,20151221,5526,5526,5562,5562,5562,5562,5562,36,36,4,222480,4
1827,y1608,20151222,5562,5562,5616,5616,5616,5616,5616,54,54,2,112320,2
1828,y1608,20151223,5616,5616,5540,5608,5540,5608,5574,-8,-42,24,1337760,2
1829,y1608,20151224,5608,5574,0,0,0,5598,5598,24,24,0,0,2
1830,y1608,20151225,5598,5598,5570,5638,5570,5638,5604,40,6,16,896640,2
1831,y1608,20151228,5638,5604,0,0,0,5592,5592,-12,-12,0,0,2
1832,y1608,20151229,5592,5592,0,0,0,5566,5566,-26,-26,0,0,2
1833,y1608,20151230,5566,5566,5636,5788,5616,5728,5676,162,110,94,5336560,8
1834,y1608,20151231,5728,5676,5768,5768,5688,5688,5728,12,52,4,229120,8
1835,y1609,20150917,5370,5370,5366,5376,5304,5306,5340,-64,-30,9366,500227520,6960
1836,y1609,20150918,5306,5340,5304,5320,5266,5278,5290,-62,-50,6278,332166680,11216
1837,y1609,20150921,5278,5290,5268,5292,5234,5286,5258,-4,-32,3442,181020680,11508
1838,y1609,20150922,5286,5258,5294,5300,5246,5258,5270,0,12,3174,167301280,12376
1839,y1609,20150923,5258,5270,5252,5270,5232,5262,5246,-8,-24,7170,376159720,15582
1840,y1609,20150924,5262,5246,5278,5286,5240,5272,5266,26,20,4784,251931600,17856
1841,y1609,20150925,5272,5266,5240,5344,5240,5324,5316,58,50,7664,407423440,17464
1842,y1609,20150928,5324,5316,5340,5380,5340,5362,5360,46,44,3704,198604400,18074
1843,y1609,20150929,5362,5360,5372,5372,5276,5300,5314,-60,-46,5316,282545480,19408
1844,y1609,20150930,5300,5314,5328,5348,5312,5334,5330,20,16,4090,218004640,19470
1845,y1609,20151008,5334,5330,5420,5438,5370,5382,5394,52,64,4332,233742240,18702
1846,y1609,20151009,5382,5394,5380,5462,5376,5436,5418,42,24,7176,388917880,19276
1847,y1609,20151012,5436,5418,5442,5552,5412,5540,5506,122,88,8126,447498200,21926
1848,y1609,20151013,5540,5506,5488,5570,5474,5550,5522,44,16,10900,602090440,25904
1849,y1609,20151014,5550,5522,5550,5572,5532,5538,5552,16,30,6108,339134840,27458
1850,y1609,20151015,5538,5552,5576,5586,5532,5544,5550,-8,-2,7966,442225000,30202
1851,y1609,20151016,5544,5550,5542,5552,5482,5512,5504,-38,-46,7596,418234800,32150
1852,y1609,20151019,5512,5504,5502,5516,5468,5474,5492,-30,-12,7512,412701400,32412
1853,y1609,20151020,5474,5492,5460,5472,5426,5444,5448,-48,-44,10694,582636360,36572
1854,y1609,20151021,5444,5448,5454,5490,5446,5460,5470,12,22,5224,285759080,37452
1855,y1609,20151022,5460,5470,5450,5528,5450,5524,5498,54,28,6650,365672320,36776
1856,y1609,20151023,5524,5498,5530,5536,5434,5462,5468,-36,-30,9384,513151800,38554
1857,y1609,20151026,5462,5468,5486,5486,5402,5410,5432,-58,-36,10126,550180040,40372
1858,y1609,20151027,5410,5432,5410,5412,5352,5400,5378,-32,-54,15280,822049400,37636
1859,y1609,20151028,5400,5378,5404,5410,5348,5354,5366,-24,-12,18234,978696400,45026
1860,y1609,20151029,5354,5366,5380,5402,5354,5360,5374,-6,8,15636,840438320,46724
1861,y1609,20151030,5360,5374,5364,5378,5340,5352,5354,-22,-20,10090,540303240,48296
1862,y1609,20151102,5352,5354,5352,5384,5328,5368,5362,14,8,7842,420563600,48948
1863,y1609,20151103,5368,5362,5358,5368,5324,5328,5342,-34,-20,17460,932779560,56210
1864,y1609,20151104,5328,5342,5340,5388,5324,5386,5354,44,12,38828,2079463320,62882
1865,y1609,20151105,5386,5354,5400,5440,5380,5390,5404,36,50,31202,1686578080,55054
1866,y1609,20151106,5390,5404,5404,5404,5320,5354,5356,-50,-48,25140,1346725800,60574
1867,y1609,20151109,5354,5356,5354,5386,5314,5370,5356,14,0,31694,1697739000,70612
1868,y1609,20151110,5370,5356,5388,5400,5350,5372,5370,16,14,25558,1372542320,74888
1869,y1609,20151111,5372,5370,5370,5370,5292,5292,5326,-78,-44,36562,1947923640,90598
1870,y1609,20151112,5292,5326,5296,5312,5272,5290,5288,-36,-38,16280,861047880,92780
1871,y1609,20151113,5290,5288,5280,5316,5260,5290,5288,2,0,17448,922692000,93454
1872,y1609,20151116,5290,5288,5290,5304,5238,5248,5264,-40,-24,23930,1259908040,101064
1873,y1609,20151117,5248,5264,5252,5286,5224,5272,5262,8,-2,16766,882461200,100776
1874,y1609,20151118,5272,5262,5270,5292,5240,5256,5266,-6,4,15478,815113440,102392
1875,y1609,20151119,5256,5266,5260,5278,5216,5228,5244,-38,-22,24330,1276246440,105410
1876,y1609,20151120,5228,5244,5230,5306,5186,5302,5250,58,6,31298,1643277800,107524
1877,y1609,20151123,5302,5250,5286,5348,5280,5300,5316,50,66,41472,2204726640,106026
1878,y1609,20151124,5300,5316,5310,5500,5272,5488,5406,172,90,53738,2905324960,104576
1879,y1609,20151125,5488,5406,5470,5504,5438,5490,5464,84,58,44484,2431450720,96562
1880,y1609,20151126,5490,5464,5464,5600,5460,5534,5540,70,76,66930,3707922600,92624
1881,y1609,20151127,5534,5540,5540,5574,5526,5568,5544,28,4,40078,2222546560,95148
1882,y1609,20151130,5568,5544,5560,5572,5480,5526,5522,-18,-22,24134,1332932800,95954
1883,y1609,20151201,5526,5522,5528,5654,5528,5586,5604,64,82,36002,2018091440,95950
1884,y1609,20151202,5586,5604,5604,5682,5572,5628,5622,24,18,39590,2225800680,98334
1885,y1609,20151203,5628,5622,5610,5664,5562,5612,5600,-10,-22,38164,2137934480,96564
1886,y1609,20151204,5612,5600,5608,5658,5600,5612,5630,12,30,30688,1727748440,96138
1887,y1609,20151207,5612,5630,5624,5770,5588,5692,5690,62,60,51392,2925120160,101080
1888,y1609,20151208,5692,5690,5700,5708,5558,5594,5624,-96,-66,55242,3107581680,103384
1889,y1609,20151209,5594,5624,5568,5592,5512,5528,5560,-96,-64,60884,3385679760,115592
1890,y1609,20151210,5528,5560,5530,5564,5502,5522,5530,-38,-30,38694,2140282960,118868
1891,y1609,20151211,5522,5530,5530,5558,5480,5552,5528,22,-2,44942,2484990280,121252
1892,y1609,20151214,5552,5528,5584,5588,5490,5554,5546,26,18,42882,2378511040,124468
1893,y1609,20151215,5554,5546,5500,5598,5500,5536,5560,-10,14,59392,3303264160,120124
1894,y1609,20151216,5536,5560,5520,5552,5500,5522,5524,-38,-36,37296,2060662000,119762
1895,y1609,20151217,5522,5524,5498,5550,5470,5482,5516,-42,-8,48350,2667191360,118892
1896,y1609,20151218,5482,5516,5480,5538,5452,5536,5502,20,-14,55680,3064539120,131182
1897,y1609,20151221,5536,5502,5548,5618,5536,5614,5580,112,78,63292,3532118760,135178
1898,y1609,20151222,5614,5580,5600,5648,5590,5626,5620,46,40,52794,2968035120,142358
1899,y1609,20151223,5626,5620,5632,5644,5580,5618,5608,-2,-12,46306,2597606720,144056
1900,y1609,20151224,5618,5608,5624,5662,5604,5614,5628,6,20,49492,2785471880,148586
1901,y1609,20151225,5614,5628,5630,5636,5602,5628,5618,0,-10,20634,1159374520,150366
1902,y1609,20151228,5628,5618,5632,5640,5572,5578,5606,-40,-12,34548,1937121240,152112
1903,y1609,20151229,5578,5606,5566,5654,5542,5646,5582,40,-24,52810,2948493400,158340
1904,y1609,20151230,5646,5582,5632,5700,5630,5688,5672,106,90,95180,5399281080,171372
1905,y1609,20151231,5688,5672,5680,5692,5654,5688,5672,16,0,47394,2688868720,173430
1906,y1611,20151116,5288,5288,0,0,0,5288,5288,0,0,0,0,0
1907,y1611,20151117,5288,5288,0,0,0,5278,5278,-10,-10,0,0,0
1908,y1611,20151118,5278,5278,0,0,0,5282,5282,4,4,0,0,0
1909,y1611,20151119,5282,5282,0,0,0,5260,5260,-22,-22,0,0,0
1910,y1611,20151120,5260,5260,0,0,0,5266,5266,6,6,0,0,0
1911,y1611,20151123,5266,5266,0,0,0,5332,5332,66,66,0,0,0
1912,y1611,20151124,5332,5332,0,0,0,5422,5422,90,90,0,0,0
1913,y1611,20151125,5422,5422,5536,5536,5372,5372,5454,-50,32,4,218160,2
1914,y1611,20151126,5372,5454,0,0,0,5528,5528,74,74,0,0,2
1915,y1611,20151127,5528,5528,5616,5616,5616,5616,5616,88,88,8,449280,10
1916,y1611,20151130,5616,5616,0,0,0,5616,5616,0,0,0,0,10
1917,y1611,20151201,5616,5616,5620,5710,5620,5640,5634,24,18,14,789000,4
1918,y1611,20151202,5640,5634,0,0,0,5652,5652,18,18,0,0,4
1919,y1611,20151203,5652,5652,5732,5732,5600,5604,5642,-48,-10,8,451480,4
1920,y1611,20151204,5604,5642,0,0,0,5672,5672,30,30,0,0,4
1921,y1611,20151207,5672,5672,0,0,0,5732,5732,60,60,0,0,4
1922,y1611,20151208,5732,5732,0,0,0,5666,5666,-66,-66,0,0,4
1923,y1611,20151209,5666,5666,0,0,0,5602,5602,-64,-64,0,0,4
1924,y1611,20151210,5602,5602,0,0,0,5572,5572,-30,-30,0,0,4
1925,y1611,20151211,5572,5572,5416,5590,5416,5590,5502,18,-70,4,220120,2
1926,y1611,20151214,5590,5502,0,0,0,5502,5502,0,0,0,0,2
1927,y1611,20151215,5502,5502,5650,5650,5578,5578,5614,76,112,4,224560,2
1928,y1611,20151216,5578,5614,0,0,0,5578,5578,-36,-36,0,0,2
1929,y1611,20151217,5578,5578,0,0,0,5570,5570,-8,-8,0,0,2
1930,y1611,20151218,5570,5570,0,0,0,5556,5556,-14,-14,0,0,2
1931,y1611,20151221,5556,5556,0,0,0,5634,5634,78,78,0,0,2
1932,y1611,20151222,5634,5634,0,0,0,5674,5674,40,40,0,0,2
1933,y1611,20151223,5674,5674,5654,5654,5572,5572,5612,-102,-62,4,224520,2
1934,y1611,20151224,5572,5612,0,0,0,5632,5632,20,20,0,0,2
1935,y1611,20151225,5632,5632,0,0,0,5622,5622,-10,-10,0,0,2
1936,y1611,20151228,5622,5622,0,0,0,5610,5610,-12,-12,0,0,2
1937,y1611,20151229,5610,5610,0,0,0,5586,5586,-24,-24,0,0,2
1938,y1611,20151230,5586,5586,0,0,0,5676,5676,90,90,0,0,2
1939,y1611,20151231,5676,5676,0,0,0,5676,5676,0,0,0,0,2
1940,y1612,20151215,5528,5528,0,0,0,5640,5640,112,112,0,0,0
1941,y1612,20151216,5640,5640,0,0,0,5604,5604,-36,-36,0,0,0
1942,y1612,20151217,5604,5604,0,0,0,5596,5596,-8,-8,0,0,0
1943,y1612,20151218,5596,5596,0,0,0,5582,5582,-14,-14,0,0,0
1944,y1612,20151221,5582,5582,0,0,0,5660,5660,78,78,0,0,0
1945,y1612,20151222,5660,5660,0,0,0,5700,5700,40,40,0,0,0
1946,y1612,20151223,5700,5700,0,0,0,5638,5638,-62,-62,0,0,0
1947,y1612,20151224,5638,5638,0,0,0,5658,5658,20,20,0,0,0
1948,y1612,20151225,5658,5658,0,0,0,5648,5648,-10,-10,0,0,0
1949,y1612,20151228,5648,5648,0,0,0,5636,5636,-12,-12,0,0,0
1950,y1612,20151229,5636,5636,0,0,0,5612,5612,-24,-24,0,0,0
1951,y1612,20151230,5612,5612,0,0,0,5702,5702,90,90,0,0,0
1952,y1612,20151231,5702,5702,0,0,0,5702,5702,0,0,0,0,0
