   ,合约,日期,前收盘价,前结算价,开盘价,最高价,最低价,收盘价,结算价,涨跌1,涨跌2,成交量,成交金额,持仓量
1,m1501,20150105,2993,3014,2986,2986,2931,2946,2948,-68,-66,6360,187544940,15948
2,m1501,20150106,2946,2948,2948,3005,2945,2991,2990,43,42,2920,87318800,13554
3,m1501,20150107,2991,2990,3000,3015,2991,3000,3003,10,13,2690,80796560,12350
4,m1501,20150108,3000,3003,3010,3015,2986,2986,3002,-17,-1,3756,112757260,10804
5,m1501,20150109,2986,3002,2986,2999,2984,2999,2985,-3,-17,1132,33797820,9672
6,m1501,20150112,2999,2985,3008,3008,2990,2990,2990,5,5,2534,75786960,9670
7,m1501,20150113,2990,2990,2975,2975,2975,2975,2975,-15,-15,22,654500,9648
8,m1501,20150114,2975,2975,2941,2950,2931,2931,2938,-44,-37,1800,52896000,8048
9,m1501,20150115,2931,2938,2911,2911,2911,2911,2911,-27,-27,2,58220,8046
10,m1501,20150116,2911,2911,2900,2900,2896,2896,2976,-15,65,162,4695360,0
11,m1503,20150105,3038,3046,2969,2989,2956,2956,2964,-90,-82,28,830080,822
12,m1503,20150106,2956,2964,2977,3017,2977,2987,3004,23,40,66,1982700,806
13,m1503,20150107,2987,3004,3031,3031,3000,3000,3015,-4,11,42,1266340,794
14,m1503,20150108,3000,3015,3001,3023,2992,3012,3006,-3,-9,148,4449760,762
15,m1503,20150109,3012,3006,3006,3006,2967,2971,2984,-35,-22,50,1492060,728
16,m1503,20150112,2971,2984,2966,2990,2956,2984,2978,0,-6,86,2561340,710
17,m1503,20150113,2984,2978,2953,3016,2930,2943,2949,-35,-29,80,2359500,730
18,m1503,20150114,2943,2949,2943,2949,2887,2888,2910,-61,-39,110,3201240,768
19,m1503,20150115,2888,2910,2890,2935,2890,2927,2920,17,10,68,1986140,770
20,m1503,20150116,2927,2920,2936,2947,2854,2860,2880,-60,-40,98,2822920,800
21,m1503,20150119,2860,2880,2873,2902,2792,2807,2886,-73,6,410,11835200,788
22,m1503,20150120,2807,2886,2836,2847,2808,2820,2828,-66,-58,56,1583820,764
23,m1503,20150121,2820,2828,2821,2871,2799,2852,2841,24,13,64,1818820,766
24,m1503,20150122,2852,2841,2869,2869,2821,2848,2846,7,5,106,3016960,704
25,m1503,20150123,2848,2846,2840,2840,2808,2808,2818,-38,-28,36,1014660,702
26,m1503,20150126,2808,2818,2837,2837,2801,2811,2814,-7,-4,200,5628600,686
27,m1503,20150127,2811,2814,2828,2857,2828,2834,2842,20,28,38,1080220,680
28,m1503,20150128,2834,2842,2829,2834,2804,2830,2818,-12,-24,20,563640,684
29,m1503,20150129,2830,2818,2803,2829,2790,2813,2804,-5,-14,110,3084560,684
30,m1503,20150130,2813,2804,2820,2842,2807,2832,2825,28,21,66,1865040,666
31,m1503,20150202,2832,2825,2827,2827,2787,2801,2798,-24,-27,46,1287500,686
32,m1503,20150203,2801,2798,2809,2853,2795,2825,2824,27,26,118,3333200,740
33,m1503,20150204,2825,2824,2876,2894,2852,2868,2877,44,53,120,3452800,732
34,m1503,20150205,2868,2877,2853,2853,2831,2834,2835,-43,-42,48,1361040,736
35,m1503,20150206,2834,2835,2859,2860,2835,2837,2849,2,14,108,3077280,730
36,m1503,20150209,2837,2849,2845,2850,2845,2850,2849,1,0,12,341900,728
37,m1503,20150210,2850,2849,2850,2871,2850,2850,2854,1,5,22,628000,722
38,m1503,20150211,2850,2854,2860,2862,2852,2858,2857,4,3,194,5543680,710
39,m1503,20150212,2858,2857,2865,2865,2852,2852,2858,-5,1,4,114340,710
40,m1503,20150213,2852,2858,2880,2930,2866,2930,2895,72,37,60,1737080,706
41,m1503,20150216,2930,2895,2905,2966,2905,2950,2926,55,31,142,4155400,598
42,m1503,20150217,2950,2926,2930,2954,2930,2954,2934,28,8,20,586880,594
43,m1503,20150225,2954,2934,3062,3062,2910,2956,2962,22,28,300,8886980,438
44,m1503,20150226,2956,2962,2970,3005,2970,2985,2982,23,20,156,4652340,360
45,m1503,20150227,2985,2982,2986,3101,2920,3000,3011,18,29,730,21983860,232
46,m1503,20150302,3000,3011,2930,2930,2930,2930,2930,-81,-81,232,6797600,232
47,m1503,20150303,2930,2930,0,0,0,2930,2930,0,0,0,0,0
48,m1503,20150304,2930,2930,0,0,0,2930,2930,0,0,0,0,0
49,m1503,20150305,2930,2930,0,0,0,2930,2930,0,0,0,0,0
50,m1503,20150306,2930,2930,0,0,0,2930,2930,0,0,0,0,0
51,m1503,20150309,2930,2930,0,0,0,2930,2930,0,0,0,0,0
52,m1503,20150310,2930,2930,0,0,0,2930,2930,0,0,0,0,0
53,m1503,20150311,2930,2930,0,0,0,2930,2930,0,0,0,0,0
54,m1503,20150312,2930,2930,0,0,0,2930,2930,0,0,0,0,0
55,m1503,20150313,2930,2930,0,0,0,2930,2930,0,0,0,0,0
56,m1505,20150105,2869,2884,2802,2828,2802,2805,2816,-79,-68,1133224,31912154900,2128376
57,m1505,20150106,2805,2816,2816,2873,2811,2849,2848,33,32,1638688,46681810980,1857150
58,m1505,20150107,2849,2848,2860,2881,2846,2858,2863,10,15,1282780,36730395780,1842564
59,m1505,20150108,2858,2863,2863,2873,2850,2864,2861,1,-2,931688,26655894500,1879430
60,m1505,20150109,2864,2861,2863,2873,2820,2831,2842,-30,-19,1413136,40162497140,1994680
61,m1505,20150112,2831,2842,2835,2849,2826,2837,2837,-5,-5,836516,23739038460,1983212
62,m1505,20150113,2837,2837,2830,2846,2770,2785,2797,-52,-40,1807898,50582847140,2184950
63,m1505,20150114,2785,2797,2782,2792,2716,2719,2750,-78,-47,2093774,57591564840,2281052
64,m1505,20150115,2719,2750,2718,2755,2702,2746,2732,-4,-18,2024042,55310378980,2140580
65,m1505,20150116,2746,2732,2741,2765,2692,2710,2720,-22,-12,2806146,76342811160,2253938
66,m1505,20150119,2710,2720,2713,2735,2620,2681,2691,-39,-29,3603260,96968740500,2048538
67,m1505,20150120,2681,2691,2681,2683,2644,2669,2662,-22,-29,2109820,56178056060,2081390
68,m1505,20150121,2669,2662,2669,2730,2645,2693,2682,31,20,2825926,75810639360,2107458
69,m1505,20150122,2693,2682,2690,2721,2682,2698,2700,16,18,2285610,61722661020,2187792
70,m1505,20150123,2698,2700,2711,2711,2663,2681,2679,-19,-21,2016936,54039011320,2194440
71,m1505,20150126,2681,2679,2671,2698,2658,2674,2679,-5,0,2383954,63884851420,2236424
72,m1505,20150127,2674,2679,2670,2720,2669,2695,2695,16,16,2215258,59705269160,2181984
73,m1505,20150128,2695,2695,2696,2702,2676,2691,2688,-4,-7,1573514,42308787580,2167684
74,m1505,20150129,2691,2688,2684,2702,2673,2686,2685,-2,-3,1528462,41039705520,2140312
75,m1505,20150130,2686,2685,2682,2702,2677,2694,2692,9,7,1672080,45017701920,2102938
76,m1505,20150202,2694,2692,2697,2697,2655,2665,2671,-27,-21,2221282,59342952280,2231834
77,m1505,20150203,2665,2671,2671,2701,2663,2691,2682,20,11,1870170,50166652620,2224246
78,m1505,20150204,2691,2682,2699,2752,2689,2720,2721,38,39,3041890,82780669300,2117758
79,m1505,20150205,2720,2721,2721,2727,2700,2716,2714,-5,-7,1539530,41784654180,2088058
80,m1505,20150206,2716,2714,2721,2742,2716,2725,2727,11,13,1684274,45946677080,2038138
81,m1505,20150209,2725,2727,2731,2738,2712,2737,2726,10,-1,1413060,38521286860,2008488
82,m1505,20150210,2737,2726,2732,2759,2729,2734,2743,8,17,1591966,43675073940,1955180
83,m1505,20150211,2734,2743,2731,2759,2724,2744,2740,1,-3,1658578,45447751140,1974310
84,m1505,20150212,2744,2740,2738,2749,2735,2742,2741,2,1,693770,19020395260,1936714
85,m1505,20150213,2742,2741,2745,2795,2743,2794,2769,53,28,1557154,43121597680,1848922
86,m1505,20150216,2794,2769,2786,2819,2785,2799,2804,30,35,1128734,31652924480,1776156
87,m1505,20150217,2799,2804,2793,2814,2789,2809,2800,5,-4,446456,12502431240,1716552
88,m1505,20150225,2809,2800,2848,2869,2831,2838,2844,38,44,597144,16987386120,1702566
89,m1505,20150226,2838,2844,2838,2865,2832,2851,2849,7,5,979856,27922350260,1724848
90,m1505,20150227,2851,2849,2859,2930,2852,2919,2889,70,40,1513870,43745846580,1728592
91,m1505,20150302,2919,2889,2922,2951,2905,2932,2929,43,40,1502486,44019490560,1650454
92,m1505,20150303,2932,2929,2932,2941,2873,2883,2901,-46,-28,1357532,39394780920,1476720
93,m1505,20150304,2883,2901,2884,2890,2847,2875,2866,-26,-35,867688,24873873380,1409720
94,m1505,20150305,2875,2866,2866,2866,2834,2842,2844,-24,-22,707210,20120002520,1375482
95,m1505,20150306,2842,2844,2836,2872,2818,2820,2846,-24,2,852240,24261790940,1301178
96,m1505,20150309,2820,2846,2828,2848,2802,2840,2826,-6,-20,722940,20437036620,1196876
97,m1505,20150310,2840,2826,2839,2865,2831,2849,2846,23,20,499854,14226397240,1137270
98,m1505,20150311,2849,2846,2845,2899,2821,2874,2857,28,11,779128,22264242960,1102160
99,m1505,20150312,2874,2857,2862,2899,2861,2887,2881,30,24,524660,15118768720,1039770
100,m1505,20150313,2887,2881,2881,2895,2855,2864,2873,-17,-8,545498,15674589960,976292
101,m1505,20150316,2864,2873,2851,2859,2816,2833,2835,-40,-38,323314,9168807240,944012
102,m1505,20150317,2833,2835,2840,2852,2816,2820,2829,-15,-6,415224,11749033840,928560
103,m1505,20150318,2820,2829,2808,2816,2782,2791,2796,-38,-33,448138,12530538800,850282
104,m1505,20150319,2791,2796,2799,2845,2789,2828,2817,32,21,486484,13706025620,834786
105,m1505,20150320,2828,2817,2819,2824,2811,2819,2817,2,0,292260,8233073520,815234
106,m1505,20150323,2819,2817,2811,2848,2811,2838,2832,21,15,248002,7023718420,782106
107,m1505,20150324,2838,2832,2838,2858,2822,2844,2841,12,9,232024,6592423760,754398
108,m1505,20150325,2844,2841,2840,2846,2817,2826,2832,-15,-9,238282,6748859740,715888
109,m1505,20150326,2826,2832,2838,2838,2800,2806,2816,-26,-16,197208,5553509740,700456
110,m1505,20150327,2806,2816,2809,2809,2780,2799,2793,-17,-23,221186,6178371560,674814
111,m1505,20150330,2799,2793,2790,2798,2776,2784,2787,-9,-6,208154,5801514840,637870
112,m1505,20150331,2784,2787,2778,2785,2752,2773,2770,-14,-17,232930,6452943760,604266
113,m1505,20150401,2773,2770,2771,2840,2766,2813,2813,43,43,367744,10345424240,529262
114,m1505,20150402,2813,2813,2819,2832,2803,2808,2815,-5,2,226650,6381869360,491194
115,m1505,20150403,2808,2815,2796,2810,2789,2792,2798,-23,-17,169080,4731194980,455766
116,m1505,20150407,2792,2798,2785,2805,2782,2791,2792,-7,-6,87740,2450226060,443048
117,m1505,20150408,2791,2792,2788,2791,2772,2783,2784,-9,-8,92584,2578256380,431278
118,m1505,20150409,2783,2784,2784,2791,2750,2753,2764,-31,-20,156348,4322997860,414622
119,m1505,20150410,2753,2764,2753,2754,2708,2720,2726,-44,-38,157350,4289534120,369414
120,m1505,20150413,2720,2726,2718,2736,2703,2726,2721,0,-5,72048,1960631800,350556
121,m1505,20150414,2726,2721,2725,2732,2721,2725,2725,4,4,121394,3308791440,308648
122,m1505,20150415,2725,2725,2732,2746,2727,2741,2737,16,12,61486,1683284900,274212
123,m1505,20150416,2741,2737,2730,2743,2720,2722,2730,-15,-7,31556,861781020,263726
124,m1505,20150417,2722,2730,2723,2739,2715,2737,2727,7,-3,40364,1100916340,242644
125,m1505,20150420,2737,2727,2739,2764,2728,2756,2745,29,18,62358,1712321540,213766
126,m1505,20150421,2756,2745,2750,2757,2741,2754,2751,9,6,27018,743495140,200394
127,m1505,20150422,2754,2751,2757,2757,2715,2716,2727,-35,-24,99464,2713368620,135886
128,m1505,20150423,2716,2727,2710,2740,2710,2738,2726,11,-1,37928,1034219640,110976
129,m1505,20150424,2738,2726,2739,2755,2725,2742,2744,16,18,33940,931463680,90336
130,m1505,20150427,2742,2744,2741,2747,2727,2742,2740,-2,-4,27646,757537440,75060
131,m1505,20150428,2742,2740,2745,2756,2721,2739,2744,-1,4,31636,868382720,53992
132,m1505,20150429,2739,2744,2748,2751,2724,2727,2738,-17,-6,22498,616136840,41896
133,m1505,20150430,2727,2738,2724,2732,2700,2700,2718,-38,-20,32414,881285700,23154
134,m1505,20150504,2700,2718,2555,2710,2555,2705,2677,-13,-41,3446,92254160,21554
135,m1505,20150505,2705,2677,2700,2729,2671,2715,2720,38,43,1700,46240940,20372
136,m1505,20150506,2715,2720,2758,2758,2651,2718,2740,-2,20,1150,31518840,19626
137,m1505,20150507,2718,2740,2718,2718,2682,2705,2703,-35,-37,600,16218940,19440
138,m1505,20150508,2705,2703,2700,2700,2671,2690,2688,-13,-15,270,7259780,19440
139,m1505,20150511,2690,2688,2689,2689,2680,2685,2683,-3,-5,38,1019880,19430
140,m1505,20150512,2685,2683,2681,2681,2670,2670,2671,-13,-12,400,10687220,19430
141,m1505,20150513,2670,2671,2662,2672,2662,2665,2669,-6,-2,1628,43461940,18216
142,m1505,20150514,2665,2669,2613,2660,2613,2658,2626,-11,-43,94,2468900,17608
143,m1505,20150515,2658,2626,2611,2611,2611,2611,2686,-15,60,790,20626900,0
144,m1507,20150105,2872,2898,2836,2839,2820,2825,2828,-73,-70,474,13407180,3836
145,m1507,20150106,2825,2828,2830,2900,2824,2869,2866,41,38,326,9345260,3756
146,m1507,20150107,2869,2866,2874,2883,2867,2868,2874,2,8,132,3794940,3746
147,m1507,20150108,2868,2874,2869,2883,2862,2883,2871,9,-3,70,2010260,3734
148,m1507,20150109,2883,2871,2887,2887,2837,2850,2851,-21,-20,136,3878440,3774
149,m1507,20150112,2850,2851,2845,2859,2845,2847,2848,-4,-3,32,911380,3770
150,m1507,20150113,2847,2848,2850,2852,2796,2799,2818,-49,-30,88,2480120,3772
151,m1507,20150114,2799,2818,2801,2804,2720,2761,2772,-57,-46,134,3715660,3782
152,m1507,20150115,2761,2772,2759,2770,2726,2768,2746,-4,-26,220,6042620,3772
153,m1507,20150116,2768,2746,2776,2776,2710,2727,2742,-19,-4,150,4114220,3746
154,m1507,20150119,2727,2742,2729,2745,2633,2690,2702,-52,-40,286,7728760,3588
155,m1507,20150120,2690,2702,2663,2688,2663,2678,2676,-24,-26,106,2836940,3560
156,m1507,20150121,2678,2676,2684,2748,2662,2711,2696,35,20,208,5607680,3542
157,m1507,20150122,2711,2696,2721,2729,2707,2722,2720,26,24,156,4244080,3508
158,m1507,20150123,2722,2720,2728,2728,2677,2695,2697,-25,-23,140,3776300,3446
159,m1507,20150126,2695,2697,2696,2710,2667,2685,2690,-12,-7,472,12701500,3332
160,m1507,20150127,2685,2690,2683,2788,2683,2709,2717,19,27,108,2934880,3310
161,m1507,20150128,2709,2717,2707,2736,2689,2709,2706,-8,-11,40,1082640,3304
162,m1507,20150129,2709,2706,2695,2727,2695,2704,2705,-2,-1,38,1028200,3306
163,m1507,20150130,2704,2705,2715,2715,2701,2713,2708,8,3,52,1408660,3294
164,m1507,20150202,2713,2708,2706,2706,2668,2683,2685,-25,-23,58,1557580,3290
165,m1507,20150203,2683,2685,2684,2707,2681,2703,2698,18,13,78,2105100,3280
166,m1507,20150204,2703,2698,2709,2755,2703,2730,2737,32,39,114,3121300,3256
167,m1507,20150205,2730,2737,2731,2746,2716,2725,2728,-12,-9,158,4310660,3262
168,m1507,20150206,2725,2728,2739,2745,2721,2731,2738,3,10,58,1588180,3262
169,m1507,20150209,2731,2738,2740,2750,2731,2750,2740,12,2,74,2028000,3208
170,m1507,20150210,2750,2740,2750,2766,2747,2747,2755,7,15,50,1377760,3200
171,m1507,20150211,2747,2755,2751,2765,2738,2765,2753,10,-2,72,1982680,3212
172,m1507,20150212,2765,2753,2755,2773,2748,2748,2756,-5,3,48,1323100,3188
173,m1507,20150213,2748,2756,2766,2805,2761,2805,2783,49,27,106,2950040,3164
174,m1507,20150216,2805,2783,2803,2832,2800,2808,2809,25,26,104,2921540,3124
175,m1507,20150217,2808,2809,2805,2825,2805,2820,2814,11,5,38,1069380,3110
176,m1507,20150225,2820,2814,2840,2875,2840,2849,2852,35,38,156,4449800,3024
177,m1507,20150226,2849,2852,2859,2875,2853,2867,2862,15,10,78,2232900,3032
178,m1507,20150227,2867,2862,2884,2939,2867,2935,2908,73,46,174,5060400,2968
179,m1507,20150302,2935,2908,2930,2952,2922,2940,2939,32,31,116,3410320,2904
180,m1507,20150303,2940,2939,2939,2939,2883,2888,2892,-51,-47,114,3297860,2892
181,m1507,20150304,2888,2892,2895,2895,2861,2885,2877,-7,-15,286,8229280,2840
182,m1507,20150305,2885,2877,2869,2869,2848,2848,2854,-29,-23,68,1941360,2848
183,m1507,20150306,2848,2854,2861,2878,2832,2832,2858,-22,4,332,9490000,2880
184,m1507,20150309,2832,2858,2823,2857,2817,2857,2834,-1,-24,100,2834400,2864
185,m1507,20150310,2857,2834,2855,2875,2854,2859,2859,25,25,22,629140,2862
186,m1507,20150311,2859,2859,2836,2909,2836,2909,2854,50,-5,402,11475960,2842
187,m1507,20150312,2909,2854,2897,2910,2875,2877,2882,23,28,1530,44100100,3522
188,m1507,20150313,2877,2882,2888,2890,2864,2864,2884,-18,2,270,7787140,3470
189,m1507,20150316,2864,2884,2855,2864,2835,2843,2845,-41,-39,16,455340,3468
190,m1507,20150317,2843,2845,2846,2848,2834,2834,2839,-11,-6,32,908480,3466
191,m1507,20150318,2834,2839,2819,2819,2795,2795,2808,-44,-31,118,3314260,3404
192,m1507,20150319,2795,2808,2813,2834,2809,2834,2817,26,9,54,1521680,3388
193,m1507,20150320,2834,2817,2825,2826,2816,2825,2823,8,6,52,1468360,3348
194,m1507,20150323,2825,2823,2839,2856,2835,2856,2844,33,21,20,568880,3338
195,m1507,20150324,2856,2844,2861,2867,2834,2834,2853,-10,9,42,1198360,3330
196,m1507,20150325,2834,2853,2831,2854,2827,2834,2839,-19,-14,92,2612420,3272
197,m1507,20150326,2834,2839,2835,2859,2817,2819,2829,-20,-10,32,905420,3262
198,m1507,20150327,2819,2829,2798,2810,2792,2805,2802,-24,-27,38,1064860,3258
199,m1507,20150330,2805,2802,2793,2805,2793,2801,2798,-1,-4,46,1287420,3230
200,m1507,20150331,2801,2798,2788,2797,2768,2781,2782,-17,-16,210,5843580,3116
201,m1507,20150401,2781,2782,2783,2845,2783,2830,2823,48,41,82,2315220,3078
202,m1507,20150402,2830,2823,2826,2840,2820,2820,2829,-3,6,90,2546120,3020
203,m1507,20150403,2820,2829,2821,2821,2809,2819,2818,-10,-11,40,1127300,3000
204,m1507,20150407,2819,2818,2797,2797,2797,2797,2797,-21,-21,2,55940,2998
205,m1507,20150408,2797,2797,2801,2815,2800,2813,2809,16,12,148,4158020,2902
206,m1507,20150409,2813,2809,2814,2816,2788,2791,2806,-18,-3,40,1122540,2882
207,m1507,20150410,2791,2806,2763,2783,2751,2760,2764,-46,-42,122,3373040,2876
208,m1507,20150413,2760,2764,2760,2768,2728,2765,2755,1,-9,236,6503200,2790
209,m1507,20150414,2765,2755,2759,2759,2745,2757,2754,2,-1,82,2258280,2752
210,m1507,20150415,2757,2754,2748,2785,2748,2765,2762,11,8,64,1768120,2720
211,m1507,20150416,2765,2762,2755,2765,2739,2746,2758,-16,-4,100,2758960,2656
212,m1507,20150417,2746,2758,2752,2765,2752,2765,2762,7,4,90,2486120,2636
213,m1507,20150420,2765,2762,2765,2790,2764,2780,2783,18,21,164,4565660,2630
214,m1507,20150421,2780,2783,2782,2784,2770,2781,2780,-2,-3,168,4670600,2594
215,m1507,20150422,2781,2780,2761,2764,2754,2761,2761,-19,-19,164,4528520,2470
216,m1507,20150423,2761,2761,2798,2798,2753,2764,2763,3,2,64,1768320,2462
217,m1507,20150424,2764,2763,2766,2780,2764,2775,2770,12,7,162,4488680,2332
218,m1507,20150427,2775,2770,2803,2803,2781,2787,2786,17,16,96,2674960,2370
219,m1507,20150428,2787,2786,2786,2812,2745,2775,2778,-11,-8,598,16612840,2488
220,m1507,20150429,2775,2778,2795,2795,2758,2758,2775,-20,-3,60,1665260,2460
221,m1507,20150430,2758,2775,2783,2783,2783,2783,2783,8,8,2,55660,2460
222,m1507,20150504,2783,2783,2774,2812,2743,2749,2785,-34,2,240,6686060,2456
223,m1507,20150505,2749,2785,2748,2777,2747,2751,2762,-34,-23,202,5581020,2428
224,m1507,20150506,2751,2762,2752,2785,2752,2772,2770,10,8,68,1884000,2378
225,m1507,20150507,2772,2770,2762,2790,2758,2758,2764,-12,-6,330,9122260,2382
226,m1507,20150508,2758,2764,2738,2761,2728,2748,2750,-16,-14,98,2695080,2368
227,m1507,20150511,2748,2750,2773,2773,2727,2751,2755,1,5,498,13723020,2454
228,m1507,20150512,2751,2755,2749,2749,2704,2704,2717,-51,-38,108,2935140,2420
229,m1507,20150513,2704,2717,2712,2712,2692,2701,2699,-16,-18,148,3994620,2356
230,m1507,20150514,2701,2699,2676,2699,2673,2674,2680,-25,-19,54,1447280,2330
231,m1507,20150515,2674,2680,2683,2690,2671,2688,2686,8,6,246,6609820,2320
232,m1507,20150518,2688,2686,2669,2669,2661,2669,2666,-17,-20,106,2826680,2286
233,m1507,20150519,2669,2666,2680,2680,2642,2642,2660,-24,-6,56,1490000,2286
234,m1507,20150520,2642,2660,2625,2625,2554,2555,2570,-105,-90,478,12288680,1964
235,m1507,20150521,2555,2570,2554,2575,2551,2561,2565,-9,-5,60,1539100,1960
236,m1507,20150522,2561,2565,2522,2554,2517,2532,2533,-33,-32,46,1165580,1956
237,m1507,20150525,2532,2533,2545,2545,2465,2468,2485,-65,-48,330,8203040,2006
238,m1507,20150526,2468,2485,2440,2482,2419,2447,2452,-38,-33,710,17414320,2036
239,m1507,20150527,2447,2452,2420,2538,2420,2446,2452,-6,0,450,11038240,1946
240,m1507,20150528,2446,2452,2456,2478,2444,2449,2457,-3,5,634,15577860,1914
241,m1507,20150529,2449,2457,2450,2456,2446,2450,2451,-7,-6,160,3921720,1918
242,m1507,20150601,2450,2451,2454,2458,2440,2445,2447,-6,-4,244,5971780,1922
243,m1507,20150602,2445,2447,2447,2462,2439,2458,2448,11,1,388,9501240,1908
244,m1507,20150603,2458,2448,2458,2467,2445,2452,2454,4,6,346,8492080,1908
245,m1507,20150604,2452,2454,2431,2455,2431,2449,2443,-5,-11,164,4007900,1908
246,m1507,20150605,2449,2443,2456,2501,2450,2493,2478,50,35,570,14127500,1592
247,m1507,20150608,2493,2478,2484,2495,2448,2478,2468,0,-10,610,15057820,1420
248,m1507,20150609,2478,2468,2485,2499,2482,2491,2490,23,22,130,3237500,1390
249,m1507,20150610,2491,2490,2500,2509,2492,2497,2500,7,10,280,7000000,1400
250,m1507,20150611,2497,2500,2498,2499,2464,2465,2475,-35,-25,436,10792160,1506
251,m1507,20150612,2465,2475,2446,2458,2415,2426,2431,-49,-44,804,19550300,1428
252,m1507,20150615,2426,2431,2422,2430,2375,2395,2408,-36,-23,376,9055700,1414
253,m1507,20150616,2395,2408,2391,2395,2382,2388,2389,-20,-19,198,4731640,1404
254,m1507,20150617,2388,2389,2381,2459,2372,2427,2430,38,41,358,8700440,1408
255,m1507,20150618,2427,2430,2426,2436,2416,2423,2425,-7,-5,162,3928640,1438
256,m1507,20150619,2423,2425,2403,2429,2385,2395,2405,-30,-20,308,7409300,1436
257,m1507,20150623,2395,2405,2435,2487,2435,2484,2465,79,60,652,16074480,1374
258,m1507,20150624,2484,2465,2480,2480,2446,2450,2463,-15,-2,308,7588460,1346
259,m1507,20150625,2450,2463,2445,2467,2445,2460,2460,-3,-3,450,11070220,1296
260,m1507,20150626,2460,2460,2480,2532,2440,2455,2481,-5,21,762,18906860,1198
261,m1507,20150629,2455,2481,2480,2492,2463,2474,2482,-7,1,346,8587820,1166
262,m1507,20150630,2474,2482,2490,2490,2400,2442,2435,-40,-47,516,12565460,988
263,m1507,20150701,2442,2435,2530,2550,2424,2500,2475,65,40,280,6931300,870
264,m1507,20150702,2500,2475,2420,2623,2419,2623,2610,148,135,220,5743980,870
265,m1507,20150703,2623,2610,2456,2614,2456,2614,2568,4,-42,16,411020,302
266,m1507,20150706,2614,2568,2600,2600,2600,2600,2600,32,32,2,52000,300
267,m1507,20150707,2600,2600,0,0,0,2600,2600,0,0,0,0,300
268,m1507,20150708,2600,2600,0,0,0,2600,2600,0,0,0,0,300
269,m1507,20150709,2600,2600,0,0,0,2600,2600,0,0,0,0,300
270,m1507,20150710,2600,2600,2650,2650,2600,2600,2604,0,4,22,573020,300
271,m1507,20150713,2600,2604,0,0,0,2604,2604,0,0,0,0,300
272,m1507,20150714,2604,2604,0,0,0,2539,2539,-65,-65,0,0,0
273,m1508,20150105,2886,2896,2896,2896,2832,2842,2847,-54,-49,40,1138800,1276
274,m1508,20150106,2842,2847,2846,2884,2846,2876,2870,29,23,50,1435000,1278
275,m1508,20150107,2876,2870,2882,2898,2876,2881,2890,11,20,96,2774520,1276
276,m1508,20150108,2881,2890,2884,2891,2871,2887,2880,-3,-10,54,1555260,1266
277,m1508,20150109,2887,2880,2895,2895,2840,2863,2867,-17,-13,74,2121800,1260
278,m1508,20150112,2863,2867,2854,2862,2854,2859,2859,-8,-8,70,2001400,1252
279,m1508,20150113,2859,2859,2862,2862,2787,2808,2823,-51,-36,132,3727340,1250
280,m1508,20150114,2808,2823,2801,2810,2758,2759,2785,-64,-38,38,1058380,1250
281,m1508,20150115,2759,2785,2751,2777,2738,2770,2764,-15,-21,42,1161120,1252
282,m1508,20150116,2770,2764,2778,2779,2700,2718,2755,-46,-9,296,8155860,1196
283,m1508,20150119,2718,2755,2731,2731,2655,2662,2711,-93,-44,210,5693840,1152
284,m1508,20150120,2662,2711,2680,2686,2667,2682,2678,-29,-33,80,2142540,1150
285,m1508,20150121,2682,2678,2685,2726,2670,2721,2701,43,23,40,1080520,1136
286,m1508,20150122,2721,2701,2720,2729,2712,2713,2722,12,21,26,707800,1132
287,m1508,20150123,2713,2722,2716,2716,2691,2704,2699,-18,-23,74,1997800,1124
288,m1508,20150126,2704,2699,2702,2725,2695,2695,2711,-4,12,40,1084720,1128
289,m1508,20150127,2695,2711,2710,2745,2709,2719,2718,8,7,46,1250360,1128
290,m1508,20150128,2719,2718,2742,2742,2713,2732,2727,14,9,12,327320,1124
291,m1508,20150129,2732,2727,2714,2733,2714,2721,2723,-6,-4,18,490280,1128
292,m1508,20150130,2721,2723,2723,2733,2706,2733,2726,10,3,18,490780,1134
293,m1508,20150202,2733,2726,2720,2720,2677,2698,2689,-28,-37,30,806820,1136
294,m1508,20150203,2698,2689,2711,2729,2711,2728,2720,39,31,16,435300,1136
295,m1508,20150204,2728,2720,2734,2779,2734,2754,2762,34,42,78,2154660,1116
296,m1508,20150205,2754,2762,2751,2753,2742,2742,2750,-20,-12,32,880120,1128
297,m1508,20150206,2742,2750,2733,2770,2733,2754,2758,4,8,46,1268760,1124
298,m1508,20150209,2754,2758,2764,2764,2749,2763,2757,5,-1,30,827360,1112
299,m1508,20150210,2763,2757,2766,2781,2766,2781,2773,24,16,10,277320,1104
300,m1508,20150211,2781,2773,2769,2775,2755,2766,2762,-7,-11,22,607780,1090
301,m1508,20150212,2766,2762,2762,2762,2762,2762,2762,0,0,2,55240,1088
302,m1508,20150213,2762,2762,2783,2788,2780,2786,2784,24,22,52,1447920,1060
303,m1508,20150216,2786,2784,2803,2810,2792,2792,2803,8,19,12,336460,1052
304,m1508,20150217,2792,2803,2800,2800,2792,2792,2794,-11,-9,14,391220,1058
305,m1508,20150225,2792,2794,2826,2828,2826,2828,2827,34,33,10,282760,1050
306,m1508,20150226,2828,2827,2834,2860,2834,2852,2853,25,26,90,2567980,1048
307,m1508,20150227,2852,2853,2865,2945,2864,2909,2906,56,53,150,4360060,1044
308,m1508,20150302,2909,2906,2914,2926,2914,2926,2920,20,14,8,233600,1048
309,m1508,20150303,2926,2920,2917,2938,2865,2869,2894,-51,-26,86,2489460,1064
310,m1508,20150304,2869,2894,2865,2868,2848,2868,2861,-26,-33,26,743880,1056
311,m1508,20150305,2868,2861,2855,2855,2830,2835,2837,-26,-24,300,8513900,1174
312,m1508,20150306,2835,2837,2847,2847,2847,2847,2847,10,10,2,56940,1174
313,m1508,20150309,2847,2847,2822,2844,2807,2839,2828,-8,-19,56,1584160,1192
314,m1508,20150310,2839,2828,2841,2865,2840,2845,2849,17,21,140,3989020,1278
315,m1508,20150311,2845,2849,2833,2899,2833,2875,2861,26,12,136,3892260,1288
316,m1508,20150312,2875,2861,2884,2896,2868,2885,2882,24,21,228,6571960,1220
317,m1508,20150313,2885,2882,2860,2876,2848,2848,2854,-34,-28,82,2340960,1238
318,m1508,20150316,2848,2854,2842,2842,2827,2827,2837,-27,-17,32,907980,1230
319,m1508,20150317,2827,2837,2827,2835,2827,2829,2831,-8,-6,16,452960,1232
320,m1508,20150318,2829,2831,2822,2822,2782,2782,2792,-49,-39,52,1452220,1222
321,m1508,20150319,2782,2792,2794,2822,2770,2822,2785,30,-7,74,2061620,1200
322,m1508,20150320,2822,2785,2801,2807,2801,2802,2803,17,18,26,728820,1208
323,m1508,20150323,2802,2803,2822,2838,2819,2838,2831,35,28,146,4133320,1258
324,m1508,20150324,2838,2831,2850,2850,2823,2833,2832,2,1,60,1699280,1246
325,m1508,20150325,2833,2832,2834,2838,2812,2838,2824,6,-8,44,1242920,1258
326,m1508,20150326,2838,2824,2831,2831,2810,2811,2814,-13,-10,34,956800,1254
327,m1508,20150327,2811,2814,2800,2808,2781,2801,2799,-13,-15,34,951800,1250
328,m1508,20150330,2801,2799,2795,2801,2795,2800,2797,1,-2,16,447520,1260
329,m1508,20150331,2800,2797,2769,2795,2769,2785,2781,-12,-16,24,667480,1254
330,m1508,20150401,2785,2781,2802,2842,2801,2842,2833,61,52,56,1586740,1232
331,m1508,20150402,2842,2833,2817,2847,2817,2847,2839,14,6,32,908640,1230
332,m1508,20150403,2847,2839,2829,2832,2817,2827,2825,-12,-14,18,508500,1220
333,m1508,20150407,2827,2825,2814,2827,2807,2813,2814,-12,-11,22,619220,1214
334,m1508,20150408,2813,2814,2807,2812,2770,2800,2787,-14,-27,90,2508880,1274
335,m1508,20150409,2800,2787,2796,2796,2732,2740,2773,-47,-14,152,4215760,1256
336,m1508,20150410,2740,2773,2715,2749,2715,2722,2730,-51,-43,72,1966300,1240
337,m1508,20150413,2722,2730,2710,2740,2710,2737,2730,7,0,110,3003920,1214
338,m1508,20150414,2737,2730,2733,2735,2725,2735,2732,5,2,14,382580,1210
339,m1508,20150415,2735,2732,2735,2757,2735,2752,2747,20,15,32,879100,1210
340,m1508,20150416,2752,2747,2744,2752,2727,2742,2737,-5,-10,66,1806960,1204
341,m1508,20150417,2742,2737,2738,2756,2736,2755,2745,18,8,24,658820,1202
342,m1508,20150420,2755,2745,2753,2778,2752,2778,2766,33,21,28,774560,1212
343,m1508,20150421,2778,2766,2763,2786,2763,2778,2774,12,8,48,1331860,1196
344,m1508,20150422,2778,2774,2781,2788,2755,2757,2762,-17,-12,932,25747060,1432
345,m1508,20150423,2757,2762,2757,2788,2730,2754,2759,-8,-3,258,7118640,1416
346,m1508,20150424,2754,2759,2759,2785,2756,2769,2772,10,13,78,2162680,1410
347,m1508,20150427,2769,2772,2775,2775,2769,2769,2772,-3,0,4,110880,1408
348,m1508,20150428,2769,2772,2781,2803,2781,2793,2794,21,22,70,1956220,1390
349,m1508,20150429,2793,2794,2812,2812,2786,2788,2792,-6,-2,104,2903940,1376
350,m1508,20150430,2788,2792,2783,2793,2783,2793,2789,1,-3,14,390540,1372
351,m1508,20150504,2793,2789,2782,2782,2734,2753,2756,-36,-33,100,2756080,1350
352,m1508,20150505,2753,2756,2766,2772,2742,2747,2757,-9,1,124,3419060,1346
353,m1508,20150506,2747,2757,2734,2767,2733,2758,2746,1,-11,480,13181300,1214
354,m1508,20150507,2758,2746,2769,2785,2763,2772,2768,26,22,162,4485600,1124
355,m1508,20150508,2772,2768,2763,2763,2754,2754,2758,-14,-10,18,496460,1118
356,m1508,20150511,2754,2758,2763,2763,2760,2760,2761,2,3,30,828300,1096
357,m1508,20150512,2760,2761,2734,2746,2717,2721,2728,-40,-33,58,1582600,1104
358,m1508,20150513,2721,2728,2735,2748,2702,2718,2729,-10,1,180,4912360,1094
359,m1508,20150514,2718,2729,2714,2714,2698,2704,2702,-25,-27,58,1567240,1044
360,m1508,20150515,2704,2702,2702,2709,2698,2698,2700,-4,-2,20,540120,1040
361,m1508,20150518,2698,2700,2699,2704,2671,2704,2693,4,-7,54,1454600,1014
362,m1508,20150519,2704,2693,2706,2716,2680,2684,2692,-9,-1,136,3661880,1012
363,m1508,20150520,2684,2692,2666,2666,2585,2586,2603,-106,-89,672,17495280,768
364,m1508,20150521,2586,2603,2583,2598,2578,2593,2588,-10,-15,376,9732920,568
365,m1508,20150522,2593,2588,2570,2571,2570,2571,2570,-17,-18,4,102820,568
366,m1508,20150525,2571,2570,2576,2576,2530,2530,2543,-40,-27,136,3459020,570
367,m1508,20150526,2530,2543,2528,2556,2512,2518,2530,-25,-13,60,1518040,576
368,m1508,20150527,2518,2530,2518,2537,2511,2518,2518,-12,-12,118,2972260,534
369,m1508,20150528,2518,2518,2538,2556,2538,2547,2547,29,29,98,2496400,514
370,m1508,20150529,2547,2547,2549,2549,2536,2544,2541,-3,-6,72,1830160,546
371,m1508,20150601,2544,2541,2553,2553,2521,2528,2532,-13,-9,120,3039060,510
372,m1508,20150602,2528,2532,2529,2546,2525,2543,2533,11,1,106,2685800,464
373,m1508,20150603,2543,2533,2562,2562,2540,2557,2554,24,21,88,2247660,406
374,m1508,20150604,2557,2554,2552,2555,2512,2551,2544,-3,-10,184,4682540,328
375,m1508,20150605,2551,2544,2560,2560,2530,2536,2543,-8,-1,1676,42622520,1158
376,m1508,20150608,2536,2543,2535,2535,2506,2511,2517,-32,-26,224,5638940,1286
377,m1508,20150609,2511,2517,2518,2530,2518,2527,2523,10,6,214,5401340,1288
378,m1508,20150610,2527,2523,2531,2533,2512,2517,2526,-6,3,60,1516140,1286
379,m1508,20150611,2517,2526,2519,2524,2516,2522,2521,-4,-5,40,1008400,1286
380,m1508,20150612,2522,2521,2522,2522,2430,2447,2465,-74,-56,424,10454780,1382
381,m1508,20150615,2447,2465,2447,2450,2398,2398,2435,-67,-30,72,1753560,1372
382,m1508,20150616,2398,2435,2398,2438,2391,2418,2418,-17,-17,112,2708500,1370
383,m1508,20150617,2418,2418,2449,2502,2420,2481,2471,63,53,292,7215780,1432
384,m1508,20150618,2481,2471,2502,2502,2472,2474,2481,3,10,114,2829120,1392
385,m1508,20150619,2474,2481,2486,2521,2463,2506,2493,25,12,134,3340840,1378
386,m1508,20150623,2506,2493,2590,2590,2539,2556,2551,63,58,376,9593920,1548
387,m1508,20150624,2556,2551,2549,2549,2530,2531,2533,-20,-18,84,2128320,1590
388,m1508,20150625,2531,2533,2531,2539,2531,2537,2534,4,1,74,1875660,1632
389,m1508,20150626,2537,2534,2549,2588,2533,2558,2565,24,31,280,7184760,1832
390,m1508,20150629,2558,2565,2598,2600,2550,2552,2564,-13,-1,160,4103540,1872
391,m1508,20150630,2552,2564,2591,2591,2510,2521,2544,-43,-20,216,5496160,1884
392,m1508,20150701,2521,2544,2530,2645,2525,2645,2613,101,69,114,2978960,1912
393,m1508,20150702,2645,2613,2631,2665,2609,2655,2635,42,22,446,11755180,2108
394,m1508,20150703,2655,2635,2651,2733,2530,2695,2683,60,48,464,12451900,2168
395,m1508,20150706,2695,2683,2686,2691,2642,2663,2674,-20,-9,172,4600620,2100
396,m1508,20150707,2663,2674,2656,2726,2646,2674,2695,0,21,216,5822040,2084
397,m1508,20150708,2674,2695,2645,2680,2588,2588,2614,-107,-81,892,23325280,2268
398,m1508,20150709,2588,2614,2620,2689,2510,2649,2634,35,20,312,8218160,2214
399,m1508,20150710,2649,2634,2694,2739,2675,2739,2716,105,82,402,10918420,2186
400,m1508,20150713,2739,2716,2724,2740,2616,2704,2690,-12,-26,326,8772180,2084
401,m1508,20150714,2704,2690,2704,2796,2688,2772,2742,82,52,352,9652260,2100
402,m1508,20150715,2772,2742,2782,2788,2736,2747,2764,5,22,194,5363960,2078
403,m1508,20150716,2747,2764,2729,2770,2710,2741,2739,-23,-25,138,3780860,2070
404,m1508,20150717,2741,2739,2765,2793,2691,2695,2719,-44,-20,246,6690500,2080
405,m1508,20150720,2695,2719,2790,2790,2645,2680,2676,-39,-43,124,3319040,2080
406,m1508,20150721,2680,2676,2674,2690,2652,2690,2680,14,4,168,4504000,2046
407,m1508,20150722,2690,2680,2700,2735,2678,2711,2702,31,22,800,21621760,1842
408,m1508,20150723,2711,2702,2698,2735,2698,2704,2711,2,9,298,8081180,1826
409,m1508,20150724,2704,2711,2702,2708,2617,2669,2681,-42,-30,298,7990940,1822
410,m1508,20150727,2669,2681,2675,2675,2617,2620,2646,-61,-35,98,2593680,1820
411,m1508,20150728,2620,2646,2615,2697,2606,2634,2623,-12,-23,428,11227860,1818
412,m1508,20150729,2634,2623,2639,2652,2533,2613,2619,-10,-4,180,4714460,1816
413,m1508,20150730,2613,2619,2612,2694,2610,2612,2619,-7,0,96,2514640,1814
414,m1508,20150731,2612,2619,2601,2653,2580,2580,2614,-39,-5,84,2196440,1800
415,m1508,20150803,2580,2614,2580,2620,2580,2600,2611,-14,-3,402,10496400,1800
416,m1508,20150804,2600,2611,2620,2620,2620,2620,2620,9,9,12,314400,1800
417,m1508,20150805,2620,2620,0,0,0,2620,2620,0,0,0,0,1800
418,m1508,20150806,2620,2620,0,0,0,2620,2620,0,0,0,0,1800
419,m1508,20150807,2620,2620,2580,2580,2580,2580,2580,-40,-40,2,51600,1800
420,m1508,20150810,2580,2580,0,0,0,2580,2580,0,0,0,0,1800
421,m1508,20150811,2580,2580,0,0,0,2622,2622,42,42,0,0,1800
422,m1508,20150812,2622,2622,0,0,0,2640,2640,18,18,0,0,1800
423,m1508,20150813,2640,2640,0,0,0,2640,2640,0,0,0,0,1800
424,m1508,20150814,2640,2640,0,0,0,2611,2611,-29,-29,0,0,0
425,m1509,20150105,2858,2868,2805,2820,2793,2797,2808,-71,-60,357632,10045724400,1252442
426,m1509,20150106,2797,2808,2810,2856,2803,2838,2833,30,25,471830,13370528020,1182780
427,m1509,20150107,2838,2833,2850,2863,2835,2842,2849,9,16,273078,7780047940,1177402
428,m1509,20150108,2842,2849,2846,2860,2838,2852,2847,3,-2,303602,8646322120,1160196
429,m1509,20150109,2852,2847,2852,2860,2812,2821,2830,-26,-17,312352,8842183860,1190044
430,m1509,20150112,2821,2830,2826,2839,2814,2824,2827,-6,-3,211964,5992865160,1194400
431,m1509,20150113,2824,2827,2812,2833,2762,2778,2785,-49,-42,467774,13028848180,1257168
432,m1509,20150114,2778,2785,2785,2785,2712,2715,2742,-70,-43,636438,17451797940,1292092
433,m1509,20150115,2715,2742,2705,2747,2698,2739,2726,-3,-16,445390,12144683240,1254252
434,m1509,20150116,2739,2726,2740,2758,2690,2708,2713,-18,-13,658050,17856169160,1293596
435,m1509,20150119,2708,2713,2709,2734,2624,2683,2687,-30,-26,1084734,29154633960,1231092
436,m1509,20150120,2683,2687,2685,2685,2652,2675,2666,-12,-21,563436,15024212380,1246458
437,m1509,20150121,2675,2666,2683,2725,2652,2695,2689,29,23,689848,18551747580,1289164
438,m1509,20150122,2695,2689,2692,2719,2684,2701,2701,12,12,491184,13270788300,1336654
439,m1509,20150123,2701,2701,2713,2715,2674,2687,2687,-14,-14,368252,9895104740,1358642
440,m1509,20150126,2687,2687,2677,2704,2670,2685,2687,-2,0,526860,14157868120,1387608
441,m1509,20150127,2685,2687,2681,2730,2680,2708,2709,21,22,476158,12900649560,1382858
442,m1509,20150128,2708,2709,2709,2715,2692,2705,2702,-4,-7,309654,8369052620,1402420
443,m1509,20150129,2705,2702,2697,2716,2690,2696,2697,-6,-5,288216,7773821580,1401856
444,m1509,20150130,2696,2697,2696,2711,2688,2701,2700,4,3,331846,8962100240,1372136
445,m1509,20150202,2701,2700,2698,2702,2665,2675,2677,-25,-23,518966,13893344080,1335732
446,m1509,20150203,2675,2677,2695,2707,2675,2701,2693,24,16,391610,10548015680,1321458
447,m1509,20150204,2701,2693,2710,2754,2698,2728,2732,35,39,666184,18201106520,1353996
448,m1509,20150205,2728,2732,2729,2735,2708,2718,2719,-14,-13,356778,9704135560,1393044
449,m1509,20150206,2718,2719,2725,2744,2719,2729,2730,10,11,405348,11068915680,1399570
450,m1509,20150209,2729,2730,2735,2739,2716,2739,2728,9,-2,366070,9989586480,1394596
451,m1509,20150210,2739,2728,2738,2755,2731,2731,2741,3,13,499126,13682778880,1420060
452,m1509,20150211,2731,2741,2732,2749,2712,2727,2725,-14,-16,681276,18565707240,1544008
453,m1509,20150212,2727,2725,2725,2734,2716,2723,2725,-2,0,276234,7528331640,1543084
454,m1509,20150213,2723,2725,2727,2765,2724,2754,2744,29,19,720464,19771265200,1488472
455,m1509,20150216,2754,2744,2753,2775,2741,2752,2756,8,12,523832,14441777420,1524324
456,m1509,20150217,2752,2756,2752,2767,2744,2765,2757,9,1,267748,7382919280,1515604
457,m1509,20150225,2765,2757,2800,2804,2777,2784,2788,27,31,360310,10048297800,1516846
458,m1509,20150226,2784,2788,2784,2827,2777,2808,2806,20,18,1100450,30881596740,1770728
459,m1509,20150227,2808,2806,2818,2880,2808,2863,2844,57,38,2140298,60881289200,1992436
460,m1509,20150302,2863,2844,2869,2875,2842,2861,2859,17,15,1904162,54457832380,2182690
461,m1509,20150303,2861,2859,2853,2864,2807,2820,2831,-39,-28,2058066,58283911600,2300520
462,m1509,20150304,2820,2831,2823,2826,2795,2817,2811,-14,-20,1563664,43969855640,2402506
463,m1509,20150305,2817,2811,2805,2809,2769,2781,2784,-30,-27,1620220,45119572060,2386236
464,m1509,20150306,2781,2784,2781,2801,2761,2762,2781,-22,-3,1734038,48238337100,2486742
465,m1509,20150309,2762,2781,2766,2798,2754,2787,2780,6,-1,1894096,52661894360,2532186
466,m1509,20150310,2787,2780,2782,2807,2782,2786,2793,6,13,1637750,45757999460,2526668
467,m1509,20150311,2786,2793,2783,2844,2766,2822,2804,29,11,3597522,1.00888E+11,2658142
468,m1509,20150312,2822,2804,2820,2858,2811,2839,2833,35,29,2935928,83185262780,2707320
469,m1509,20150313,2839,2833,2838,2847,2802,2810,2821,-23,-12,3339740,94242273060,2731938
470,m1509,20150316,2810,2821,2802,2809,2766,2785,2787,-36,-34,2193840,61159256900,2796188
471,m1509,20150317,2785,2787,2792,2810,2778,2781,2792,-6,5,2045880,57125309660,2925680
472,m1509,20150318,2781,2792,2775,2781,2750,2752,2766,-40,-26,2067994,57209152920,3033172
473,m1509,20150319,2752,2766,2761,2797,2750,2776,2772,10,6,1863808,51678119240,3062468
474,m1509,20150320,2776,2772,2768,2777,2756,2773,2766,1,-6,1635004,45230493340,3072698
475,m1509,20150323,2773,2766,2775,2816,2771,2805,2796,39,30,2344270,65563267640,3162234
476,m1509,20150324,2805,2796,2804,2827,2787,2818,2810,22,14,2408170,67685509200,3241714
477,m1509,20150325,2818,2810,2815,2821,2795,2799,2806,-11,-4,2111250,59255747600,3239636
478,m1509,20150326,2799,2806,2803,2811,2777,2780,2793,-26,-13,1920590,53656607460,3272778
479,m1509,20150327,2780,2793,2773,2784,2763,2782,2775,-11,-18,1588942,44094765040,3299814
480,m1509,20150330,2782,2775,2776,2781,2757,2763,2768,-12,-7,1833266,50757754280,3334668
481,m1509,20150331,2763,2768,2760,2766,2737,2753,2752,-15,-16,2352584,64761493880,3359370
482,m1509,20150401,2753,2752,2748,2822,2746,2794,2789,42,37,4194538,1.16989E+11,3258912
483,m1509,20150402,2794,2789,2794,2817,2787,2798,2803,9,14,2342528,65664456680,3239996
484,m1509,20150403,2798,2803,2790,2799,2770,2773,2784,-30,-19,2003270,55785360820,3219262
485,m1509,20150407,2773,2784,2765,2789,2762,2768,2772,-16,-12,1015032,28146335340,3318882
486,m1509,20150408,2768,2772,2760,2771,2750,2763,2761,-9,-11,1653240,45660969860,3420206
487,m1509,20150409,2763,2761,2763,2769,2708,2708,2732,-53,-29,2683294,73324666240,3605968
488,m1509,20150410,2708,2732,2708,2715,2676,2682,2697,-50,-35,2819572,76055624280,3605558
489,m1509,20150413,2682,2697,2686,2708,2674,2692,2690,-5,-7,2473190,66544520900,3594528
490,m1509,20150414,2692,2690,2691,2698,2682,2696,2690,6,0,1354824,36454979420,3603500
491,m1509,20150415,2696,2690,2707,2719,2700,2708,2711,18,21,1671496,45317080740,3616028
492,m1509,20150416,2708,2711,2705,2723,2690,2695,2705,-16,-6,2446088,66187040020,3749874
493,m1509,20150417,2695,2705,2698,2709,2694,2707,2702,2,-3,1511298,40837161720,3740534
494,m1509,20150420,2707,2702,2707,2731,2697,2719,2714,17,12,2038562,55338543580,3664830
495,m1509,20150421,2719,2714,2722,2728,2711,2726,2720,12,6,1489304,40512978880,3669178
496,m1509,20150422,2726,2720,2723,2734,2702,2709,2713,-11,-7,1735768,47099945960,3767378
497,m1509,20150423,2709,2713,2707,2728,2703,2720,2716,7,3,1464392,39785964100,3654578
498,m1509,20150424,2720,2716,2720,2750,2720,2733,2737,17,21,2244310,61427504760,3596618
499,m1509,20150427,2733,2737,2733,2748,2724,2741,2734,4,-3,1667272,45599354840,3712272
500,m1509,20150428,2741,2734,2741,2780,2739,2764,2761,30,27,2643874,73022001840,3839560
501,m1509,20150429,2764,2761,2773,2783,2740,2746,2761,-15,0,2190182,60491186280,3777730
502,m1509,20150430,2746,2761,2752,2775,2744,2772,2761,11,0,1750846,48357447280,3789542
503,m1509,20150504,2772,2761,2735,2740,2720,2730,2731,-31,-30,1257472,34342934460,3874420
504,m1509,20150505,2730,2731,2728,2756,2713,2730,2737,-1,6,2309590,63230818300,3932496
505,m1509,20150506,2730,2737,2730,2759,2728,2748,2742,11,5,2054582,56348150060,3987802
506,m1509,20150507,2748,2742,2743,2769,2735,2754,2752,12,10,2942034,80981071080,4005146
507,m1509,20150508,2754,2752,2752,2757,2725,2727,2736,-25,-16,1862234,50964062520,4055578
508,m1509,20150511,2727,2736,2729,2741,2723,2733,2732,-3,-4,1411918,38587604960,4101558
509,m1509,20150512,2733,2732,2730,2737,2686,2688,2705,-44,-27,2577354,69717665080,4251210
510,m1509,20150513,2688,2705,2688,2710,2670,2677,2687,-28,-18,2161540,58095760200,4315196
511,m1509,20150514,2677,2687,2681,2691,2664,2672,2675,-15,-12,1962450,52511853520,4381246
512,m1509,20150515,2672,2675,2672,2684,2670,2672,2676,-3,1,1292174,34590689740,4383014
513,m1509,20150518,2672,2676,2674,2680,2653,2671,2665,-5,-11,1594348,42498200600,4463942
514,m1509,20150519,2671,2665,2676,2685,2659,2662,2674,-3,9,1530002,40916805920,4481244
515,m1509,20150520,2662,2674,2655,2656,2574,2590,2616,-84,-58,3398278,88903293840,4273908
516,m1509,20150521,2590,2616,2588,2603,2581,2583,2593,-33,-23,1778018,46106429660,4291252
517,m1509,20150522,2583,2593,2584,2600,2565,2587,2580,-6,-13,2158036,55689576020,4356782
518,m1509,20150525,2587,2580,2588,2600,2530,2535,2555,-45,-25,2138842,54662233160,4406198
519,m1509,20150526,2535,2555,2539,2553,2526,2528,2541,-27,-14,2094650,53235280440,4449180
520,m1509,20150527,2528,2541,2520,2551,2514,2533,2536,-8,-5,1979394,50201370440,4464104
521,m1509,20150528,2533,2536,2538,2569,2536,2556,2557,20,21,2369644,60599135480,4331760
522,m1509,20150529,2556,2557,2557,2565,2544,2553,2553,-4,-4,1580138,40354248040,4323452
523,m1509,20150601,2553,2553,2547,2558,2516,2519,2535,-34,-18,2167382,54948750160,4520182
524,m1509,20150602,2519,2535,2524,2562,2517,2556,2537,21,2,2926394,74261890180,4434028
525,m1509,20150603,2556,2537,2560,2582,2559,2571,2567,34,30,2080584,53417670580,4347564
526,m1509,20150604,2571,2567,2569,2575,2541,2566,2559,-1,-8,2350754,60166467300,4329160
527,m1509,20150605,2566,2559,2568,2578,2557,2564,2567,5,8,1691310,43432534160,4206714
528,m1509,20150608,2564,2567,2565,2572,2541,2551,2555,-16,-12,1344738,34367518600,4205952
529,m1509,20150609,2551,2555,2558,2569,2555,2561,2562,6,7,1091082,27961702220,4128464
530,m1509,20150610,2561,2562,2559,2571,2551,2553,2562,-9,0,1104890,28311793300,4134584
531,m1509,20150611,2553,2562,2558,2567,2553,2555,2560,-7,-2,1075394,27533939920,4101636
532,m1509,20150612,2555,2560,2549,2549,2479,2490,2511,-70,-49,3081766,77402206640,4117618
533,m1509,20150615,2490,2511,2497,2498,2445,2454,2469,-57,-42,2397950,59222624500,4023858
534,m1509,20150616,2454,2469,2450,2478,2440,2475,2460,6,-9,1832360,45085459360,3934114
535,m1509,20150617,2475,2460,2474,2547,2446,2522,2508,62,48,2888848,72469959280,3836360
536,m1509,20150618,2522,2508,2515,2531,2501,2505,2516,-3,8,1220412,30710206580,3810298
537,m1509,20150619,2505,2516,2505,2556,2495,2532,2529,16,13,2213308,55989795120,3629792
538,m1509,20150623,2532,2529,2586,2611,2586,2599,2599,70,70,1495402,38868723860,3478408
539,m1509,20150624,2599,2599,2585,2595,2568,2573,2579,-26,-20,1555962,40137677500,3575776
540,m1509,20150625,2573,2579,2571,2585,2559,2573,2573,-6,-6,1185476,30508404020,3571822
541,m1509,20150626,2573,2573,2590,2626,2583,2604,2605,31,32,2526050,65809181780,3411680
542,m1509,20150629,2604,2605,2644,2649,2582,2600,2615,-5,10,2705410,70749825320,3107002
543,m1509,20150630,2600,2615,2605,2618,2548,2556,2574,-59,-41,2284550,58815530880,2929526
544,m1509,20150701,2556,2574,2565,2676,2544,2676,2642,102,68,3199970,84550027920,2695810
545,m1509,20150702,2676,2642,2678,2705,2670,2702,2685,60,43,2486068,66757893440,2365428
546,m1509,20150703,2702,2685,2690,2749,2685,2736,2720,51,35,2589328,70436702020,2358742
547,m1509,20150706,2736,2720,2732,2737,2674,2700,2707,-20,-13,2238886,60621907360,2163816
548,m1509,20150707,2700,2707,2690,2753,2682,2709,2720,2,13,3007226,81825021460,2082922
549,m1509,20150708,2709,2720,2709,2711,2612,2612,2640,-108,-80,2746922,72537250100,1714962
550,m1509,20150709,2612,2640,2563,2719,2482,2663,2629,23,-11,3475602,91376697920,1531924
551,m1509,20150710,2663,2629,2696,2734,2678,2734,2714,105,85,1845270,50092002560,1498254
552,m1509,20150713,2734,2714,2754,2772,2690,2732,2735,18,21,1982272,54217234700,1467390
553,m1509,20150714,2732,2735,2717,2838,2712,2806,2785,71,50,3276754,91272688640,1402588
554,m1509,20150715,2806,2785,2798,2821,2763,2789,2788,4,3,2772164,77306372400,1349788
555,m1509,20150716,2789,2788,2786,2796,2728,2784,2761,-4,-27,2527274,69790450740,1268096
556,m1509,20150717,2784,2761,2793,2812,2709,2720,2757,-41,-4,2394846,66033147680,1237690
557,m1509,20150720,2720,2757,2707,2737,2665,2685,2699,-72,-58,1779900,48047119060,1183888
558,m1509,20150721,2685,2699,2680,2718,2671,2699,2698,0,-1,1360282,36707809940,1172750
559,m1509,20150722,2699,2698,2700,2735,2692,2735,2714,37,16,1371202,37218694660,1132142
560,m1509,20150723,2735,2714,2714,2742,2707,2724,2725,10,11,1253366,34165042980,1088082
561,m1509,20150724,2724,2725,2715,2735,2681,2698,2709,-27,-16,1092484,29599077880,1074716
562,m1509,20150727,2698,2709,2702,2702,2640,2642,2669,-67,-40,767850,20497599480,1021476
563,m1509,20150728,2642,2669,2637,2656,2616,2647,2639,-22,-30,818530,21608531100,965510
564,m1509,20150729,2647,2639,2655,2666,2627,2641,2647,2,8,615598,16297835740,923198
565,m1509,20150730,2641,2647,2640,2665,2634,2646,2650,-1,3,522942,13859730440,890034
566,m1509,20150731,2646,2650,2665,2670,2636,2653,2651,3,1,446744,11846158420,832852
567,m1509,20150803,2653,2651,2646,2660,2614,2623,2635,-28,-16,389746,10271319260,812136
568,m1509,20150804,2623,2635,2620,2666,2609,2662,2643,27,8,417386,11032594840,799460
569,m1509,20150805,2662,2643,2658,2682,2657,2672,2669,29,26,389640,10402382800,753098
570,m1509,20150806,2672,2669,2688,2691,2660,2680,2676,11,7,329556,8821261080,726726
571,m1509,20150807,2680,2676,2674,2690,2646,2665,2666,-11,-10,417130,11123249420,646394
572,m1509,20150810,2665,2666,2670,2732,2661,2726,2703,60,37,363462,9826839480,578754
573,m1509,20150811,2726,2703,2723,2766,2723,2752,2740,49,37,335692,9200595120,523910
574,m1509,20150812,2752,2740,2755,2755,2714,2729,2727,-11,-13,326046,8892996960,455666
575,m1509,20150813,2729,2727,2749,2758,2618,2653,2676,-74,-51,437736,11716926020,367812
576,m1509,20150814,2653,2676,2651,2668,2645,2647,2655,-29,-21,192446,5110401100,310550
577,m1509,20150817,2647,2655,2642,2652,2636,2649,2645,-6,-10,59336,1569800740,301984
578,m1509,20150818,2649,2645,2652,2664,2646,2647,2654,2,9,59822,1588265600,281254
579,m1509,20150819,2647,2654,2638,2639,2591,2628,2618,-26,-36,94346,2470084360,249574
580,m1509,20150820,2628,2618,2640,2648,2614,2628,2632,10,14,112312,2956216120,191580
581,m1509,20150821,2628,2632,2630,2662,2620,2639,2642,7,10,67846,1793109100,154196
582,m1509,20150824,2639,2642,2642,2650,2563,2585,2603,-57,-39,95760,2493471540,95988
583,m1509,20150825,2585,2603,2555,2643,2555,2625,2608,22,5,65092,1697961300,66632
584,m1509,20150826,2625,2608,2668,2699,2611,2622,2634,14,26,31454,828592000,53372
585,m1509,20150827,2622,2634,2630,2647,2606,2640,2624,6,-10,31994,839787640,37668
586,m1509,20150828,2640,2624,2639,2650,2615,2631,2630,7,6,27800,731351380,22554
587,m1509,20150831,2631,2630,2603,2660,2588,2588,2620,-42,-10,25692,673175760,9352
588,m1509,20150901,2588,2620,2583,2659,2565,2595,2591,-25,-29,5416,140348740,5886
589,m1509,20150902,2595,2591,2602,2620,2594,2620,2605,29,14,2234,58198060,4936
590,m1509,20150907,2620,2605,2598,2642,2592,2593,2595,-12,-10,1500,38930140,4554
591,m1509,20150908,2593,2595,2595,2622,2595,2613,2602,18,7,2696,70153080,4136
592,m1509,20150909,2613,2602,2757,2757,2603,2688,2649,86,47,2000,52999000,3282
593,m1509,20150910,2688,2649,2591,2676,2591,2604,2648,-45,-1,456,12078520,3148
594,m1509,20150911,2604,2648,2650,2650,2650,2650,2650,2,2,166,4399000,3148
595,m1509,20150914,2650,2650,2600,2636,2600,2636,2601,-14,-49,100,2601320,3034
596,m1509,20150915,2636,2601,2650,2682,2650,2651,2662,50,61,1700,45263800,2766
597,m1509,20150916,2651,2662,2661,2661,2661,2661,2618,-1,-44,2650,70358260,0
598,m1511,20150105,2842,2849,2764,2810,2764,2795,2803,-54,-46,212,5943140,1044
599,m1511,20150106,2795,2803,2808,2845,2803,2840,2830,37,27,190,5377220,986
600,m1511,20150107,2840,2830,2854,2855,2829,2836,2841,6,11,152,4319820,960
601,m1511,20150108,2836,2841,2843,2849,2833,2843,2842,2,1,46,1307560,952
602,m1511,20150109,2843,2842,2857,2857,2809,2819,2823,-23,-19,54,1524800,968
603,m1511,20150112,2819,2823,2826,2828,2818,2818,2824,-5,1,40,1129660,952
604,m1511,20150113,2818,2824,2819,2825,2766,2775,2781,-49,-43,224,6231660,922
605,m1511,20150114,2775,2781,2775,2780,2678,2712,2734,-69,-47,292,7985980,908
606,m1511,20150115,2712,2734,2710,2740,2701,2739,2728,5,-6,138,3765140,888
607,m1511,20150116,2739,2728,2747,2751,2693,2707,2711,-21,-17,364,9869540,792
608,m1511,20150119,2707,2711,2721,2773,2622,2725,2729,14,18,882,24072100,624
609,m1511,20150120,2725,2729,2706,2730,2706,2726,2718,-3,-11,192,5218880,584
610,m1511,20150121,2726,2718,2725,2784,2693,2720,2719,2,1,338,9190760,610
611,m1511,20150122,2720,2719,2713,2742,2713,2727,2729,8,10,14,382180,604
612,m1511,20150123,2727,2729,2723,2733,2701,2718,2722,-11,-7,52,1415760,596
613,m1511,20150126,2718,2722,2739,2739,2710,2710,2728,-12,6,50,1364060,600
614,m1511,20150127,2710,2728,2740,2767,2734,2765,2748,37,20,82,2253700,582
615,m1511,20150128,2765,2748,2762,2762,2734,2750,2752,2,4,26,715700,576
616,m1511,20150129,2750,2752,2747,2760,2735,2736,2742,-16,-10,34,932460,580
617,m1511,20150130,2736,2742,2746,2748,2715,2744,2740,2,-2,20,548020,578
618,m1511,20150202,2744,2740,2751,2751,2714,2727,2722,-13,-18,42,1143500,588
619,m1511,20150203,2727,2722,2726,2745,2726,2740,2734,18,12,20,546880,580
620,m1511,20150204,2740,2734,2740,2783,2739,2764,2760,30,26,86,2374420,550
621,m1511,20150205,2764,2760,2761,2761,2761,2761,2761,1,1,2,55220,548
622,m1511,20150206,2761,2761,2762,2772,2753,2763,2764,2,3,26,718800,540
623,m1511,20150209,2763,2764,2762,2762,2762,2762,2762,-2,-2,2,55240,538
624,m1511,20150210,2762,2762,2772,2826,2745,2775,2774,13,12,108,2996080,500
625,m1511,20150211,2775,2774,2773,2779,2763,2763,2772,-11,-2,24,665300,502
626,m1511,20150212,2763,2772,2732,2770,2732,2769,2763,-3,-9,44,1215800,502
627,m1511,20150213,2769,2763,2772,2796,2764,2781,2780,18,17,76,2113020,494
628,m1511,20150216,2781,2780,2768,2798,2768,2776,2790,-4,10,42,1172160,486
629,m1511,20150217,2776,2790,2796,2797,2786,2797,2792,7,2,24,670280,480
630,m1511,20150225,2797,2792,2833,2833,2810,2810,2820,18,28,30,846280,482
631,m1511,20150226,2810,2820,2820,2845,2820,2840,2832,20,12,102,2889300,464
632,m1511,20150227,2840,2832,2840,2879,2833,2876,2857,44,25,134,3829380,434
633,m1511,20150302,2876,2857,2884,2887,2867,2878,2882,21,25,108,3112880,410
634,m1511,20150303,2878,2882,2875,2884,2833,2843,2868,-39,-14,26,745920,412
635,m1511,20150304,2843,2868,2842,2846,2840,2845,2843,-23,-25,14,398100,404
636,m1511,20150305,2845,2843,2831,2834,2811,2824,2820,-19,-23,70,1974480,406
637,m1511,20150306,2824,2820,2825,2833,2800,2811,2817,-9,-3,52,1465240,418
638,m1511,20150309,2811,2817,2806,2825,2797,2825,2809,8,-8,32,899100,424
639,m1511,20150310,2825,2809,2815,2832,2815,2827,2825,18,16,22,621680,424
640,m1511,20150311,2827,2825,2821,2861,2821,2848,2849,23,24,56,1595640,442
641,m1511,20150312,2848,2849,2857,2873,2851,2873,2859,24,10,78,2230140,444
642,m1511,20150313,2873,2859,2886,2886,2828,2834,2841,-25,-18,66,1875580,466
643,m1511,20150316,2834,2841,2801,2808,2801,2808,2804,-33,-37,6,168280,464
644,m1511,20150317,2808,2804,2821,2826,2811,2818,2820,14,16,18,507600,454
645,m1511,20150318,2818,2820,2805,2810,2791,2793,2799,-27,-21,32,895720,450
646,m1511,20150319,2793,2799,2794,2823,2790,2811,2804,12,5,26,729200,444
647,m1511,20150320,2811,2804,2810,2810,2800,2800,2803,-4,-1,12,336400,442
648,m1511,20150323,2800,2803,2816,2857,2816,2835,2846,32,43,166,4725860,544
649,m1511,20150324,2835,2846,2832,2849,2810,2830,2834,-16,-12,184,5215900,572
650,m1511,20150325,2830,2834,2834,2845,2823,2830,2832,-4,-2,98,2775420,558
651,m1511,20150326,2830,2832,2828,2828,2800,2802,2807,-30,-25,34,954440,556
652,m1511,20150327,2802,2807,2802,2811,2802,2804,2805,-3,-2,10,280500,550
653,m1511,20150330,2804,2805,2792,2811,2792,2794,2803,-11,-2,34,953040,544
654,m1511,20150331,2794,2803,2770,2801,2755,2779,2771,-24,-32,290,8037860,508
655,m1511,20150401,2779,2771,2779,2850,2779,2815,2828,44,57,100,2828380,482
656,m1511,20150402,2815,2828,2818,2840,2798,2831,2819,3,-9,192,5414260,492
657,m1511,20150403,2831,2819,2811,2824,2746,2819,2810,0,-9,28,786980,486
658,m1511,20150407,2819,2810,2810,2810,2796,2806,2803,-4,-7,24,672760,492
659,m1511,20150408,2806,2803,0,0,0,2803,2803,0,0,0,0,492
660,m1511,20150409,2803,2803,2801,2801,2760,2777,2784,-26,-19,16,445500,496
661,m1511,20150410,2777,2784,2741,2743,2707,2707,2734,-77,-50,120,3281140,488
662,m1511,20150413,2707,2734,2726,2744,2711,2732,2727,-2,-7,22,600060,486
663,m1511,20150414,2732,2727,2722,2727,2715,2715,2722,-12,-5,16,435580,486
664,m1511,20150415,2715,2722,2740,2745,2717,2741,2728,19,6,98,2673820,460
665,m1511,20150416,2741,2728,2731,2754,2730,2740,2742,12,14,28,767760,454
666,m1511,20150417,2740,2742,2737,2746,2733,2741,2740,-1,-2,84,2301680,456
667,m1511,20150420,2741,2740,2743,2760,2733,2746,2745,6,5,30,823500,456
668,m1511,20150421,2746,2745,2755,2756,2751,2756,2754,11,9,6,165240,450
669,m1511,20150422,2756,2754,2754,2754,2740,2742,2742,-12,-12,40,1097100,434
670,m1511,20150423,2742,2742,2739,2757,2739,2749,2749,7,7,28,769800,428
671,m1511,20150424,2749,2749,2765,2778,2765,2765,2769,16,20,142,3933100,438
672,m1511,20150427,2765,2769,2762,2769,2760,2767,2763,-2,-6,22,607900,428
673,m1511,20150428,2767,2763,2783,2808,2781,2795,2791,32,28,78,2177480,396
674,m1511,20150429,2795,2791,2807,2807,2775,2775,2792,-16,1,46,1284340,414
675,m1511,20150430,2775,2792,2778,2821,2778,2795,2796,3,4,30,838920,396
676,m1511,20150504,2795,2796,2762,2762,2756,2756,2761,-40,-35,12,331320,390
677,m1511,20150505,2756,2761,2773,2774,2750,2760,2766,-1,5,36,995840,398
678,m1511,20150506,2760,2766,2762,2784,2762,2780,2773,14,7,52,1442400,406
679,m1511,20150507,2780,2773,2790,2794,2779,2779,2787,6,14,32,891860,400
680,m1511,20150508,2779,2787,2785,2785,2761,2761,2767,-26,-20,44,1217540,420
681,m1511,20150511,2761,2767,2761,2778,2761,2775,2768,8,1,270,7473900,434
682,m1511,20150512,2775,2768,2745,2753,2725,2729,2734,-39,-34,78,2132660,472
683,m1511,20150513,2729,2734,2733,2733,2718,2721,2721,-13,-13,26,707560,476
684,m1511,20150514,2721,2721,2698,2747,2698,2707,2711,-14,-10,30,813500,484
685,m1511,20150515,2707,2711,2720,2722,2712,2715,2719,4,8,68,1849220,458
686,m1511,20150518,2715,2719,2712,2712,2699,2705,2705,-14,-14,44,1190360,444
687,m1511,20150519,2705,2705,2709,2722,2700,2700,2707,-5,2,48,1299420,442
688,m1511,20150520,2700,2707,2674,2682,2616,2619,2648,-88,-59,124,3283700,424
689,m1511,20150521,2619,2648,2622,2640,2618,2619,2626,-29,-22,66,1733760,404
690,m1511,20150522,2619,2626,2632,2634,2599,2617,2608,-9,-18,92,2399640,396
691,m1511,20150525,2617,2608,2619,2620,2574,2575,2597,-33,-11,42,1091000,396
692,m1511,20150526,2575,2597,2588,2593,2576,2576,2584,-21,-13,18,465120,400
693,m1511,20150527,2576,2584,2570,2610,2570,2573,2580,-11,-4,34,877460,400
694,m1511,20150528,2573,2580,2583,2608,2583,2594,2592,14,12,88,2281620,390
695,m1511,20150529,2594,2592,2594,2599,2583,2587,2590,-5,-2,30,777140,384
696,m1511,20150601,2587,2590,2575,2575,2570,2570,2571,-20,-19,10,257140,386
697,m1511,20150602,2570,2571,2567,2593,2566,2593,2581,22,10,26,671200,382
698,m1511,20150603,2593,2581,2611,2616,2604,2615,2610,34,29,10,261000,378
699,m1511,20150604,2615,2610,2613,2618,2547,2616,2577,6,-33,298,7681740,382
700,m1511,20150605,2616,2577,2607,2627,2605,2619,2611,42,34,56,1462420,352
701,m1511,20150608,2619,2611,2617,2625,2607,2613,2613,2,2,34,888640,356
702,m1511,20150609,2613,2613,2618,2629,2612,2612,2615,-1,2,36,941700,370
703,m1511,20150610,2612,2615,2624,2624,2612,2619,2621,4,6,24,629220,380
704,m1511,20150611,2619,2621,2618,2618,2614,2618,2616,-3,-5,18,471000,378
705,m1511,20150612,2618,2616,2598,2600,2527,2548,2561,-68,-55,56,1434620,374
706,m1511,20150615,2548,2561,2569,2569,2508,2508,2526,-53,-35,96,2424960,420
707,m1511,20150616,2508,2526,2496,2526,2495,2526,2511,0,-15,28,703260,408
708,m1511,20150617,2526,2511,2550,2578,2550,2569,2568,58,57,42,1078700,386
709,m1511,20150618,2569,2568,2565,2575,2551,2566,2563,-2,-5,28,717860,394
710,m1511,20150619,2566,2563,2532,2598,2532,2593,2574,30,11,56,1441720,396
711,m1511,20150623,2593,2574,2641,2648,2635,2637,2637,63,63,72,1898940,384
712,m1511,20150624,2637,2637,2627,2634,2616,2626,2624,-11,-13,32,839840,398
713,m1511,20150625,2626,2624,2635,2635,2609,2619,2618,-5,-6,42,1099600,394
714,m1511,20150626,2619,2618,2643,2661,2643,2645,2652,27,34,44,1166900,392
715,m1511,20150629,2645,2652,2664,2664,2631,2640,2650,-12,-2,56,1484280,414
716,m1511,20150630,2640,2650,2638,2653,2575,2615,2607,-35,-43,74,1929400,438
717,m1511,20150701,2615,2607,2633,2711,2633,2711,2703,104,96,162,4380380,400
718,m1511,20150702,2711,2703,2717,2732,2682,2732,2710,29,7,140,3794300,374
719,m1511,20150703,2732,2710,2724,2766,2724,2755,2744,45,34,106,2909100,358
720,m1511,20150706,2755,2744,2737,2738,2688,2716,2721,-28,-23,154,4190760,388
721,m1511,20150707,2716,2721,2703,2760,2694,2736,2735,15,14,120,3282100,372
722,m1511,20150708,2736,2735,2706,2844,2626,2626,2693,-109,-42,152,4094060,314
723,m1511,20150709,2626,2693,2693,2735,2586,2698,2665,5,-28,168,4478680,296
724,m1511,20150710,2698,2665,2742,2771,2720,2771,2747,106,82,58,1593400,290
725,m1511,20150713,2771,2747,2736,2795,2720,2765,2777,18,30,106,2944380,298
726,m1511,20150714,2765,2777,2770,2851,2752,2834,2819,57,42,104,2932180,318
727,m1511,20150715,2834,2819,2812,2849,2780,2809,2810,-10,-9,272,7644820,396
728,m1511,20150716,2809,2810,2792,2829,2765,2795,2782,-15,-28,164,4562620,378
729,m1511,20150717,2795,2782,2799,2799,2736,2753,2774,-29,-8,38,1054260,378
730,m1511,20150720,2753,2774,2722,2760,2692,2725,2723,-49,-51,24,653720,378
731,m1511,20150721,2725,2723,2739,2754,2734,2737,2743,14,20,40,1097300,378
732,m1511,20150722,2737,2743,2756,2770,2725,2770,2755,27,12,20,551140,372
733,m1511,20150723,2770,2755,2779,2782,2734,2750,2754,-5,-1,46,1267120,380
734,m1511,20150724,2750,2754,2760,2760,2720,2745,2743,-9,-11,68,1865820,380
735,m1511,20150727,2745,2743,2708,2740,2680,2715,2723,-28,-20,42,1143980,382
736,m1511,20150728,2715,2723,2715,2715,2674,2694,2689,-29,-34,24,645400,380
737,m1511,20150729,2694,2689,2731,2731,2685,2690,2693,1,4,80,2154700,362
738,m1511,20150730,2690,2693,2690,2710,2690,2693,2701,0,8,82,2215560,334
739,m1511,20150731,2693,2701,2696,2703,2692,2695,2696,-6,-5,8,215720,336
740,m1511,20150803,2695,2696,2692,2692,2655,2670,2677,-26,-19,76,2034780,340
741,m1511,20150804,2670,2677,2689,2725,2681,2725,2695,48,18,24,646840,346
742,m1511,20150805,2725,2695,2725,2727,2700,2727,2717,32,22,24,652220,340
743,m1511,20150806,2727,2717,2703,2784,2703,2727,2723,10,6,92,2505500,336
744,m1511,20150807,2727,2723,2722,2722,2722,2722,2722,-1,-1,6,163320,336
745,m1511,20150810,2722,2722,2724,2777,2724,2776,2750,54,28,112,3080000,340
746,m1511,20150811,2776,2750,2779,2810,2779,2810,2791,60,41,34,949160,336
747,m1511,20150812,2810,2791,2782,2782,2745,2778,2770,-13,-21,30,831000,334
748,m1511,20150813,2778,2770,2803,2811,2662,2718,2777,-52,7,150,4166920,446
749,m1511,20150814,2718,2777,2706,2713,2680,2701,2703,-76,-74,82,2216700,434
750,m1511,20150817,2701,2703,2694,2694,2667,2679,2686,-24,-17,100,2686060,398
751,m1511,20150818,2679,2686,2683,2693,2681,2693,2688,7,2,34,913920,382
752,m1511,20150819,2693,2688,2649,2669,2639,2663,2651,-25,-37,120,3182140,348
753,m1511,20150820,2663,2651,2678,2688,2656,2667,2673,16,22,38,1015900,356
754,m1511,20150821,2667,2673,2673,2682,2673,2682,2677,9,4,4,107100,356
755,m1511,20150824,2682,2677,2647,2647,2601,2609,2616,-68,-61,56,1465280,356
756,m1511,20150825,2609,2616,2518,2697,2518,2653,2633,37,17,174,4581700,308
757,m1511,20150826,2653,2633,2723,2723,2609,2678,2677,45,44,88,2356540,302
758,m1511,20150827,2678,2677,2686,2699,2672,2679,2683,2,6,34,912380,300
759,m1511,20150828,2679,2683,2694,2736,2684,2685,2698,2,15,124,3346720,382
760,m1511,20150831,2685,2698,2686,2688,2621,2621,2658,-77,-40,118,3137520,342
761,m1511,20150901,2621,2658,2667,2674,2637,2665,2661,7,3,48,1277700,320
762,m1511,20150902,2665,2661,2673,2676,2632,2668,2650,7,-11,124,3286020,340
763,m1511,20150907,2668,2650,2614,2675,2614,2663,2645,13,-5,204,5397540,316
764,m1511,20150908,2663,2645,2676,2686,2655,2664,2671,19,26,134,3579700,332
765,m1511,20150909,2664,2671,2671,2702,2568,2674,2666,3,-5,166,4425980,308
766,m1511,20150910,2674,2666,2679,2699,2669,2685,2677,19,11,36,963880,306
767,m1511,20150911,2685,2677,2674,2675,2670,2670,2672,-7,-5,12,320740,304
768,m1511,20150914,2670,2672,2679,2699,2668,2699,2687,27,15,50,1343960,304
769,m1511,20150915,2699,2687,2712,2737,2701,2717,2714,30,27,64,1737040,306
770,m1511,20150916,2717,2714,2725,2728,2725,2727,2726,13,12,24,654380,308
771,m1511,20150917,2727,2726,2721,2721,2699,2699,2707,-27,-19,74,2003520,282
772,m1511,20150918,2699,2707,2702,2702,2661,2698,2687,-9,-20,8,214960,282
773,m1511,20150921,2698,2687,2694,2694,2632,2651,2664,-36,-23,26,692780,284
774,m1511,20150922,2651,2664,2646,2672,2636,2672,2645,8,-19,10,264520,282
775,m1511,20150923,2672,2645,2666,2666,2662,2662,2665,17,20,8,213200,282
776,m1511,20150924,2662,2665,2662,2687,2619,2640,2659,-25,-6,40,1063780,284
777,m1511,20150925,2640,2659,2659,2679,2626,2678,2670,19,11,96,2563620,276
778,m1511,20150928,2678,2670,0,0,0,2670,2670,0,0,0,0,276
779,m1511,20150929,2670,2670,2635,2681,2635,2666,2666,-4,-4,26,693300,260
780,m1511,20150930,2666,2666,2622,2649,2622,2631,2629,-35,-37,38,999220,260
781,m1511,20151008,2631,2629,2666,2686,2666,2666,2671,37,42,26,694640,256
782,m1511,20151009,2666,2671,2667,2694,2630,2671,2656,0,-15,58,1540640,244
783,m1511,20151012,2671,2656,2660,2680,2626,2680,2666,24,10,56,1493200,206
784,m1511,20151013,2680,2666,2675,2676,2670,2676,2674,10,8,28,748920,206
785,m1511,20151014,2676,2674,2693,2760,2693,2748,2726,74,52,98,2672300,218
786,m1511,20151015,2748,2726,2747,2755,2720,2720,2737,-6,11,158,4324780,142
787,m1511,20151016,2720,2737,2729,2777,2729,2743,2745,6,8,130,3568800,138
788,m1511,20151019,2743,2745,2733,2735,2663,2718,2701,-27,-44,78,2106800,114
789,m1511,20151020,2718,2701,2691,2725,2687,2687,2696,-14,-5,30,809000,110
790,m1511,20151021,2687,2696,2680,2692,2680,2692,2685,-4,-11,12,322280,110
791,m1511,20151022,2692,2685,2667,2703,2667,2703,2695,18,10,20,539040,98
792,m1511,20151023,2703,2695,2686,2686,2602,2602,2613,-93,-82,30,783960,98
793,m1511,20151026,2602,2613,2632,2632,2612,2612,2629,-1,16,38,999320,86
794,m1511,20151027,2612,2629,2629,2629,2629,2629,2629,0,0,20,525800,86
795,m1511,20151028,2629,2629,2699,2699,2603,2638,2642,9,13,18,475620,76
796,m1511,20151029,2638,2642,2605,2666,2605,2666,2624,24,-18,18,472460,66
797,m1511,20151030,2666,2624,2691,2695,2522,2564,2585,-60,-39,32,827240,58
798,m1511,20151102,2564,2585,2470,2470,2470,2470,2470,-115,-115,2,49400,0
799,m1511,20151103,2470,2470,0,0,0,2470,2470,0,0,0,0,0
800,m1511,20151104,2470,2470,0,0,0,2470,2470,0,0,0,0,0
801,m1511,20151105,2470,2470,0,0,0,2470,2470,0,0,0,0,0
802,m1511,20151106,2470,2470,0,0,0,2470,2470,0,0,0,0,0
803,m1511,20151109,2470,2470,0,0,0,2470,2470,0,0,0,0,0
804,m1511,20151110,2470,2470,0,0,0,2470,2470,0,0,0,0,0
805,m1511,20151111,2470,2470,0,0,0,2470,2470,0,0,0,0,0
806,m1511,20151112,2470,2470,0,0,0,2470,2470,0,0,0,0,0
807,m1511,20151113,2470,2470,0,0,0,2470,2470,0,0,0,0,0
808,m1512,20150105,2832,2839,2799,2805,2795,2800,2799,-39,-40,166,4647940,516
809,m1512,20150106,2800,2799,2804,2839,2793,2828,2820,29,21,114,3215100,500
810,m1512,20150107,2828,2820,2841,2849,2820,2833,2837,13,17,68,1929280,478
811,m1512,20150108,2833,2837,2823,2840,2823,2840,2833,3,-4,30,850080,456
812,m1512,20150109,2840,2833,2829,2829,2805,2817,2815,-16,-18,54,1520180,466
813,m1512,20150112,2817,2815,2821,2826,2812,2815,2819,0,4,38,1071560,480
814,m1512,20150113,2815,2819,2817,2817,2713,2770,2777,-49,-42,116,3222400,534
815,m1512,20150114,2770,2777,2768,2770,2710,2715,2733,-62,-44,154,4209380,554
816,m1512,20150115,2715,2733,2700,2740,2700,2730,2727,-3,-6,190,5181680,628
817,m1512,20150116,2730,2727,2742,2750,2690,2707,2711,-20,-16,180,4880020,684
818,m1512,20150119,2707,2711,2720,2775,2701,2738,2733,27,22,712,19461800,498
819,m1512,20150120,2738,2733,2733,2736,2709,2733,2724,0,-9,62,1689160,504
820,m1512,20150121,2733,2724,2730,2771,2719,2757,2741,33,17,90,2467580,486
821,m1512,20150122,2757,2741,2764,2768,2759,2759,2762,18,21,8,221000,484
822,m1512,20150123,2759,2762,2758,2759,2746,2755,2753,-7,-9,94,2588400,476
823,m1512,20150126,2755,2753,2763,2776,2759,2768,2770,15,17,220,6094920,458
824,m1512,20150127,2768,2770,2774,2804,2774,2795,2792,25,22,42,1173040,446
825,m1512,20150128,2795,2792,2783,2800,2783,2794,2793,2,1,96,2681520,450
826,m1512,20150129,2794,2793,2780,2800,2773,2773,2777,-20,-16,112,3110580,454
827,m1512,20150130,2773,2777,2766,2774,2766,2774,2766,-3,-11,22,608680,454
828,m1512,20150202,2774,2766,2773,2780,2751,2757,2760,-9,-6,76,2098180,450
829,m1512,20150203,2757,2760,2774,2790,2761,2785,2772,25,12,38,1053500,460
830,m1512,20150204,2785,2772,2787,2822,2786,2804,2803,32,31,92,2579020,432
831,m1512,20150205,2804,2803,2807,2807,2785,2792,2793,-11,-10,54,1508260,426
832,m1512,20150206,2792,2793,2788,2820,2788,2803,2798,10,5,40,1119500,424
833,m1512,20150209,2803,2798,2798,2811,2788,2805,2800,7,2,74,2072220,416
834,m1512,20150210,2805,2800,2817,2830,2805,2815,2815,15,15,40,1126020,406
835,m1512,20150211,2815,2815,2802,2805,2794,2801,2799,-14,-16,24,671860,396
836,m1512,20150212,2801,2799,2808,2808,2795,2796,2801,-3,2,10,280160,396
837,m1512,20150213,2796,2801,2810,2827,2806,2823,2816,22,15,64,1802720,384
838,m1512,20150216,2823,2816,2811,2833,2801,2815,2814,-1,-2,40,1125960,356
839,m1512,20150217,2815,2814,2811,2811,2811,2811,2811,-3,-3,2,56220,356
840,m1512,20150225,2811,2811,2850,2850,2829,2829,2838,18,27,24,681200,354
841,m1512,20150226,2829,2838,2845,2857,2843,2844,2848,6,10,30,854520,352
842,m1512,20150227,2844,2848,2848,2885,2848,2885,2870,37,22,66,1894780,316
843,m1512,20150302,2885,2870,2883,2905,2879,2900,2894,30,24,118,3415080,290
844,m1512,20150303,2900,2894,2888,2909,2861,2866,2891,-28,-3,144,4164300,258
845,m1512,20150304,2866,2891,2854,2875,2847,2875,2855,-16,-36,24,685280,272
846,m1512,20150305,2875,2855,2854,2854,2819,2819,2835,-36,-20,26,737280,268
847,m1512,20150306,2819,2835,2816,2816,2816,2816,2816,-19,-19,2,56320,266
848,m1512,20150309,2816,2816,2814,2838,2814,2838,2827,22,11,18,509000,264
849,m1512,20150310,2838,2827,2837,2851,2837,2848,2843,21,16,34,966880,262
850,m1512,20150311,2848,2843,2830,2894,2830,2894,2848,51,5,8,227900,264
851,m1512,20150312,2894,2848,2883,2906,2858,2887,2883,39,35,62,1787620,232
852,m1512,20150313,2887,2883,2869,2872,2868,2868,2869,-15,-14,10,286960,232
853,m1512,20150316,2868,2869,2839,2854,2832,2843,2846,-26,-23,30,853840,250
854,m1512,20150317,2843,2846,2862,2862,2843,2850,2850,4,4,20,570100,252
855,m1512,20150318,2850,2850,2833,2840,2815,2815,2829,-35,-21,104,2942200,276
856,m1512,20150319,2815,2829,2816,2851,2816,2830,2830,1,1,22,622600,264
857,m1512,20150320,2830,2830,2820,2830,2814,2822,2821,-8,-9,26,733460,260
858,m1512,20150323,2822,2821,2833,2871,2833,2858,2844,37,23,64,1820680,250
859,m1512,20150324,2858,2844,2863,2875,2842,2854,2859,10,15,44,1258000,236
860,m1512,20150325,2854,2859,2862,2874,2856,2858,2862,-1,3,16,458000,242
861,m1512,20150326,2858,2862,2854,2874,2833,2833,2848,-29,-14,32,911620,238
862,m1512,20150327,2833,2848,2828,2834,2817,2834,2826,-14,-22,18,508820,238
863,m1512,20150330,2834,2826,2825,2844,2822,2828,2830,2,4,16,452920,238
864,m1512,20150331,2828,2830,2822,2825,2812,2812,2819,-18,-11,12,338340,234
865,m1512,20150401,2812,2819,2817,2872,2816,2863,2850,44,31,56,1596460,232
866,m1512,20150402,2863,2850,2863,2872,2863,2869,2868,19,18,10,286840,234
867,m1512,20150403,2869,2868,2866,2877,2846,2846,2857,-22,-11,28,800080,238
868,m1512,20150407,2846,2857,0,0,0,2857,2857,0,0,0,0,238
869,m1512,20150408,2857,2857,2843,2844,2835,2842,2841,-15,-16,10,284160,242
870,m1512,20150409,2842,2841,2841,2845,2799,2799,2818,-42,-23,32,902060,252
871,m1512,20150410,2799,2818,2792,2792,2770,2770,2777,-48,-41,50,1388860,266
872,m1512,20150413,2770,2777,2783,2783,2762,2781,2775,4,-2,16,444140,268
873,m1512,20150414,2781,2775,2775,2780,2769,2769,2774,-6,-1,8,221980,268
874,m1512,20150415,2769,2774,2797,2798,2784,2786,2793,12,19,36,1005580,278
875,m1512,20150416,2786,2793,2799,2799,2794,2795,2796,2,3,8,223720,274
876,m1512,20150417,2795,2796,2789,2798,2786,2791,2789,-5,-7,42,1171720,280
877,m1512,20150420,2791,2789,2791,2808,2790,2800,2799,11,10,14,391880,284
878,m1512,20150421,2800,2799,2797,2804,2797,2804,2799,5,0,8,223980,282
879,m1512,20150422,2804,2799,2799,2801,2794,2796,2798,-3,-1,26,727700,274
880,m1512,20150423,2796,2798,2787,2820,2787,2805,2801,7,3,24,672420,256
881,m1512,20150424,2805,2801,2788,2804,2781,2804,2789,3,-12,26,725340,258
882,m1512,20150427,2804,2789,2802,2805,2800,2804,2803,15,14,18,504640,262
883,m1512,20150428,2804,2803,2820,2860,2816,2830,2849,27,46,94,2678600,304
884,m1512,20150429,2830,2849,2844,2844,2814,2824,2826,-25,-23,36,1017440,318
885,m1512,20150430,2824,2826,2830,2839,2828,2839,2833,13,7,56,1586540,288
886,m1512,20150504,2839,2833,2819,2819,2796,2806,2804,-27,-29,194,5441240,306
887,m1512,20150505,2806,2804,2815,2818,2792,2793,2804,-11,0,26,729200,304
888,m1512,20150506,2793,2804,2801,2818,2791,2808,2797,4,-7,222,6209340,358
889,m1512,20150507,2808,2797,2819,2819,2803,2812,2809,15,12,76,2135420,298
890,m1512,20150508,2812,2809,2799,2802,2785,2785,2793,-24,-16,86,2402080,310
891,m1512,20150511,2785,2793,2798,2798,2793,2795,2795,2,2,8,223600,310
892,m1512,20150512,2795,2795,2762,2762,2762,2762,2762,-33,-33,2,55240,310
893,m1512,20150513,2762,2762,2764,2764,2764,2764,2764,2,2,6,165840,308
894,m1512,20150514,2764,2764,2738,2770,2735,2736,2746,-28,-18,52,1428280,304
895,m1512,20150515,2736,2746,2745,2758,2745,2758,2751,12,5,40,1100540,340
896,m1512,20150518,2758,2751,2736,2741,2735,2741,2736,-10,-15,22,601920,340
897,m1512,20150519,2741,2736,2746,2753,2740,2740,2748,4,12,28,769520,344
898,m1512,20150520,2740,2748,2717,2721,2646,2651,2688,-97,-60,46,1236860,348
899,m1512,20150521,2651,2688,2651,2681,2651,2680,2667,-8,-21,18,480100,340
900,m1512,20150522,2680,2667,2680,2687,2639,2654,2664,-13,-3,38,1012500,336
901,m1512,20150525,2654,2664,0,0,0,2619,2619,-45,-45,0,0,336
902,m1512,20150526,2619,2619,0,0,0,2619,2619,0,0,0,0,336
903,m1512,20150527,2619,2619,2609,2628,2606,2606,2611,-13,-8,34,887740,320
904,m1512,20150528,2606,2611,2624,2645,2624,2632,2633,21,22,48,1263840,298
905,m1512,20150529,2632,2633,2621,2630,2620,2628,2622,-5,-11,18,471980,310
906,m1512,20150601,2628,2622,2601,2603,2581,2590,2590,-32,-32,50,1295000,310
907,m1512,20150602,2590,2590,2593,2614,2588,2614,2594,24,4,66,1712660,304
908,m1512,20150603,2614,2594,2643,2643,2624,2637,2632,43,38,40,1052940,308
909,m1512,20150604,2637,2632,2639,2639,2603,2624,2623,-8,-9,34,891900,302
910,m1512,20150605,2624,2623,2630,2635,2624,2635,2630,12,7,22,578600,300
911,m1512,20150608,2635,2630,2628,2628,2614,2614,2621,-16,-9,4,104840,304
912,m1512,20150609,2614,2621,2629,2630,2624,2630,2627,9,6,12,315320,296
913,m1512,20150610,2630,2627,2629,2638,2625,2626,2628,-1,1,22,578280,280
914,m1512,20150611,2626,2628,2632,2632,2632,2632,2632,4,4,2,52640,282
915,m1512,20150612,2632,2632,2611,2611,2550,2565,2554,-67,-78,244,6233800,470
916,m1512,20150615,2565,2554,2562,2565,2518,2518,2545,-36,-9,330,8399060,282
917,m1512,20150616,2518,2545,2512,2551,2512,2539,2532,-6,-13,28,709080,276
918,m1512,20150617,2539,2532,2528,2594,2528,2589,2579,57,47,42,1083480,274
919,m1512,20150618,2589,2579,2590,2597,2579,2579,2588,0,9,40,1035360,276
920,m1512,20150619,2579,2588,2587,2631,2587,2625,2608,37,20,24,626100,276
921,m1512,20150623,2625,2608,2698,2698,2668,2679,2678,71,70,36,964360,282
922,m1512,20150624,2679,2678,2657,2659,2656,2659,2657,-19,-21,6,159440,282
923,m1512,20150625,2659,2657,2644,2663,2644,2654,2653,-3,-4,14,371460,284
924,m1512,20150626,2654,2653,2683,2690,2669,2688,2681,35,28,30,804560,286
925,m1512,20150629,2688,2681,2705,2705,2674,2684,2690,3,9,44,1183940,292
926,m1512,20150630,2684,2690,2689,2696,2624,2636,2659,-54,-31,70,1861500,294
927,m1512,20150701,2636,2659,2637,2765,2630,2765,2741,106,82,80,2192860,300
928,m1512,20150702,2765,2741,2738,2781,2738,2763,2754,22,13,80,2203280,280
929,m1512,20150703,2763,2754,2776,2826,2776,2819,2810,65,56,74,2080120,274
930,m1512,20150706,2819,2810,2814,2814,2756,2767,2784,-43,-26,38,1058120,272
931,m1512,20150707,2767,2784,2773,2831,2762,2780,2800,-4,16,42,1176200,276
932,m1512,20150708,2780,2800,2773,2773,2688,2694,2703,-106,-97,118,3190540,258
933,m1512,20150709,2694,2703,2630,2799,2595,2751,2713,48,10,226,6131820,274
934,m1512,20150710,2751,2713,2782,2821,2700,2821,2788,108,75,110,3067120,252
935,m1512,20150713,2821,2788,2846,2850,2787,2802,2818,14,30,60,1691000,232
936,m1512,20150714,2802,2818,2803,2899,2803,2869,2855,51,37,84,2398540,226
937,m1512,20150715,2869,2855,2859,2859,2809,2820,2823,-35,-32,72,2033060,224
938,m1512,20150716,2820,2823,2789,2823,2778,2813,2798,-10,-25,92,2574400,218
939,m1512,20150717,2813,2798,2836,2836,2745,2761,2781,-37,-17,134,3727620,230
940,m1512,20150720,2761,2781,2756,2767,2695,2729,2727,-52,-54,66,1800280,234
941,m1512,20150721,2729,2727,2701,2742,2701,2734,2734,7,7,86,2351400,244
942,m1512,20150722,2734,2734,2741,2769,2735,2767,2750,33,16,106,2915220,296
943,m1512,20150723,2767,2750,2781,2782,2723,2769,2767,19,17,98,2711680,280
944,m1512,20150724,2769,2767,2771,2771,2723,2743,2750,-24,-17,36,990160,292
945,m1512,20150727,2743,2750,2728,2731,2687,2689,2707,-61,-43,60,1624580,292
946,m1512,20150728,2689,2707,2687,2701,2665,2701,2681,-6,-26,44,1180020,292
947,m1512,20150729,2701,2681,2711,2711,2678,2698,2689,17,8,34,914560,294
948,m1512,20150730,2698,2689,2689,2716,2689,2703,2700,14,11,80,2160640,288
949,m1512,20150731,2703,2700,2711,2719,2700,2715,2711,15,11,28,759180,288
950,m1512,20150803,2715,2711,2709,2709,2680,2688,2694,-23,-17,18,485080,284
951,m1512,20150804,2688,2694,2683,2730,2683,2717,2710,23,16,44,1192700,272
952,m1512,20150805,2717,2710,2735,2738,2733,2738,2734,28,24,10,273480,268
953,m1512,20150806,2738,2734,2735,2746,2735,2746,2740,12,6,4,109620,266
954,m1512,20150807,2746,2740,2745,2745,2710,2725,2714,-15,-26,34,922920,268
955,m1512,20150810,2725,2714,2727,2787,2719,2776,2750,62,36,44,1210140,270
956,m1512,20150811,2776,2750,2789,2810,2788,2800,2800,50,50,34,952120,270
957,m1512,20150812,2800,2800,2799,2809,2756,2779,2784,-21,-16,40,1113940,266
958,m1512,20150813,2779,2784,2821,2821,2685,2723,2730,-61,-54,158,4314860,248
959,m1512,20150814,2723,2730,2712,2721,2710,2718,2717,-12,-13,18,489060,252
960,m1512,20150817,2718,2717,2703,2751,2696,2708,2709,-9,-8,14,379320,248
961,m1512,20150818,2708,2709,2724,2724,2693,2702,2703,-7,-6,36,973260,246
962,m1512,20150819,2702,2703,2663,2676,2650,2670,2660,-33,-43,108,2873420,236
963,m1512,20150820,2670,2660,2676,2681,2652,2665,2666,5,6,18,480040,236
964,m1512,20150821,2665,2666,2672,2714,2669,2671,2684,5,18,56,1503160,236
965,m1512,20150824,2671,2684,2681,2681,2608,2621,2635,-63,-49,44,1159700,218
966,m1512,20150825,2621,2635,2605,2656,2605,2653,2624,18,-11,38,997220,218
967,m1512,20150826,2653,2624,2697,2697,2620,2679,2675,55,51,300,8027140,176
968,m1512,20150827,2679,2675,2687,2705,2681,2705,2694,30,19,50,1347120,164
969,m1512,20150828,2705,2694,2720,2745,2690,2699,2714,5,20,110,2986000,140
970,m1512,20150831,2699,2714,2710,2710,2670,2670,2695,-44,-19,30,808500,136
971,m1512,20150901,2670,2695,2664,2674,2664,2674,2671,-21,-24,8,213700,138
972,m1512,20150902,2674,2671,2664,2698,2664,2696,2687,25,16,94,2526440,130
973,m1512,20150907,2696,2687,2662,2669,2658,2664,2664,-23,-23,16,426280,124
974,m1512,20150908,2664,2664,2669,2682,2626,2682,2667,18,3,12,320140,126
975,m1512,20150909,2682,2667,2693,2705,2691,2692,2698,25,31,32,863400,128
976,m1512,20150910,2692,2698,2691,2699,2688,2699,2693,1,-5,24,646480,128
977,m1512,20150911,2699,2693,2690,2699,2690,2693,2695,0,2,18,485100,128
978,m1512,20150914,2693,2695,2698,2739,2687,2725,2716,30,21,42,1141100,126
979,m1512,20150915,2725,2716,2731,2748,2731,2745,2738,29,22,30,821480,126
980,m1512,20150916,2745,2738,2735,2754,2721,2740,2734,2,-4,34,929680,124
981,m1512,20150917,2740,2734,2747,2747,2730,2730,2734,-4,0,24,656360,120
982,m1512,20150918,2730,2734,2723,2725,2712,2712,2718,-22,-16,16,434960,116
983,m1512,20150921,2712,2718,2700,2700,2665,2675,2683,-43,-35,18,482980,112
984,m1512,20150922,2675,2683,2697,2697,2691,2691,2692,8,9,8,215420,110
985,m1512,20150923,2691,2692,2679,2690,2679,2682,2685,-10,-7,32,859440,106
986,m1512,20150924,2682,2685,2694,2696,2694,2696,2694,11,9,6,161680,104
987,m1512,20150925,2696,2694,2699,2718,2699,2703,2705,9,11,44,1190340,122
988,m1512,20150928,2703,2705,0,0,0,2706,2706,1,1,0,0,122
989,m1512,20150929,2706,2706,2682,2696,2678,2681,2685,-25,-21,46,1235200,114
990,m1512,20150930,2681,2685,2688,2688,2688,2688,2688,3,3,22,591360,102
991,m1512,20151008,2688,2688,0,0,0,2695,2695,7,7,0,0,102
992,m1512,20151009,2695,2695,2695,2710,2680,2680,2690,-15,-5,26,699520,92
993,m1512,20151012,2680,2690,2630,2688,2630,2688,2679,-2,-11,40,1071660,94
994,m1512,20151013,2688,2679,2681,2681,2676,2676,2680,-3,1,14,375240,106
995,m1512,20151014,2676,2680,2693,2712,2686,2711,2705,31,25,24,649420,100
996,m1512,20151015,2711,2705,2702,2707,2702,2707,2704,2,-1,4,108180,100
997,m1512,20151016,2707,2704,2699,2707,2699,2702,2702,-2,-2,10,270240,98
998,m1512,20151019,2702,2702,2688,2688,2688,2688,2688,-14,-14,2,53760,96
999,m1512,20151020,2688,2688,2686,2686,2677,2677,2682,-11,-6,6,160920,96
1000,m1512,20151021,2677,2682,2654,2654,2640,2640,2647,-42,-35,8,211760,98
1001,m1512,20151022,2640,2647,2639,2688,2639,2651,2663,4,16,12,319580,100
1002,m1512,20151023,2651,2663,2683,2683,2580,2596,2631,-67,-32,16,421080,104
1003,m1512,20151026,2596,2631,2618,2618,2611,2611,2614,-20,-17,8,209180,106
1004,m1512,20151027,2611,2614,2562,2608,2562,2598,2596,-16,-18,12,311560,106
1005,m1512,20151028,2598,2596,2602,2602,2568,2568,2583,-28,-13,6,155020,106
1006,m1512,20151029,2568,2583,2640,2640,2571,2571,2599,-12,16,8,207980,104
1007,m1512,20151030,2571,2599,2616,2617,2586,2586,2606,-13,7,6,156380,104
1008,m1512,20151102,2586,2606,0,0,0,2599,2599,-7,-7,0,0,104
1009,m1512,20151103,2599,2599,2548,2548,2548,2548,2548,-51,-51,4,101920,108
1010,m1512,20151104,2548,2548,2558,2558,2522,2528,2536,-20,-12,6,152160,108
1011,m1512,20151105,2528,2536,2528,2593,2461,2461,2509,-75,-27,20,501840,106
1012,m1512,20151106,2461,2509,2438,2494,2409,2436,2427,-73,-82,96,2330660,104
1013,m1512,20151109,2436,2427,2415,2445,2412,2434,2425,7,-2,48,1164320,106
1014,m1512,20151110,2434,2425,2440,2453,2439,2451,2443,26,18,34,830900,114
1015,m1512,20151111,2451,2443,2476,2477,2476,2477,2476,34,33,10,247640,108
1016,m1512,20151112,2477,2476,2496,2499,2380,2437,2473,-39,-3,80,1978580,104
1017,m1512,20151113,2437,2473,2444,2447,2438,2438,2444,-35,-29,10,244440,104
1018,m1512,20151116,2438,2444,2428,2446,2401,2437,2429,-7,-15,46,1117700,112
1019,m1512,20151117,2437,2429,0,0,0,2427,2427,-2,-2,0,0,112
1020,m1512,20151118,2427,2427,2402,2402,2364,2364,2392,-63,-35,8,191400,112
1021,m1512,20151119,2364,2392,2362,2422,2362,2363,2372,-29,-20,36,853920,130
1022,m1512,20151120,2363,2372,2407,2466,2367,2371,2432,-1,60,1534,37315020,476
1023,m1512,20151123,2371,2432,2352,2395,2335,2335,2349,-97,-83,178,4182860,426
1024,m1512,20151124,2335,2349,2301,2395,2283,2395,2353,46,4,152,3577040,378
1025,m1512,20151125,2395,2353,2395,2396,2309,2386,2354,33,1,130,3061320,318
1026,m1512,20151126,2386,2354,2380,2448,2380,2448,2424,94,70,206,4993660,194
1027,m1512,20151127,2448,2424,2449,2483,2447,2483,2453,59,29,114,2797380,86
1028,m1512,20151130,2483,2453,2481,2550,2355,2355,2395,-98,-58,66,1581120,82
1029,m1512,20151201,2355,2395,0,0,0,2395,2395,0,0,0,0,82
1030,m1512,20151202,2395,2395,0,0,0,2395,2395,0,0,0,0,82
1031,m1512,20151203,2395,2395,0,0,0,2395,2395,0,0,0,0,82
1032,m1512,20151204,2395,2395,0,0,0,2395,2395,0,0,0,0,82
1033,m1512,20151207,2395,2395,0,0,0,2395,2395,0,0,0,0,82
1034,m1512,20151208,2395,2395,0,0,0,2395,2395,0,0,0,0,82
1035,m1512,20151209,2395,2395,0,0,0,2395,2395,0,0,0,0,82
1036,m1512,20151210,2395,2395,0,0,0,2395,2395,0,0,0,0,82
1037,m1512,20151211,2395,2395,0,0,0,2395,2395,0,0,0,0,82
1038,m1512,20151214,2395,2395,0,0,0,2395,2395,0,0,0,0,0
1039,m1601,20150119,2726,2726,2819,2819,2670,2724,2741,-2,15,139830,3833622960,86468
1040,m1601,20150120,2724,2741,2729,2729,2694,2720,2709,-21,-32,50468,1367598860,111502
1041,m1601,20150121,2720,2709,2720,2771,2703,2743,2737,34,28,39474,1080507000,118392
1042,m1601,20150122,2743,2737,2737,2763,2732,2748,2749,11,12,24742,680197360,123222
1043,m1601,20150123,2748,2749,2765,2765,2730,2745,2740,-4,-9,28088,769856880,125100
1044,m1601,20150126,2745,2740,2742,2759,2730,2750,2746,10,6,34948,959786000,131068
1045,m1601,20150127,2750,2746,2750,2785,2744,2772,2771,26,25,27104,751306860,133046
1046,m1601,20150128,2772,2771,2770,2778,2758,2770,2768,-1,-3,34786,963037200,146330
1047,m1601,20150129,2770,2768,2762,2769,2747,2748,2753,-20,-15,50854,1400453640,156670
1048,m1601,20150130,2748,2753,2749,2762,2743,2760,2755,7,2,24772,682570700,151220
1049,m1601,20150202,2760,2755,2758,2758,2722,2732,2736,-23,-19,23820,651932420,153176
1050,m1601,20150203,2732,2736,2736,2762,2701,2757,2747,21,11,30686,843129140,159502
1051,m1601,20150204,2757,2747,2760,2809,2756,2785,2785,38,38,38144,1062647220,159790
1052,m1601,20150205,2785,2785,2783,2790,2761,2771,2773,-14,-12,25348,703147280,163184
1053,m1601,20150206,2771,2773,2777,2798,2771,2784,2782,11,9,19840,552042620,161936
1054,m1601,20150209,2784,2782,2784,2807,2770,2797,2785,15,3,19356,539246660,158972
1055,m1601,20150210,2797,2785,2792,2810,2787,2787,2795,2,10,29372,820975520,150596
1056,m1601,20150211,2787,2795,2786,2801,2765,2780,2778,-15,-17,45830,1273374860,160820
1057,m1601,20150212,2780,2778,2785,2785,2769,2775,2777,-3,-1,11264,312893020,162952
1058,m1601,20150213,2775,2777,2781,2814,2775,2808,2795,31,18,50268,1405391300,160408
1059,m1601,20150216,2808,2795,2800,2826,2790,2798,2803,3,8,29852,836897980,164764
1060,m1601,20150217,2798,2803,2798,2816,2793,2816,2805,13,2,20784,583094900,172802
1061,m1601,20150225,2816,2805,2836,2851,2826,2832,2835,27,30,24952,707468460,175544
1062,m1601,20150226,2832,2835,2828,2870,2826,2852,2845,17,10,59300,1687673980,195756
1063,m1601,20150227,2852,2845,2858,2920,2850,2906,2886,61,41,50502,1457683520,203216
1064,m1601,20150302,2906,2886,2912,2915,2859,2896,2900,10,14,88854,2577230480,222502
1065,m1601,20150303,2896,2900,2900,2900,2845,2852,2864,-48,-36,88180,2526236620,243858
1066,m1601,20150304,2852,2864,2852,2857,2826,2845,2842,-19,-22,71154,2022853040,260780
1067,m1601,20150305,2845,2842,2835,2836,2794,2804,2806,-38,-36,76528,2148133260,283862
1068,m1601,20150306,2804,2806,2802,2829,2782,2785,2804,-21,-2,98428,2760084480,309916
1069,m1601,20150309,2785,2804,2790,2816,2774,2810,2800,6,-4,114250,3199793760,349686
1070,m1601,20150310,2810,2800,2806,2829,2803,2814,2813,14,13,90014,2532664100,360132
1071,m1601,20150311,2814,2813,2813,2866,2793,2850,2834,37,21,125138,3546788560,370230
1072,m1601,20150312,2850,2834,2851,2880,2836,2865,2858,31,24,104576,2989529460,375194
1073,m1601,20150313,2865,2858,2858,2870,2824,2832,2841,-26,-17,105136,2987537120,397534
1074,m1601,20150316,2832,2841,2830,2831,2790,2815,2810,-26,-31,119498,3358964200,436918
1075,m1601,20150317,2815,2810,2819,2838,2811,2818,2821,8,11,87954,2481350760,449718
1076,m1601,20150318,2818,2821,2815,2817,2789,2790,2804,-31,-17,90002,2524058540,462398
1077,m1601,20150319,2790,2804,2798,2830,2789,2814,2810,10,6,83844,2356742280,470912
1078,m1601,20150320,2814,2810,2802,2812,2794,2809,2803,-1,-7,79772,2236611820,476110
1079,m1601,20150323,2809,2803,2813,2851,2808,2838,2833,35,30,78216,2216454700,488478
1080,m1601,20150324,2838,2833,2840,2859,2827,2853,2844,20,11,93194,2650497600,507314
1081,m1601,20150325,2853,2844,2849,2859,2834,2837,2845,-7,1,76634,2180309820,520602
1082,m1601,20150326,2837,2845,2840,2850,2813,2816,2826,-29,-19,76288,2156238780,535196
1083,m1601,20150327,2816,2826,2815,2821,2800,2820,2810,-6,-16,65894,1851678180,543670
1084,m1601,20150330,2820,2810,2812,2824,2802,2808,2813,-2,3,85938,2417809260,536756
1085,m1601,20150331,2808,2813,2805,2814,2789,2802,2801,-11,-12,115984,3248746220,534206
1086,m1601,20150401,2802,2801,2800,2867,2795,2843,2838,42,37,183094,5196601160,567278
1087,m1601,20150402,2843,2838,2841,2868,2836,2857,2856,19,18,154538,4413979240,550660
1088,m1601,20150403,2857,2856,2860,2860,2837,2839,2846,-17,-10,101728,2895654300,537044
1089,m1601,20150407,2839,2846,2828,2848,2821,2837,2836,-9,-10,71128,2017472160,531200
1090,m1601,20150408,2837,2836,2833,2840,2823,2837,2832,1,-4,129194,3659230040,549018
1091,m1601,20150409,2837,2832,2834,2836,2783,2784,2804,-48,-28,174352,4889913980,547520
1092,m1601,20150410,2784,2804,2784,2792,2749,2753,2769,-51,-35,202986,5622071060,558612
1093,m1601,20150413,2753,2769,2760,2779,2749,2764,2763,-5,-6,152982,4227859860,560250
1094,m1601,20150414,2764,2763,2768,2770,2753,2765,2760,2,-3,121494,3354168260,586122
1095,m1601,20150415,2765,2760,2775,2787,2766,2772,2775,12,15,146178,4057453220,619050
1096,m1601,20150416,2772,2775,2768,2789,2709,2762,2773,-13,-2,165614,4592867240,627718
1097,m1601,20150417,2762,2773,2764,2777,2759,2774,2770,1,-3,107228,2970251460,633682
1098,m1601,20150420,2774,2770,2785,2797,2766,2783,2782,13,12,143234,3986195500,635700
1099,m1601,20150421,2783,2782,2780,2790,2777,2788,2783,6,1,92766,2582414560,640014
1100,m1601,20150422,2788,2783,2790,2795,2765,2772,2774,-11,-9,155446,4312636560,645540
1101,m1601,20150423,2772,2774,2774,2793,2769,2785,2784,11,10,118918,3310890060,639164
1102,m1601,20150424,2785,2784,2783,2813,2741,2776,2777,-8,-7,523744,14549007300,741824
1103,m1601,20150427,2776,2777,2776,2785,2763,2782,2773,5,-4,279238,7745126900,805884
1104,m1601,20150428,2782,2773,2783,2817,2779,2798,2801,25,28,261222,7316851220,827120
1105,m1601,20150429,2798,2801,2805,2820,2780,2785,2799,-16,-2,188302,5271070300,841786
1106,m1601,20150430,2785,2799,2780,2815,2780,2812,2802,13,3,170798,4787462780,843256
1107,m1601,20150504,2812,2802,2771,2780,2762,2768,2772,-34,-30,171160,4745071060,832144
1108,m1601,20150505,2768,2772,2771,2789,2750,2767,2772,-5,0,215402,5973057540,851686
1109,m1601,20150506,2767,2772,2769,2799,2763,2787,2781,15,9,248544,6912957260,851368
1110,m1601,20150507,2787,2781,2782,2806,2774,2790,2788,9,7,200876,5601969240,852860
1111,m1601,20150508,2790,2788,2783,2793,2765,2768,2774,-20,-14,143936,3993505360,849754
1112,m1601,20150511,2768,2774,2767,2782,2767,2774,2775,0,1,120916,3356189920,856614
1113,m1601,20150512,2774,2775,2771,2777,2729,2730,2747,-45,-28,235932,6481606440,882046
1114,m1601,20150513,2730,2747,2729,2749,2712,2722,2727,-25,-20,209914,5726074140,908662
1115,m1601,20150514,2722,2727,2727,2734,2708,2717,2718,-10,-9,160480,4363400800,908006
1116,m1601,20150515,2717,2718,2719,2727,2714,2723,2721,5,3,175786,4783587820,908666
1117,m1601,20150518,2723,2721,2723,2729,2707,2726,2719,5,-2,207728,5648239340,917812
1118,m1601,20150519,2726,2719,2736,2739,2718,2720,2729,1,10,178448,4870158740,921984
1119,m1601,20150520,2720,2729,2715,2715,2635,2653,2678,-76,-51,425038,11384064240,909500
1120,m1601,20150521,2653,2678,2650,2663,2645,2647,2654,-31,-24,212140,5631394880,916216
1121,m1601,20150522,2647,2654,2645,2662,2622,2645,2637,-9,-17,335326,8842919120,950836
1122,m1601,20150525,2645,2637,2651,2652,2592,2596,2611,-41,-26,227324,5936436260,950174
1123,m1601,20150526,2596,2611,2600,2613,2588,2591,2602,-20,-9,242320,6307568440,984172
1124,m1601,20150527,2591,2602,2585,2610,2576,2586,2592,-16,-10,208024,5393250840,995114
1125,m1601,20150528,2586,2592,2592,2620,2589,2609,2608,17,16,302574,7891159420,971032
1126,m1601,20150529,2609,2608,2610,2617,2594,2606,2605,-2,-3,153058,3987655200,975652
1127,m1601,20150601,2606,2605,2608,2608,2556,2559,2578,-46,-27,343436,8853983940,1067976
1128,m1601,20150602,2559,2578,2562,2617,2553,2611,2590,33,12,629680,16311293620,997344
1129,m1601,20150603,2611,2590,2619,2633,2611,2624,2621,34,31,305744,8016072200,989274
1130,m1601,20150604,2624,2621,2620,2631,2597,2623,2614,2,-7,397796,10402213800,948144
1131,m1601,20150605,2623,2614,2626,2635,2616,2623,2625,9,11,257048,6748463640,941546
1132,m1601,20150608,2623,2625,2625,2630,2601,2608,2613,-17,-12,197996,5174098600,952494
1133,m1601,20150609,2608,2613,2619,2623,2614,2616,2618,3,5,149040,3902103700,943278
1134,m1601,20150610,2616,2618,2614,2628,2607,2609,2617,-9,-1,155194,4062440500,959128
1135,m1601,20150611,2609,2617,2617,2625,2609,2616,2617,-1,0,179962,4711078720,952772
1136,m1601,20150612,2616,2617,2610,2610,2548,2557,2575,-60,-42,402348,10364168760,970324
1137,m1601,20150615,2557,2575,2570,2570,2515,2523,2536,-52,-39,329722,8364820460,987042
1138,m1601,20150616,2523,2536,2520,2551,2510,2539,2534,3,-2,354998,8997807800,1054426
1139,m1601,20150617,2539,2534,2538,2608,2513,2587,2575,53,41,556676,14339924680,1080236
1140,m1601,20150618,2587,2575,2580,2598,2573,2575,2584,0,9,285258,7371360700,1091398
1141,m1601,20150619,2575,2584,2570,2629,2565,2608,2605,24,21,524660,13668677960,1093696
1142,m1601,20150623,2608,2605,2674,2693,2666,2679,2677,74,72,429448,11496548900,1160442
1143,m1601,20150624,2679,2677,2656,2669,2643,2650,2654,-27,-23,506640,13446663340,1248350
1144,m1601,20150625,2650,2654,2648,2662,2633,2648,2648,-6,-6,367470,9733403840,1255428
1145,m1601,20150626,2648,2648,2676,2700,2658,2679,2682,31,34,711334,19079651420,1264576
1146,m1601,20150629,2679,2682,2720,2729,2662,2679,2692,-3,10,716010,19276653800,1259536
1147,m1601,20150630,2679,2692,2685,2706,2636,2647,2660,-45,-32,856676,22794326960,1305572
1148,m1601,20150701,2647,2660,2645,2766,2633,2766,2732,106,72,839418,22936594660,1310078
1149,m1601,20150702,2766,2732,2761,2794,2754,2790,2769,58,37,755062,20910884200,1237930
1150,m1601,20150703,2790,2769,2782,2836,2772,2827,2811,58,42,927010,26066984400,1253730
1151,m1601,20150706,2827,2811,2820,2826,2761,2786,2793,-25,-18,1014278,28336868940,1182082
1152,m1601,20150707,2786,2793,2786,2832,2763,2789,2802,-4,9,1199746,33617282320,1157930
1153,m1601,20150708,2789,2802,2781,2787,2690,2690,2720,-112,-82,1604200,43638165520,978120
1154,m1601,20150709,2690,2720,2680,2795,2570,2748,2713,28,-7,1952480,52986276420,947768
1155,m1601,20150710,2748,2713,2759,2821,2759,2821,2798,108,85,930606,26039760760,1001830
1156,m1601,20150713,2821,2798,2852,2864,2777,2819,2819,21,21,1126594,31768213620,1017492
1157,m1601,20150714,2819,2819,2805,2926,2800,2884,2877,65,58,2041022,58733953460,1154536
1158,m1601,20150715,2884,2877,2875,2889,2828,2843,2853,-34,-24,1531572,43702293260,1148134
1159,m1601,20150716,2843,2853,2848,2848,2782,2833,2820,-20,-33,1387814,39149031040,1121644
1160,m1601,20150717,2833,2820,2843,2859,2761,2769,2802,-51,-18,1671224,46843953060,1122642
1161,m1601,20150720,2769,2802,2774,2783,2706,2730,2742,-72,-60,1409276,38646684880,1149298
1162,m1601,20150721,2730,2742,2713,2765,2713,2749,2745,7,3,1277662,35074159860,1166070
1163,m1601,20150722,2749,2745,2736,2783,2736,2782,2759,37,14,1354566,37375530280,1200298
1164,m1601,20150723,2782,2759,2758,2794,2752,2771,2775,12,16,1858552,51575776280,1204482
1165,m1601,20150724,2771,2775,2765,2783,2723,2740,2751,-35,-24,1883682,51826943280,1227372
1166,m1601,20150727,2740,2751,2732,2744,2677,2678,2711,-73,-40,1782920,48346111740,1252718
1167,m1601,20150728,2678,2711,2668,2688,2651,2681,2672,-30,-39,1861670,49759367420,1232396
1168,m1601,20150729,2681,2672,2686,2703,2662,2681,2683,9,11,1649434,44270015780,1267494
1169,m1601,20150730,2681,2683,2677,2715,2670,2687,2695,4,12,1991642,53682184800,1264432
1170,m1601,20150731,2687,2695,2706,2714,2685,2699,2698,4,3,1706614,46058602740,1324962
1171,m1601,20150803,2699,2698,2690,2705,2656,2665,2681,-33,-17,1808930,48506226500,1354194
1172,m1601,20150804,2665,2681,2659,2712,2651,2707,2687,26,6,2002744,53821713380,1383020
1173,m1601,20150805,2707,2687,2710,2734,2704,2723,2719,36,32,2337114,63556762440,1432756
1174,m1601,20150806,2723,2719,2739,2745,2708,2729,2724,10,5,1879160,51199830440,1430484
1175,m1601,20150807,2729,2724,2722,2736,2683,2703,2707,-21,-17,2333798,63186124600,1355698
1176,m1601,20150810,2703,2707,2703,2784,2699,2776,2751,69,44,2772306,76274991820,1513196
1177,m1601,20150811,2776,2751,2776,2831,2772,2810,2801,59,50,3414358,95661904660,1554668
1178,m1601,20150812,2810,2801,2808,2816,2782,2810,2799,9,-2,2741426,76747182460,1559074
1179,m1601,20150813,2810,2799,2828,2847,2688,2734,2762,-65,-37,4239736,1.17114E+11,1568082
1180,m1601,20150814,2734,2762,2734,2747,2721,2722,2731,-40,-31,1963658,53642086940,1521288
1181,m1601,20150817,2722,2731,2714,2726,2708,2719,2718,-12,-13,1348174,36649915700,1524082
1182,m1601,20150818,2719,2718,2726,2737,2707,2712,2723,-6,5,1553786,42312061880,1542416
1183,m1601,20150819,2712,2723,2700,2701,2658,2684,2676,-39,-47,2463250,65917512120,1493088
1184,m1601,20150820,2684,2676,2699,2700,2655,2666,2675,-10,-1,1886438,50465921120,1545158
1185,m1601,20150821,2666,2675,2671,2706,2669,2678,2685,3,10,1713302,46018606720,1518528
1186,m1601,20150824,2678,2685,2675,2689,2606,2629,2641,-56,-44,2964542,78323104360,1597658
1187,m1601,20150825,2629,2641,2603,2680,2602,2671,2650,30,9,3421584,90699384040,1571654
1188,m1601,20150826,2671,2650,2706,2721,2667,2684,2694,34,44,2279692,61426336400,1521928
1189,m1601,20150827,2684,2694,2695,2723,2675,2719,2697,25,3,2267254,61167132220,1519040
1190,m1601,20150828,2719,2697,2727,2764,2690,2704,2724,7,27,3189120,86885215400,1418678
1191,m1601,20150831,2704,2724,2703,2725,2672,2673,2700,-51,-24,2736596,73899605480,1381014
1192,m1601,20150901,2673,2700,2669,2685,2659,2682,2672,-18,-28,1706456,45601877540,1385856
1193,m1601,20150902,2682,2672,2674,2699,2656,2698,2675,26,3,1689576,45208917600,1358180
1194,m1601,20150907,2698,2675,2675,2682,2644,2647,2656,-28,-19,1167458,31011333700,1395802
1195,m1601,20150908,2647,2656,2655,2675,2649,2673,2663,17,7,1187788,31638518220,1397020
1196,m1601,20150909,2673,2663,2676,2702,2672,2677,2686,14,23,1940952,52141151060,1399188
1197,m1601,20150910,2677,2686,2685,2695,2673,2688,2684,2,-2,1448658,38884213560,1398360
1198,m1601,20150911,2688,2684,2673,2697,2669,2679,2685,-5,1,1754420,47108841760,1370258
1199,m1601,20150914,2679,2685,2680,2735,2665,2721,2711,36,26,2942042,79784989080,1528294
1200,m1601,20150915,2721,2711,2721,2745,2718,2733,2734,22,23,2043938,55883339480,1539872
1201,m1601,20150916,2733,2734,2725,2747,2711,2739,2729,5,-5,1980844,54067759760,1557032
1202,m1601,20150917,2739,2729,2739,2743,2715,2719,2728,-10,-1,1467780,40045753060,1537798
1203,m1601,20150918,2719,2728,2713,2726,2696,2697,2710,-31,-18,1432890,38837049400,1536168
1204,m1601,20150921,2697,2710,2696,2697,2644,2680,2671,-30,-39,1743610,46577743220,1434452
1205,m1601,20150922,2680,2671,2676,2686,2668,2675,2676,4,5,970412,25973222800,1438790
1206,m1601,20150923,2675,2676,2661,2675,2657,2672,2665,-4,-11,1033140,27542160660,1449814
1207,m1601,20150924,2672,2665,2674,2682,2661,2669,2670,4,5,850236,22705080760,1426604
1208,m1601,20150925,2669,2670,2660,2685,2655,2675,2671,5,1,1051774,28102564760,1381068
1209,m1601,20150928,2675,2671,2690,2699,2665,2674,2678,3,7,736652,19728409480,1339980
1210,m1601,20150929,2674,2678,2667,2673,2630,2646,2652,-32,-26,1399546,37124817300,1250936
1211,m1601,20150930,2646,2652,2653,2678,2651,2670,2666,18,14,890586,23745061300,1138182
1212,m1601,20151008,2670,2666,2680,2687,2648,2652,2667,-14,1,676300,18037839520,1200562
1213,m1601,20151009,2652,2667,2651,2670,2631,2632,2652,-35,-15,1700086,45087091320,1306902
1214,m1601,20151012,2632,2652,2640,2675,2634,2664,2652,12,0,1948864,51686488080,1266960
1215,m1601,20151013,2664,2652,2664,2672,2649,2659,2659,7,7,1324338,35223152240,1317662
1216,m1601,20151014,2659,2659,2664,2706,2661,2693,2688,34,29,2013212,54122687140,1411202
1217,m1601,20151015,2693,2688,2705,2710,2683,2691,2695,3,7,1265522,34109562200,1371286
1218,m1601,20151016,2691,2695,2687,2701,2680,2685,2689,-10,-6,1329018,35750190060,1402494
1219,m1601,20151019,2685,2689,2681,2683,2655,2659,2667,-30,-22,1121832,29925132280,1395648
1220,m1601,20151020,2659,2667,2659,2664,2613,2641,2640,-26,-27,1917316,50630585880,1462126
1221,m1601,20151021,2641,2640,2643,2649,2606,2609,2622,-31,-18,2001784,52496605680,1466500
1222,m1601,20151022,2609,2622,2607,2634,2601,2629,2616,7,-6,1321724,34588654460,1419092
1223,m1601,20151023,2629,2616,2631,2639,2568,2580,2592,-36,-24,2590120,67138729220,1571018
1224,m1601,20151026,2580,2592,2588,2590,2558,2580,2574,-12,-18,1804124,46447488960,1503724
1225,m1601,20151027,2580,2574,2579,2586,2546,2582,2566,8,-8,1498752,38465426120,1427890
1226,m1601,20151028,2582,2566,2586,2596,2572,2580,2582,14,16,1194906,30855665980,1367882
1227,m1601,20151029,2580,2582,2575,2582,2565,2575,2572,-7,-10,1086326,27944128040,1348692
1228,m1601,20151030,2575,2572,2570,2575,2551,2553,2560,-19,-12,990046,25348168560,1385494
1229,m1601,20151102,2553,2560,2559,2567,2542,2553,2556,-7,-4,903520,23095426400,1407850
1230,m1601,20151103,2553,2556,2553,2557,2512,2513,2528,-43,-28,1448324,36625203800,1550682
1231,m1601,20151104,2513,2528,2510,2535,2507,2518,2521,-10,-7,1270408,32029914000,1546678
1232,m1601,20151105,2518,2521,2515,2526,2490,2491,2507,-30,-14,1455916,36502998100,1648922
1233,m1601,20151106,2491,2507,2501,2501,2459,2471,2477,-36,-30,1755904,43506878540,1589568
1234,m1601,20151109,2471,2477,2472,2486,2456,2470,2470,-7,-7,1197602,29590898700,1582476
1235,m1601,20151110,2470,2470,2475,2475,2457,2465,2464,-5,-6,847766,20892121240,1587864
1236,m1601,20151111,2465,2464,2461,2481,2445,2471,2467,7,3,1522140,37554144000,1499386
1237,m1601,20151112,2471,2467,2473,2488,2465,2474,2477,7,10,887140,21980098540,1477142
1238,m1601,20151113,2474,2477,2467,2481,2442,2446,2460,-31,-17,1015022,24973168700,1500982
1239,m1601,20151116,2446,2460,2445,2449,2421,2423,2438,-37,-22,875512,21347945080,1471144
1240,m1601,20151117,2423,2438,2426,2428,2405,2407,2416,-31,-22,879850,21265157340,1446726
1241,m1601,20151118,2407,2416,2410,2435,2406,2422,2421,6,5,1041190,25213289560,1388396
1242,m1601,20151119,2422,2421,2430,2438,2382,2392,2408,-29,-13,1555598,37466845420,1292294
1243,m1601,20151120,2392,2408,2391,2398,2362,2372,2380,-36,-28,1064766,25341469180,1234552
1244,m1601,20151123,2372,2380,2367,2375,2287,2324,2336,-56,-44,1810832,42313529820,1116396
1245,m1601,20151124,2324,2336,2321,2395,2306,2383,2353,47,17,1265636,29783460760,987876
1246,m1601,20151125,2383,2353,2385,2398,2366,2386,2382,33,29,727410,17331441520,911912
1247,m1601,20151126,2386,2382,2384,2460,2372,2448,2421,66,39,827654,20044476980,752500
1248,m1601,20151127,2448,2421,2440,2450,2416,2442,2435,21,14,476536,11606374940,667844
1249,m1601,20151130,2442,2435,2437,2444,2405,2422,2422,-13,-13,321448,7788629460,637358
1250,m1601,20151201,2422,2422,2419,2455,2419,2444,2439,22,17,245126,5979614920,590254
1251,m1601,20151202,2444,2439,2460,2474,2446,2459,2460,20,21,264974,6519688400,545792
1252,m1601,20151203,2459,2460,2459,2461,2424,2425,2435,-35,-25,173938,4236614320,528164
1253,m1601,20151204,2425,2435,2419,2444,2407,2438,2429,3,-6,223016,5418137520,474072
1254,m1601,20151207,2438,2429,2427,2468,2427,2467,2456,38,27,161658,3970651880,420906
1255,m1601,20151208,2467,2456,2466,2468,2395,2410,2418,-46,-38,223776,5411219460,355504
1256,m1601,20151209,2410,2418,2414,2419,2401,2412,2410,-6,-8,152952,3686278860,317564
1257,m1601,20151210,2412,2410,2418,2426,2382,2394,2400,-16,-10,142044,3410337140,289242
1258,m1601,20151211,2394,2400,2391,2443,2391,2426,2407,26,7,106562,2565376940,266494
1259,m1601,20151214,2426,2407,2426,2431,2331,2425,2413,18,6,101148,2441079960,225618
1260,m1601,20151215,2425,2413,2386,2462,2386,2445,2439,32,26,70512,1719945840,200134
1261,m1601,20151216,2445,2439,2440,2459,2435,2456,2450,17,11,39416,965863000,185108
1262,m1601,20151217,2456,2450,2458,2463,2423,2424,2442,-26,-8,50894,1243127920,159064
1263,m1601,20151218,2424,2442,2422,2460,2415,2455,2441,13,-1,39682,968998040,143936
1264,m1601,20151221,2455,2441,2461,2506,2460,2499,2474,58,33,55792,1380590200,113368
1265,m1601,20151222,2499,2474,2501,2508,2485,2493,2496,19,22,37024,924145820,96924
1266,m1601,20151223,2493,2496,2493,2500,2478,2481,2483,-15,-13,22478,558315840,83764
1267,m1601,20151224,2481,2483,2482,2487,2470,2477,2480,-6,-3,25274,626810240,66934
1268,m1601,20151225,2477,2480,2475,2485,2470,2482,2477,2,-3,11602,287452080,59672
1269,m1601,20151228,2482,2477,2478,2481,2458,2465,2468,-12,-9,16390,404632840,49284
1270,m1601,20151229,2465,2468,2460,2480,2460,2479,2471,11,3,16646,411370260,35850
1271,m1601,20151230,2479,2471,2474,2506,2465,2481,2476,10,5,12840,318010920,28806
1272,m1601,20151231,2481,2476,2488,2488,2467,2476,2474,0,-2,18104,447984940,17948
1273,m1603,20150316,2858,2858,2854,2889,2766,2860,2859,2,1,22,629080,16
1274,m1603,20150317,2860,2859,2840,2840,2795,2815,2818,-44,-41,54,1521900,32
1275,m1603,20150318,2815,2818,2815,2816,2802,2802,2809,-16,-9,78,2191520,82
1276,m1603,20150319,2802,2809,2812,2834,2802,2808,2808,-1,-1,40,1123340,92
1277,m1603,20150320,2808,2808,2810,2821,2808,2808,2813,0,5,6,168780,92
1278,m1603,20150323,2808,2813,2817,2850,2817,2835,2836,22,23,20,567380,96
1279,m1603,20150324,2835,2836,2846,2900,2832,2848,2853,12,17,32,913100,104
1280,m1603,20150325,2848,2853,2839,2850,2832,2837,2843,-16,-10,16,454960,102
1281,m1603,20150326,2837,2843,2842,2848,2820,2832,2835,-11,-8,46,1304140,98
1282,m1603,20150327,2832,2835,2821,2846,2806,2811,2821,-24,-14,28,790040,96
1283,m1603,20150330,2811,2821,2820,2820,2820,2820,2820,-1,-1,2,56400,96
1284,m1603,20150331,2820,2820,2800,2816,2800,2805,2810,-15,-10,34,955520,110
1285,m1603,20150401,2805,2810,2816,2870,2813,2858,2853,48,43,46,1312700,104
1286,m1603,20150402,2858,2853,2848,2869,2848,2867,2860,14,7,26,743820,98
1287,m1603,20150403,2867,2860,2855,2863,2849,2849,2856,-11,-4,48,1371200,112
1288,m1603,20150407,2849,2856,2858,2859,2848,2848,2853,-8,-3,10,285340,112
1289,m1603,20150408,2848,2853,2845,2845,2845,2845,2845,-8,-8,4,113800,116
1290,m1603,20150409,2845,2845,2842,2842,2803,2803,2823,-42,-22,86,2427780,166
1291,m1603,20150410,2803,2823,2788,2810,2781,2781,2794,-42,-29,52,1453340,206
1292,m1603,20150413,2781,2794,2789,2797,2781,2792,2791,-2,-3,30,837360,216
1293,m1603,20150414,2792,2791,2791,2804,2791,2802,2796,11,5,124,3467820,312
1294,m1603,20150415,2802,2796,2815,2819,2801,2810,2810,14,14,116,3260740,358
1295,m1603,20150416,2810,2810,2809,2832,2803,2808,2815,-2,5,196,5517800,432
1296,m1603,20150417,2808,2815,2811,2820,2809,2820,2815,5,0,70,1970880,436
1297,m1603,20150420,2820,2815,2815,2840,2815,2828,2827,13,12,96,2714540,426
1298,m1603,20150421,2828,2827,2835,2837,2831,2831,2833,4,6,18,510040,438
1299,m1603,20150422,2831,2833,2836,2836,2817,2817,2826,-16,-7,84,2374660,460
1300,m1603,20150423,2817,2826,2827,2844,2827,2834,2834,8,8,128,3627640,466
1301,m1603,20150424,2834,2834,2834,2860,2800,2815,2821,-19,-13,374,10552240,514
1302,m1603,20150427,2815,2821,2815,2845,2808,2816,2816,-5,-5,90,2534800,520
1303,m1603,20150428,2816,2816,2818,2845,2818,2836,2834,20,18,386,10942860,796
1304,m1603,20150429,2836,2834,2850,2864,2825,2833,2839,-1,5,174,4941500,838
1305,m1603,20150430,2833,2839,2836,2851,2830,2846,2843,7,4,54,1535720,832
1306,m1603,20150504,2846,2843,2832,2832,2811,2819,2816,-24,-27,102,2872400,856
1307,m1603,20150505,2819,2816,2825,2838,2812,2815,2826,-1,10,96,2713280,924
1308,m1603,20150506,2815,2826,2825,2838,2816,2838,2820,12,-6,90,2538720,932
1309,m1603,20150507,2838,2820,2830,2851,2828,2839,2839,19,19,62,1760600,934
1310,m1603,20150508,2839,2839,2833,2833,2809,2815,2816,-24,-23,188,5295260,988
1311,m1603,20150511,2815,2816,2819,2823,2811,2823,2816,7,0,50,1408400,982
1312,m1603,20150512,2823,2816,2816,2816,2771,2776,2788,-40,-28,286,7973940,1096
1313,m1603,20150513,2776,2788,2783,2794,2765,2765,2778,-23,-10,238,6611680,1192
1314,m1603,20150514,2765,2778,2779,2793,2766,2776,2782,-2,4,488,13578740,1528
1315,m1603,20150515,2776,2782,2776,2792,2763,2769,2774,-13,-8,410,11374520,1610
1316,m1603,20150518,2769,2774,2768,2778,2756,2768,2763,-6,-11,480,13264720,1684
1317,m1603,20150519,2768,2763,2763,2774,2755,2760,2763,-3,0,278,7681700,1582
1318,m1603,20150520,2760,2763,2760,2760,2680,2684,2708,-79,-55,176,4767700,1594
1319,m1603,20150521,2684,2708,2693,2700,2684,2687,2696,-21,-12,284,7657800,1592
1320,m1603,20150522,2687,2696,2699,2705,2665,2678,2681,-18,-15,684,18338760,1698
1321,m1603,20150525,2678,2681,2677,2679,2623,2623,2647,-58,-34,222,5877400,1730
1322,m1603,20150526,2623,2647,2637,2651,2630,2635,2639,-12,-8,506,13354560,2044
1323,m1603,20150527,2635,2639,2628,2649,2621,2625,2637,-14,-2,628,16562560,2456
1324,m1603,20150528,2625,2637,2638,2669,2625,2654,2651,17,14,128,3393600,2486
1325,m1603,20150529,2654,2651,2652,2659,2640,2643,2652,-8,1,198,5252600,2534
1326,m1603,20150601,2643,2652,2648,2650,2600,2609,2621,-43,-31,290,7601360,2564
1327,m1603,20150602,2609,2621,2614,2649,2607,2646,2628,25,7,472,12407980,2568
1328,m1603,20150603,2646,2628,2666,2666,2652,2662,2660,34,32,188,5001780,2620
1329,m1603,20150604,2662,2660,2652,2670,2641,2665,2657,5,-3,276,7335080,2756
1330,m1603,20150605,2665,2657,2670,2673,2660,2671,2668,14,11,150,4002100,2808
1331,m1603,20150608,2671,2668,2668,2671,2648,2653,2660,-15,-8,102,2713400,2796
1332,m1603,20150609,2653,2660,2665,2666,2660,2662,2663,2,3,92,2450180,2818
1333,m1603,20150610,2662,2663,2662,2670,2656,2659,2663,-4,0,52,1385240,2816
1334,m1603,20150611,2659,2663,2670,2672,2660,2667,2666,4,3,60,1599760,2820
1335,m1603,20150612,2667,2666,2649,2652,2597,2604,2628,-62,-38,222,5834540,2818
1336,m1603,20150615,2604,2628,2603,2608,2574,2574,2588,-54,-40,104,2691780,2798
1337,m1603,20150616,2574,2588,2564,2596,2557,2583,2577,-5,-11,96,2474280,2782
1338,m1603,20150617,2583,2577,2573,2640,2557,2630,2606,53,29,188,4899620,2782
1339,m1603,20150618,2630,2606,2637,2650,2615,2615,2627,9,21,160,4204060,2810
1340,m1603,20150619,2615,2627,2615,2665,2614,2658,2635,31,8,138,3637320,2850
1341,m1603,20150623,2658,2635,2710,2713,2697,2703,2706,68,71,136,3680160,2836
1342,m1603,20150624,2703,2706,2699,2700,2684,2684,2689,-22,-17,96,2582180,2832
1343,m1603,20150625,2684,2689,2676,2695,2668,2687,2687,-2,-2,36,967640,2830
1344,m1603,20150626,2687,2687,2704,2714,2676,2679,2702,-8,15,1182,31939100,2022
1345,m1603,20150629,2679,2702,2706,2706,2648,2662,2684,-40,-18,366,9824960,1862
1346,m1603,20150630,2662,2684,2681,2687,2624,2635,2659,-49,-25,222,5905080,1790
1347,m1603,20150701,2635,2659,2610,2765,2610,2738,2732,79,73,1144,31259000,1772
1348,m1603,20150702,2738,2732,2703,2715,2682,2700,2698,-32,-34,694,18728160,1748
1349,m1603,20150703,2700,2698,2689,2739,2687,2735,2714,37,16,840,22798100,1848
1350,m1603,20150706,2735,2714,2740,2760,2690,2712,2742,-2,28,894,24515700,1504
1351,m1603,20150707,2712,2742,2700,2769,2700,2730,2728,-12,-14,262,7148300,1432
1352,m1603,20150708,2730,2728,2700,2700,2619,2620,2654,-108,-74,210,5574380,1426
1353,m1603,20150709,2620,2654,2572,2711,2548,2683,2653,29,-1,462,12259820,1444
1354,m1603,20150710,2683,2653,2685,2759,2685,2759,2735,106,82,328,8973280,1440
1355,m1603,20150713,2759,2735,2779,2786,2689,2724,2755,-11,20,252,6944940,1436
1356,m1603,20150714,2724,2755,2732,2830,2724,2806,2787,51,32,180,5017360,1420
1357,m1603,20150715,2806,2787,2792,2794,2741,2756,2757,-31,-30,162,4466920,1412
1358,m1603,20150716,2756,2757,2751,2758,2718,2745,2737,-12,-20,82,2244340,1384
1359,m1603,20150717,2745,2737,2745,2785,2702,2714,2762,-23,25,284,7846100,1286
1360,m1603,20150720,2714,2762,2719,2719,2660,2686,2676,-76,-86,78,2087400,1286
1361,m1603,20150721,2686,2676,2668,2686,2668,2673,2677,-3,1,16,428400,1288
1362,m1603,20150722,2673,2677,2681,2697,2665,2696,2688,19,11,560,15057760,780
1363,m1603,20150723,2696,2688,2694,2718,2675,2705,2678,17,-10,622,16659060,782
1364,m1603,20150724,2705,2678,2702,2702,2645,2681,2676,3,-2,62,1659280,790
1365,m1603,20150727,2681,2676,2670,2670,2611,2611,2654,-65,-22,166,4406360,792
1366,m1603,20150728,2611,2654,2613,2636,2605,2629,2622,-25,-32,40,1049020,786
1367,m1603,20150729,2629,2622,2646,2694,2613,2625,2641,3,19,94,2483040,790
1368,m1603,20150730,2625,2641,2637,2650,2625,2629,2639,-12,-2,80,2111220,784
1369,m1603,20150731,2629,2639,2634,2646,2628,2634,2635,-5,-4,66,1739220,778
1370,m1603,20150803,2634,2635,2626,2632,2602,2609,2614,-26,-21,54,1412000,780
1371,m1603,20150804,2609,2614,2600,2643,2600,2643,2625,29,11,80,2100200,782
1372,m1603,20150805,2643,2625,2650,2659,2627,2639,2644,14,19,40,1057900,790
1373,m1603,20150806,2639,2644,2657,2657,2618,2647,2642,3,-2,62,1638200,802
1374,m1603,20150807,2647,2642,2643,2643,2619,2622,2622,-20,-20,100,2622660,818
1375,m1603,20150810,2622,2622,2628,2690,2627,2681,2666,59,44,48,1279720,812
1376,m1603,20150811,2681,2666,2676,2736,2676,2717,2705,51,39,98,2651480,822
1377,m1603,20150812,2717,2705,2713,2729,2679,2717,2711,12,6,70,1897980,824
1378,m1603,20150813,2717,2711,2758,2758,2633,2670,2712,-41,1,248,6727880,816
1379,m1603,20150814,2670,2712,2651,2684,2651,2665,2665,-47,-47,44,1172820,808
1380,m1603,20150817,2665,2665,2659,2659,2571,2648,2639,-17,-26,60,1583720,818
1381,m1603,20150818,2648,2639,2659,2666,2643,2644,2651,5,12,52,1378680,828
1382,m1603,20150819,2644,2651,2638,2638,2603,2608,2609,-43,-42,252,6577060,766
1383,m1603,20150820,2608,2609,2622,2623,2570,2601,2608,-8,-1,50,1304060,768
1384,m1603,20150821,2601,2608,2615,2628,2599,2608,2609,0,1,100,2609820,768
1385,m1603,20150824,2608,2609,2648,2648,2554,2576,2588,-33,-21,122,3157800,776
1386,m1603,20150825,2576,2588,2501,2621,2501,2611,2608,23,20,298,7774400,768
1387,m1603,20150826,2611,2608,2640,2650,2613,2621,2635,13,27,128,3373380,778
1388,m1603,20150827,2621,2635,2630,2655,2623,2655,2641,20,6,306,8082540,782
1389,m1603,20150828,2655,2641,2656,2682,2631,2634,2653,-7,12,106,2813200,774
1390,m1603,20150831,2634,2653,2634,2657,2623,2627,2636,-26,-17,246,6484700,826
1391,m1603,20150901,2627,2636,2620,2690,2611,2670,2629,34,-7,186,4890080,804
1392,m1603,20150902,2670,2629,2627,2678,2616,2631,2631,2,2,98,2578680,792
1393,m1603,20150907,2631,2631,2630,2630,2600,2604,2605,-27,-26,394,10267120,634
1394,m1603,20150908,2604,2605,2617,2627,2606,2625,2620,20,15,44,1152860,618
1395,m1603,20150909,2625,2620,2637,2674,2620,2658,2640,38,20,20,528080,624
1396,m1603,20150910,2658,2640,2622,2660,2622,2641,2638,1,-2,22,580360,610
1397,m1603,20150911,2641,2638,2639,2642,2629,2629,2640,-9,2,30,792220,602
1398,m1603,20150914,2629,2640,2631,2670,2604,2641,2624,1,-16,334,8767020,760
1399,m1603,20150915,2641,2624,2640,2657,2634,2649,2648,25,24,102,2701960,686
1400,m1603,20150916,2649,2648,2641,2654,2621,2645,2639,-3,-9,96,2534360,632
1401,m1603,20150917,2645,2639,2651,2651,2634,2636,2638,-3,-1,40,1055420,610
1402,m1603,20150918,2636,2638,2638,2644,2628,2628,2635,-10,-3,32,843440,600
1403,m1603,20150921,2628,2635,2620,2666,2603,2605,2626,-30,-9,108,2836400,602
1404,m1603,20150922,2605,2626,2637,2637,2620,2620,2627,-6,1,40,1050940,592
1405,m1603,20150923,2620,2627,2616,2622,2612,2613,2615,-14,-12,28,732420,584
1406,m1603,20150924,2613,2615,2626,2626,2614,2614,2616,-1,1,14,366320,580
1407,m1603,20150925,2614,2616,2616,2625,2616,2625,2617,9,1,36,942200,550
1408,m1603,20150928,2625,2617,0,0,0,2618,2618,1,1,0,0,550
1409,m1603,20150929,2618,2618,2583,2639,2583,2586,2603,-32,-15,22,572840,550
1410,m1603,20150930,2586,2603,2604,2634,2583,2634,2622,31,19,14,367100,556
1411,m1603,20151008,2634,2622,2604,2604,2600,2601,2602,-21,-20,22,572440,538
1412,m1603,20151009,2601,2602,2603,2611,2594,2595,2600,-7,-2,74,1924320,498
1413,m1603,20151012,2595,2600,2640,2640,2595,2598,2605,-2,5,10,260560,498
1414,m1603,20151013,2598,2605,2612,2620,2606,2611,2614,6,9,14,366000,494
1415,m1603,20151014,2611,2614,2629,2650,2627,2633,2639,19,25,56,1477940,502
1416,m1603,20151015,2633,2639,2642,2645,2633,2638,2641,-1,2,60,1584640,534
1417,m1603,20151016,2638,2641,2634,2650,2629,2636,2636,-5,-5,86,2267400,470
1418,m1603,20151019,2636,2636,2629,2629,2616,2624,2624,-12,-12,16,419840,464
1419,m1603,20151020,2624,2624,2621,2622,2614,2615,2617,-9,-7,12,314040,458
1420,m1603,20151021,2615,2617,2625,2625,2600,2600,2607,-17,-10,110,2868080,436
1421,m1603,20151022,2600,2607,2598,2613,2598,2613,2610,6,3,26,678680,418
1422,m1603,20151023,2613,2610,2625,2625,2580,2583,2595,-27,-15,182,4723100,434
1423,m1603,20151026,2583,2595,2585,2586,2555,2575,2577,-20,-18,210,5412180,550
1424,m1603,20151027,2575,2577,2575,2599,2557,2588,2561,11,-16,224,5738580,510
1425,m1603,20151028,2588,2561,2593,2593,2558,2565,2588,4,27,44,1139040,528
1426,m1603,20151029,2565,2588,0,0,0,2588,2588,0,0,0,0,528
1427,m1603,20151030,2588,2588,2560,2576,2560,2570,2567,-18,-21,10,256720,532
1428,m1603,20151102,2570,2567,2553,2561,2535,2535,2551,-32,-16,16,408200,530
1429,m1603,20151103,2535,2551,2532,2550,2520,2540,2535,-11,-16,210,5325200,502
1430,m1603,20151104,2540,2535,2527,2544,2527,2527,2538,-8,3,58,1472600,488
1431,m1603,20151105,2527,2538,2536,2541,2511,2518,2526,-20,-12,92,2324480,490
1432,m1603,20151106,2518,2526,2512,2520,2478,2494,2496,-32,-30,78,1947560,472
1433,m1603,20151109,2494,2496,2485,2501,2485,2501,2497,5,1,12,299740,464
1434,m1603,20151110,2501,2497,2500,2500,2487,2488,2490,-9,-7,28,697300,444
1435,m1603,20151111,2488,2490,2476,2499,2476,2492,2488,2,-2,22,547540,434
1436,m1603,20151112,2492,2488,2501,2501,2495,2500,2499,12,11,26,649740,424
1437,m1603,20151113,2500,2499,2495,2504,2480,2480,2495,-19,-4,36,898380,432
1438,m1603,20151116,2480,2495,2473,2481,2461,2461,2472,-34,-23,64,1582080,420
1439,m1603,20151117,2461,2472,2444,2462,2440,2440,2447,-32,-25,88,2153760,384
1440,m1603,20151118,2440,2447,2453,2467,2449,2454,2456,7,9,136,3341100,344
1441,m1603,20151119,2454,2456,2460,2467,2419,2429,2437,-27,-19,118,2876120,344
1442,m1603,20151120,2429,2437,2405,2426,2387,2393,2401,-44,-36,100,2401720,330
1443,m1603,20151123,2393,2401,2373,2384,2306,2322,2345,-79,-56,172,4035100,330
1444,m1603,20151124,2322,2345,2321,2399,2315,2359,2333,14,-12,114,2660200,318
1445,m1603,20151125,2359,2333,2339,2395,2339,2387,2370,54,37,98,2322720,290
1446,m1603,20151126,2387,2370,2385,2458,2385,2453,2427,83,57,42,1019720,286
1447,m1603,20151127,2453,2427,2433,2452,2428,2444,2441,17,14,30,732560,290
1448,m1603,20151130,2444,2441,2451,2455,2416,2426,2439,-15,-2,102,2488120,302
1449,m1603,20151201,2426,2439,2404,2461,2400,2449,2436,10,-3,64,1559420,304
1450,m1603,20151202,2449,2436,2468,2468,2455,2466,2461,30,25,22,541520,292
1451,m1603,20151203,2466,2461,2435,2448,2428,2428,2436,-33,-25,132,3216400,298
1452,m1603,20151204,2428,2436,2422,2439,2391,2419,2414,-17,-22,90,2173300,304
1453,m1603,20151207,2419,2414,2412,2460,2412,2453,2438,39,24,70,1706860,296
1454,m1603,20151208,2453,2438,2424,2424,2385,2392,2401,-46,-37,24,576320,300
1455,m1603,20151209,2392,2401,2435,2435,2361,2387,2390,-14,-11,52,1243060,296
1456,m1603,20151210,2387,2390,2381,2381,2381,2381,2381,-9,-9,10,238100,296
1457,m1603,20151211,2381,2381,2386,2428,2386,2428,2394,47,13,40,957820,294
1458,m1603,20151214,2428,2394,2436,2439,2370,2383,2407,-11,13,452,10880300,350
1459,m1603,20151215,2383,2407,2413,2435,2412,2435,2429,28,22,50,1214700,310
1460,m1603,20151216,2435,2429,2428,2446,2387,2434,2429,5,0,42,1020280,332
1461,m1603,20151217,2434,2429,2406,2406,2406,2406,2406,-23,-23,2,48120,332
1462,m1603,20151218,2406,2406,0,0,0,2415,2415,9,9,0,0,332
1463,m1603,20151221,2415,2415,0,0,0,2449,2449,34,34,0,0,332
1464,m1603,20151222,2449,2449,2454,2456,2454,2456,2455,7,6,20,491120,316
1465,m1603,20151223,2456,2455,2449,2449,2449,2449,2449,-6,-6,20,489800,298
1466,m1603,20151224,2449,2449,2448,2448,2444,2444,2446,-5,-3,48,1174100,276
1467,m1603,20151225,2444,2446,2443,2445,2425,2445,2441,-1,-5,88,2148920,270
1468,m1603,20151228,2445,2441,2345,2437,2345,2413,2418,-28,-23,20,483720,270
1469,m1603,20151229,2413,2418,2414,2414,2400,2408,2409,-10,-9,8,192720,272
1470,m1603,20151230,2408,2409,0,0,0,2411,2411,2,2,0,0,272
1471,m1603,20151231,2411,2411,0,0,0,2411,2411,0,0,0,0,272
1472,m1605,20150518,2718,2718,2650,2701,2650,2686,2681,-32,-37,75430,2022768640,47966
1473,m1605,20150519,2686,2681,2696,2699,2673,2675,2684,-6,3,34980,939010500,63812
1474,m1605,20150520,2675,2684,2675,2675,2604,2621,2642,-63,-42,52246,1380428080,81792
1475,m1605,20150521,2621,2642,2612,2642,2612,2624,2627,-18,-15,42214,1109242880,100804
1476,m1605,20150522,2624,2627,2628,2638,2606,2628,2618,1,-9,55614,1456136240,130874
1477,m1605,20150525,2628,2618,2628,2632,2586,2590,2601,-28,-17,45216,1176098420,137854
1478,m1605,20150526,2590,2601,2591,2607,2584,2585,2596,-16,-5,43826,1137827100,148206
1479,m1605,20150527,2585,2596,2585,2598,2571,2574,2583,-22,-13,61898,1598924580,176704
1480,m1605,20150528,2574,2583,2570,2597,2570,2578,2584,-5,1,97430,2518398700,187792
1481,m1605,20150529,2578,2584,2589,2589,2571,2575,2578,-9,-6,56484,1456215160,202342
1482,m1605,20150601,2575,2578,2576,2577,2530,2533,2549,-45,-29,111044,2831600540,243820
1483,m1605,20150602,2533,2549,2538,2559,2526,2555,2542,6,-7,135114,3434883020,258012
1484,m1605,20150603,2555,2542,2556,2585,2556,2573,2571,31,29,81700,2100920660,252878
1485,m1605,20150604,2573,2571,2570,2581,2556,2581,2568,10,-3,61106,1569733240,255496
1486,m1605,20150605,2581,2568,2575,2586,2567,2577,2577,9,9,47340,1219986220,260258
1487,m1605,20150608,2577,2577,2577,2584,2561,2567,2569,-10,-8,51822,1331418580,276352
1488,m1605,20150609,2567,2569,2577,2585,2574,2577,2578,8,9,35630,918795300,280198
1489,m1605,20150610,2577,2578,2576,2587,2572,2573,2581,-5,3,43162,1114037360,284024
1490,m1605,20150611,2573,2581,2578,2592,2577,2582,2583,1,2,59510,1537203580,294596
1491,m1605,20150612,2582,2583,2575,2577,2527,2530,2548,-53,-35,101022,2574930480,313760
1492,m1605,20150615,2530,2548,2535,2538,2496,2502,2514,-46,-34,99294,2496623160,358002
1493,m1605,20150616,2502,2514,2455,2534,2455,2521,2517,7,3,82214,2069844360,367958
1494,m1605,20150617,2521,2517,2518,2568,2500,2554,2549,37,32,156026,3977334540,347380
1495,m1605,20150618,2554,2549,2553,2565,2541,2543,2553,-6,4,55490,1416790760,336334
1496,m1605,20150619,2543,2553,2548,2582,2540,2566,2564,13,11,88640,2273314600,328450
1497,m1605,20150623,2566,2564,2607,2635,2607,2623,2621,59,57,71646,1878087080,316504
1498,m1605,20150624,2623,2621,2610,2616,2600,2603,2607,-18,-14,53986,1407465640,323580
1499,m1605,20150625,2603,2607,2601,2614,2591,2599,2602,-8,-5,40266,1047750480,325298
1500,m1605,20150626,2599,2602,2619,2643,2611,2626,2627,24,25,105368,2768177580,316486
1501,m1605,20150629,2626,2627,2650,2668,2607,2623,2636,-4,9,111258,2933835540,316992
1502,m1605,20150630,2623,2636,2632,2651,2581,2592,2604,-44,-32,153994,4010113280,319068
1503,m1605,20150701,2592,2604,2587,2708,2580,2708,2680,104,76,181664,4868993900,322280
1504,m1605,20150702,2708,2680,2708,2708,2683,2708,2693,28,13,137098,3692061200,307806
1505,m1605,20150703,2708,2693,2700,2769,2692,2755,2737,62,44,205186,5617093160,336732
1506,m1605,20150706,2755,2737,2753,2757,2682,2706,2719,-31,-18,124978,3398422140,328960
1507,m1605,20150707,2706,2719,2696,2749,2686,2709,2722,-10,3,173792,4731953120,326374
1508,m1605,20150708,2709,2722,2710,2711,2614,2614,2641,-108,-81,168246,4444011540,327046
1509,m1605,20150709,2614,2641,2483,2710,2483,2667,2627,26,-14,235030,6174274560,309122
1510,m1605,20150710,2667,2627,2690,2732,2684,2732,2713,105,86,127870,3470096680,318430
1511,m1605,20150713,2732,2713,2770,2778,2690,2724,2734,11,21,217958,5960752180,343606
1512,m1605,20150714,2724,2734,2706,2814,2703,2771,2766,37,32,245132,6781647940,357140
1513,m1605,20150715,2771,2766,2758,2787,2728,2739,2754,-27,-12,214018,5895511000,391178
1514,m1605,20150716,2739,2754,2730,2745,2692,2736,2723,-18,-31,185356,5047730120,400222
1515,m1605,20150717,2736,2723,2750,2758,2670,2681,2707,-42,-16,202358,5478513520,393182
1516,m1605,20150720,2681,2707,2680,2695,2625,2645,2655,-62,-52,179350,4761759500,412808
1517,m1605,20150721,2645,2655,2639,2675,2635,2656,2657,1,2,124926,3320506000,425894
1518,m1605,20150722,2656,2657,2655,2688,2648,2688,2666,31,9,147232,3926536920,432680
1519,m1605,20150723,2688,2666,2670,2700,2658,2683,2683,17,17,158740,4259612220,442282
1520,m1605,20150724,2683,2683,2675,2693,2641,2656,2665,-27,-18,163332,4352876380,451620
1521,m1605,20150727,2656,2665,2645,2660,2598,2599,2623,-66,-42,172594,4527169440,484652
1522,m1605,20150728,2599,2623,2590,2606,2575,2603,2595,-20,-28,171350,4446740500,494824
1523,m1605,20150729,2603,2595,2609,2621,2587,2602,2604,7,9,138006,3593884460,508648
1524,m1605,20150730,2602,2604,2605,2629,2596,2603,2612,-1,8,139350,3641036660,519006
1525,m1605,20150731,2603,2612,2621,2630,2601,2611,2612,-1,0,113488,2964506220,512558
1526,m1605,20150803,2611,2612,2601,2616,2575,2580,2593,-32,-19,138454,3590350480,515966
1527,m1605,20150804,2580,2593,2577,2623,2568,2618,2603,25,10,120358,3133871340,520430
1528,m1605,20150805,2618,2603,2625,2642,2609,2623,2624,20,21,159744,4191987620,531948
1529,m1605,20150806,2623,2624,2636,2642,2610,2628,2624,4,0,149340,3919088740,521660
1530,m1605,20150807,2628,2624,2620,2629,2586,2604,2604,-20,-20,172874,4502392320,533562
1531,m1605,20150810,2604,2604,2608,2664,2600,2658,2642,54,38,212472,5614938720,528316
1532,m1605,20150811,2658,2642,2658,2711,2656,2695,2683,53,41,306046,8211559200,515898
1533,m1605,20150812,2695,2683,2685,2707,2677,2700,2693,17,10,290652,7828393700,552168
1534,m1605,20150813,2700,2693,2712,2742,2587,2641,2653,-52,-40,527760,14005161560,632890
1535,m1605,20150814,2641,2653,2643,2654,2628,2628,2639,-25,-14,166346,4390038120,635808
1536,m1605,20150817,2628,2639,2612,2632,2612,2626,2623,-13,-16,165258,4335765960,630572
1537,m1605,20150818,2626,2623,2645,2645,2616,2616,2628,-7,5,186492,4901969280,636558
1538,m1605,20150819,2616,2628,2610,2610,2570,2586,2582,-42,-46,377794,9758190700,638704
1539,m1605,20150820,2586,2582,2595,2598,2556,2568,2574,-14,-8,350896,9032142380,692342
1540,m1605,20150821,2568,2574,2575,2598,2568,2578,2584,4,10,265426,6860379140,683138
1541,m1605,20150824,2578,2584,2578,2587,2514,2536,2541,-48,-43,469008,11918264820,690440
1542,m1605,20150825,2536,2541,2506,2593,2506,2593,2567,52,26,611656,15706069040,660482
1543,m1605,20150826,2593,2567,2615,2636,2592,2602,2612,35,45,408332,10668661840,643524
1544,m1605,20150827,2602,2612,2610,2635,2603,2633,2619,21,7,433954,11365414140,645974
1545,m1605,20150828,2633,2619,2634,2673,2611,2623,2639,4,20,474026,12514133180,648192
1546,m1605,20150831,2623,2639,2623,2639,2596,2596,2617,-43,-22,352070,9217117620,651552
1547,m1605,20150901,2596,2617,2593,2607,2581,2601,2594,-16,-23,226440,5876115380,658980
1548,m1605,20150902,2601,2594,2593,2613,2577,2611,2595,17,1,184792,4795630980,652006
1549,m1605,20150907,2611,2595,2599,2599,2564,2570,2574,-25,-21,166638,4290009680,665076
1550,m1605,20150908,2570,2574,2572,2595,2572,2594,2586,20,12,206296,5336008240,658648
1551,m1605,20150909,2594,2586,2595,2615,2588,2592,2602,6,16,320526,8340197660,670408
1552,m1605,20150910,2592,2602,2600,2605,2587,2595,2595,-7,-7,293538,7617595140,692386
1553,m1605,20150911,2595,2595,2585,2593,2573,2576,2583,-19,-12,413796,10691092760,718958
1554,m1605,20150914,2576,2583,2579,2617,2564,2607,2599,24,16,455100,11832176200,704674
1555,m1605,20150915,2607,2599,2609,2626,2605,2616,2615,17,16,345400,9035311560,711910
1556,m1605,20150916,2616,2615,2610,2627,2600,2618,2613,3,-2,323688,8458379360,717158
1557,m1605,20150917,2618,2613,2618,2624,2600,2604,2608,-9,-5,286960,7486773740,743246
1558,m1605,20150918,2604,2608,2598,2607,2584,2586,2594,-22,-14,261238,6778307680,745172
1559,m1605,20150921,2586,2594,2585,2588,2541,2575,2565,-19,-29,457352,11731082440,747072
1560,m1605,20150922,2575,2565,2571,2580,2566,2574,2573,9,8,184684,4753313520,756086
1561,m1605,20150923,2574,2573,2564,2571,2557,2570,2563,-3,-10,247346,6340991660,806904
1562,m1605,20150924,2570,2563,2570,2579,2560,2570,2567,7,4,167010,4288683780,821484
1563,m1605,20150925,2570,2567,2562,2589,2557,2582,2578,15,11,244642,6307894320,819644
1564,m1605,20150928,2582,2578,2598,2599,2574,2581,2584,3,6,143328,3704723880,800678
1565,m1605,20150929,2581,2584,2579,2580,2542,2546,2555,-38,-29,323018,8255210420,794310
1566,m1605,20150930,2546,2555,2558,2586,2550,2565,2571,10,16,376054,9669963060,781626
1567,m1605,20151008,2565,2571,2585,2585,2551,2553,2567,-18,-4,136322,3500285400,790858
1568,m1605,20151009,2553,2567,2554,2570,2530,2531,2551,-36,-16,467014,11916438080,825356
1569,m1605,20151012,2531,2551,2541,2572,2536,2559,2551,8,0,443298,11312864880,834110
1570,m1605,20151013,2559,2551,2556,2568,2552,2561,2559,10,8,229746,5880911860,851772
1571,m1605,20151014,2561,2559,2562,2610,2562,2601,2593,42,34,518332,13441397240,914870
1572,m1605,20151015,2601,2593,2608,2613,2596,2597,2603,4,10,349128,9090200740,934334
1573,m1605,20151016,2597,2603,2594,2610,2587,2593,2599,-10,-4,417116,10841283560,952890
1574,m1605,20151019,2593,2599,2590,2597,2568,2576,2578,-23,-21,317276,8182462880,987662
1575,m1605,20151020,2576,2578,2573,2582,2548,2570,2567,-8,-11,477468,12256979680,1071056
1576,m1605,20151021,2570,2567,2577,2578,2546,2549,2562,-18,-5,436762,11192794720,1093352
1577,m1605,20151022,2549,2562,2550,2576,2548,2573,2559,11,-3,265324,6791656800,1101002
1578,m1605,20151023,2573,2559,2573,2581,2527,2539,2545,-20,-14,558282,14210319140,1098202
1579,m1605,20151026,2539,2545,2545,2546,2506,2507,2520,-38,-25,516068,13009996760,1107716
1580,m1605,20151027,2507,2520,2507,2508,2474,2504,2492,-16,-28,544656,13573763400,1103386
1581,m1605,20151028,2504,2492,2505,2517,2494,2502,2504,10,12,292490,7326676340,1110032
1582,m1605,20151029,2502,2504,2500,2508,2487,2495,2496,-9,-8,273952,6840233100,1108764
1583,m1605,20151030,2495,2496,2490,2498,2482,2486,2489,-10,-7,244250,6079814820,1103362
1584,m1605,20151102,2486,2489,2490,2497,2483,2490,2490,1,1,157178,3914364420,1104114
1585,m1605,20151103,2490,2490,2492,2492,2457,2458,2474,-32,-16,320868,7939691260,1143786
1586,m1605,20151104,2458,2474,2455,2481,2451,2468,2467,-6,-7,329672,8134647400,1147952
1587,m1605,20151105,2468,2467,2467,2477,2452,2456,2464,-11,-3,307266,7572499240,1156664
1588,m1605,20151106,2456,2464,2460,2462,2419,2433,2437,-31,-27,542800,13228355720,1205196
1589,m1605,20151109,2433,2437,2433,2454,2418,2445,2438,8,1,395522,9646459940,1202116
1590,m1605,20151110,2445,2438,2443,2446,2427,2428,2434,-10,-4,334294,8138818280,1244224
1591,m1605,20151111,2428,2434,2423,2448,2410,2425,2432,-9,-2,559364,13605659740,1211264
1592,m1605,20151112,2425,2432,2429,2445,2421,2437,2437,5,5,302138,7364285360,1195324
1593,m1605,20151113,2437,2437,2432,2445,2418,2420,2431,-17,-6,311802,7580287840,1218974
1594,m1605,20151116,2420,2431,2420,2424,2398,2403,2413,-28,-18,431776,10422031120,1238732
1595,m1605,20151117,2403,2413,2401,2409,2389,2399,2399,-14,-14,379440,9105571600,1229770
1596,m1605,20151118,2399,2399,2401,2426,2400,2411,2413,12,14,453712,10949807560,1206012
1597,m1605,20151119,2411,2413,2415,2424,2355,2363,2382,-50,-31,865602,20625267100,1232366
1598,m1605,20151120,2363,2382,2360,2370,2321,2325,2343,-57,-39,889440,20843015240,1315056
1599,m1605,20151123,2325,2343,2321,2328,2250,2255,2288,-88,-55,1642780,37593438280,1456918
1600,m1605,20151124,2255,2288,2255,2319,2246,2313,2285,25,-3,1615930,36927575920,1538704
1601,m1605,20151125,2313,2285,2316,2341,2294,2318,2316,33,31,1666120,38588589600,1607836
1602,m1605,20151126,2318,2316,2314,2378,2300,2365,2343,49,27,1877008,43987566420,1611402
1603,m1605,20151127,2365,2343,2361,2378,2340,2363,2359,20,16,1360946,32110969000,1631664
1604,m1605,20151130,2363,2359,2360,2365,2330,2342,2346,-17,-13,1219012,28598478380,1616028
1605,m1605,20151201,2342,2346,2343,2385,2340,2366,2363,20,17,1404106,33180423820,1632446
1606,m1605,20151202,2366,2363,2380,2390,2361,2380,2376,17,13,1285790,30556387620,1689952
1607,m1605,20151203,2380,2376,2376,2379,2335,2336,2353,-40,-23,1420876,33437596660,1813040
1608,m1605,20151204,2336,2353,2332,2347,2313,2341,2330,-12,-23,1611108,37542376960,1944754
1609,m1605,20151207,2341,2330,2335,2378,2333,2371,2359,41,29,1398232,32994114240,1838292
1610,m1605,20151208,2371,2359,2368,2371,2284,2309,2322,-50,-37,1929664,44814291620,1792924
1611,m1605,20151209,2309,2322,2315,2319,2289,2300,2304,-22,-18,1475130,34000792040,1695990
1612,m1605,20151210,2300,2304,2305,2313,2285,2294,2297,-10,-7,1109462,25492360100,1749596
1613,m1605,20151211,2294,2297,2295,2341,2292,2340,2316,43,19,1391598,32238938160,1620724
1614,m1605,20151214,2340,2316,2338,2348,2321,2345,2336,29,20,1382658,32303334500,1620036
1615,m1605,20151215,2345,2336,2338,2371,2332,2344,2351,8,15,1571534,36950922520,1579328
1616,m1605,20151216,2344,2351,2350,2361,2330,2355,2348,4,-3,1322676,31069211380,1609132
1617,m1605,20151217,2355,2348,2353,2364,2311,2314,2336,-34,-12,1892990,44235783760,1847328
1618,m1605,20151218,2314,2336,2317,2367,2309,2365,2341,29,5,1756952,41142650160,1706694
1619,m1605,20151221,2365,2341,2370,2419,2364,2418,2385,77,44,1784970,42587559260,1664996
1620,m1605,20151222,2418,2385,2417,2422,2398,2406,2410,21,25,1492704,35987173000,1639428
1621,m1605,20151223,2406,2410,2409,2412,2385,2397,2398,-13,-12,1248652,29943722180,1620044
1622,m1605,20151224,2397,2398,2396,2402,2373,2382,2387,-16,-11,1265586,30213578180,1611402
1623,m1605,20151225,2382,2387,2386,2390,2361,2364,2375,-23,-12,1103264,26206174680,1596112
1624,m1605,20151228,2364,2375,2366,2372,2338,2345,2354,-30,-21,1102178,25947801900,1594344
1625,m1605,20151229,2345,2354,2344,2371,2341,2370,2355,16,1,1133802,26705140280,1582254
1626,m1605,20151230,2370,2355,2368,2377,2350,2360,2363,5,8,1760472,41606743100,1670914
1627,m1605,20151231,2360,2363,2359,2380,2353,2380,2367,17,4,1436936,34024620980,1511136
1628,m1607,20150715,2734,2734,2841,2841,2737,2769,2763,35,29,22,607980,16
1629,m1607,20150716,2769,2763,2744,2787,2663,2720,2722,-43,-41,208,5663740,64
1630,m1607,20150717,2720,2722,2748,2748,2688,2704,2707,-18,-15,78,2111960,110
1631,m1607,20150720,2704,2707,2666,2718,2615,2643,2689,-64,-18,740,19900280,110
1632,m1607,20150721,2643,2689,2688,2689,2647,2652,2662,-37,-27,96,2556160,114
1633,m1607,20150722,2652,2662,2664,2682,2655,2682,2669,20,7,104,2776740,130
1634,m1607,20150723,2682,2669,2676,2708,2661,2687,2686,18,17,134,3600460,124
1635,m1607,20150724,2687,2686,2686,2748,2634,2665,2682,-21,-4,102,2736460,146
1636,m1607,20150727,2665,2682,2665,2665,2615,2616,2635,-66,-47,66,1739140,164
1637,m1607,20150728,2616,2635,2622,2622,2594,2616,2613,-19,-22,28,731900,170
1638,m1607,20150729,2616,2613,2623,2623,2604,2614,2612,1,-1,38,992600,170
1639,m1607,20150730,2614,2612,2629,2641,2616,2616,2625,4,13,28,735020,168
1640,m1607,20150731,2616,2625,2628,2634,2616,2616,2622,-9,-3,80,2097760,194
1641,m1607,20150803,2616,2622,2617,2625,2586,2597,2607,-25,-15,92,2399100,182
1642,m1607,20150804,2597,2607,2613,2630,2605,2613,2616,6,9,30,784940,184
1643,m1607,20150805,2613,2616,2629,2642,2620,2634,2632,18,16,76,2000360,214
1644,m1607,20150806,2634,2632,2633,2650,2623,2638,2632,6,0,148,3895820,224
1645,m1607,20150807,2638,2632,2613,2613,2600,2607,2606,-25,-26,12,312760,230
1646,m1607,20150810,2607,2606,2612,2677,2612,2659,2653,53,47,82,2176120,220
1647,m1607,20150811,2659,2653,2664,2715,2664,2702,2687,49,34,188,5052100,242
1648,m1607,20150812,2702,2687,2688,2707,2685,2707,2697,20,10,112,3020940,224
1649,m1607,20150813,2707,2697,2720,2742,2594,2644,2654,-53,-43,400,10618240,304
1650,m1607,20150814,2644,2654,2644,2662,2636,2638,2647,-16,-7,88,2329620,324
1651,m1607,20150817,2638,2647,2636,2636,2630,2635,2631,-12,-16,42,1105220,320
1652,m1607,20150818,2635,2631,2644,2644,2624,2624,2636,-7,5,32,843720,320
1653,m1607,20150819,2624,2636,2597,2603,2580,2590,2587,-46,-49,98,2535900,330
1654,m1607,20150820,2590,2587,2594,2594,2563,2580,2577,-7,-10,120,3093520,318
1655,m1607,20150821,2580,2577,2585,2610,2581,2592,2593,15,16,52,1348600,318
1656,m1607,20150824,2592,2593,2590,2590,2526,2543,2542,-50,-51,294,7473900,338
1657,m1607,20150825,2543,2542,2524,2601,2524,2590,2581,48,39,88,2271720,326
1658,m1607,20150826,2590,2581,2582,2637,2579,2620,2614,39,33,266,6955020,390
1659,m1607,20150827,2620,2614,2630,2639,2618,2639,2630,25,16,48,1262520,364
1660,m1607,20150828,2639,2630,2654,2665,2625,2631,2649,1,19,56,1483600,360
1661,m1607,20150831,2631,2649,2636,2647,2614,2614,2628,-35,-21,58,1524260,374
1662,m1607,20150901,2614,2628,2604,2619,2600,2611,2610,-17,-18,128,3341160,380
1663,m1607,20150902,2611,2610,2607,2617,2598,2617,2611,7,1,40,1044460,370
1664,m1607,20150907,2617,2611,2587,2613,2581,2594,2593,-17,-18,36,933680,378
1665,m1607,20150908,2594,2593,2601,2618,2601,2616,2610,23,17,36,939920,396
1666,m1607,20150909,2616,2610,2623,2632,2617,2617,2621,7,11,50,1310800,378
1667,m1607,20150910,2617,2621,2606,2624,2606,2624,2617,3,-4,14,366440,376
1668,m1607,20150911,2624,2617,2610,2617,2610,2617,2612,0,-5,18,470320,382
1669,m1607,20150914,2617,2612,2601,2644,2595,2637,2621,25,9,32,838880,374
1670,m1607,20150915,2637,2621,2630,2645,2628,2645,2635,24,14,64,1686820,396
1671,m1607,20150916,2645,2635,2610,2640,2610,2625,2632,-10,-3,34,895000,396
1672,m1607,20150917,2625,2632,2625,2632,2625,2632,2627,0,-5,6,157640,394
1673,m1607,20150918,2632,2627,2595,2623,2595,2615,2617,-12,-10,18,471120,394
1674,m1607,20150921,2615,2617,2608,2608,2570,2603,2588,-14,-29,64,1656460,416
1675,m1607,20150922,2603,2588,2592,2596,2592,2596,2593,8,5,22,570580,420
1676,m1607,20150923,2596,2593,2578,2585,2578,2585,2582,-8,-11,6,154960,418
1677,m1607,20150924,2585,2582,2599,2599,2599,2599,2599,17,17,4,103960,418
1678,m1607,20150925,2599,2599,2588,2599,2587,2599,2592,0,-7,22,570360,410
1679,m1607,20150928,2599,2592,2604,2605,2604,2605,2604,13,12,6,156280,410
1680,m1607,20150929,2605,2604,2569,2569,2569,2569,2569,-35,-35,2,51380,410
1681,m1607,20150930,2569,2569,2576,2604,2575,2586,2587,17,18,68,1759500,402
1682,m1607,20151008,2586,2587,2592,2594,2569,2569,2586,-18,-1,8,206940,402
1683,m1607,20151009,2569,2586,2567,2574,2551,2551,2563,-35,-23,14,358920,402
1684,m1607,20151012,2551,2563,2556,2563,2548,2563,2556,0,-7,8,204500,398
1685,m1607,20151013,2563,2556,2571,2580,2571,2580,2575,24,19,4,103020,396
1686,m1607,20151014,2580,2575,2580,2615,2580,2608,2600,33,25,94,2444680,404
1687,m1607,20151015,2608,2600,2612,2620,2609,2611,2614,11,14,48,1255100,414
1688,m1607,20151016,2611,2614,2602,2612,2602,2603,2607,-11,-7,18,469380,422
1689,m1607,20151019,2603,2607,2597,2598,2597,2598,2597,-9,-10,8,207820,424
1690,m1607,20151020,2598,2597,2591,2594,2565,2570,2580,-27,-17,50,1290040,426
1691,m1607,20151021,2570,2580,2587,2589,2565,2572,2576,-8,-4,48,1236940,428
1692,m1607,20151022,2572,2576,2563,2580,2562,2580,2571,4,-5,8,205680,426
1693,m1607,20151023,2580,2571,2586,2586,2560,2560,2572,-11,1,6,154360,424
1694,m1607,20151026,2560,2572,2534,2554,2527,2527,2542,-45,-30,24,610160,438
1695,m1607,20151027,2527,2542,2481,2527,2481,2509,2509,-33,-33,50,1254980,438
1696,m1607,20151028,2509,2509,2523,2525,2504,2512,2516,3,7,8,201280,432
1697,m1607,20151029,2512,2516,2506,2507,2506,2507,2506,-9,-10,14,350960,432
1698,m1607,20151030,2507,2506,2510,2510,2503,2503,2506,-3,0,4,100260,432
1699,m1607,20151102,2503,2506,2505,2515,2505,2515,2506,9,0,14,350900,434
1700,m1607,20151103,2515,2506,2506,2506,2476,2476,2491,-30,-15,6,149500,432
1701,m1607,20151104,2476,2491,0,0,0,2485,2485,-6,-6,0,0,432
1702,m1607,20151105,2485,2485,0,0,0,2475,2475,-10,-10,0,0,432
1703,m1607,20151106,2475,2475,2463,2463,2463,2463,2463,-12,-12,4,98520,432
1704,m1607,20151109,2463,2463,2471,2471,2444,2450,2450,-13,-13,12,294020,434
1705,m1607,20151110,2450,2450,2460,2460,2450,2452,2456,2,6,16,393100,436
1706,m1607,20151111,2452,2456,2445,2459,2445,2459,2453,3,-3,6,147220,434
1707,m1607,20151112,2459,2453,2447,2460,2447,2454,2453,1,0,12,294420,430
1708,m1607,20151113,2454,2453,2458,2458,2446,2446,2450,-7,-3,6,147020,430
1709,m1607,20151116,2446,2450,2431,2445,2418,2429,2430,-21,-20,40,972380,446
1710,m1607,20151117,2429,2430,2413,2425,2413,2422,2417,-8,-13,38,918780,426
1711,m1607,20151118,2422,2417,2426,2440,2422,2428,2429,11,12,26,631780,420
1712,m1607,20151119,2428,2429,2395,2409,2380,2380,2394,-49,-35,42,1005480,416
1713,m1607,20151120,2380,2394,2366,2378,2354,2354,2364,-40,-30,50,1182200,412
1714,m1607,20151123,2354,2364,2331,2331,2282,2282,2312,-82,-52,6,138760,410
1715,m1607,20151124,2282,2312,2266,2326,2266,2326,2290,14,-22,76,1741000,360
1716,m1607,20151125,2326,2290,0,0,0,2326,2326,36,36,0,0,360
1717,m1607,20151126,2326,2326,2325,2392,2318,2378,2361,52,35,102,2408480,306
1718,m1607,20151127,2378,2361,2373,2377,2363,2363,2369,2,8,14,331700,304
1719,m1607,20151130,2363,2369,2370,2370,2341,2355,2354,-14,-15,8,188380,306
1720,m1607,20151201,2355,2354,2367,2385,2367,2374,2377,20,23,12,285260,304
1721,m1607,20151202,2374,2377,2381,2392,2381,2392,2386,15,9,4,95460,304
1722,m1607,20151203,2392,2386,2384,2384,2365,2365,2374,-21,-12,10,237400,308
1723,m1607,20151204,2365,2374,2322,2362,2322,2351,2342,-23,-32,18,421660,306
1724,m1607,20151207,2351,2342,2361,2386,2360,2386,2369,44,27,12,284320,306
1725,m1607,20151208,2386,2369,2370,2372,2322,2327,2336,-42,-33,56,1308200,322
1726,m1607,20151209,2327,2336,2334,2334,2312,2319,2323,-17,-13,18,418200,324
1727,m1607,20151210,2319,2323,2330,2330,2314,2314,2323,-9,0,18,418140,330
1728,m1607,20151211,2314,2323,2324,2345,2321,2345,2331,22,8,32,745940,334
1729,m1607,20151214,2345,2331,2354,2355,2300,2352,2308,21,-23,562,12971360,700
1730,m1607,20151215,2352,2308,2351,2379,2345,2345,2362,37,54,310,7323260,620
1731,m1607,20151216,2345,2362,2353,2374,2349,2357,2352,-5,-10,76,1787540,574
1732,m1607,20151217,2357,2352,2367,2375,2321,2333,2324,-19,-28,726,16877880,1142
1733,m1607,20151218,2333,2324,2329,2386,2324,2386,2349,62,25,576,13533860,992
1734,m1607,20151221,2386,2349,2386,2442,2376,2442,2414,93,65,562,13571500,698
1735,m1607,20151222,2442,2414,2431,2440,2423,2423,2435,9,21,38,925560,698
1736,m1607,20151223,2423,2435,2430,2430,2413,2429,2422,-6,-13,28,678400,682
1737,m1607,20151224,2429,2422,2419,2419,2409,2409,2411,-13,-11,30,723320,666
1738,m1607,20151225,2409,2411,2409,2409,2384,2389,2400,-22,-11,44,1056380,686
1739,m1607,20151228,2389,2400,2384,2387,2365,2372,2372,-28,-28,64,1518140,672
1740,m1607,20151229,2372,2372,0,0,0,2386,2386,14,14,0,0,672
1741,m1607,20151230,2386,2386,2399,2399,2376,2376,2391,-10,5,24,573860,670
1742,m1607,20151231,2376,2391,2385,2399,2385,2399,2387,8,-4,12,286480,660
1743,m1608,20150817,2653,2653,0,0,0,2653,2653,0,0,0,0,0
1744,m1608,20150818,2653,2653,0,0,0,2653,2653,0,0,0,0,0
1745,m1608,20150819,2653,2653,2658,2658,2658,2658,2658,5,5,2,53160,2
1746,m1608,20150820,2658,2658,2586,2598,2555,2591,2584,-67,-74,20,516860,12
1747,m1608,20150821,2591,2584,0,0,0,2584,2584,0,0,0,0,12
1748,m1608,20150824,2584,2584,0,0,0,2569,2569,-15,-15,0,0,12
1749,m1608,20150825,2569,2569,0,0,0,2570,2570,1,1,0,0,12
1750,m1608,20150826,2570,2570,2581,2653,2581,2600,2611,30,41,6,156680,12
1751,m1608,20150827,2600,2611,0,0,0,2616,2616,5,5,0,0,12
1752,m1608,20150828,2616,2616,2680,2686,2653,2656,2668,40,52,16,426920,14
1753,m1608,20150831,2656,2668,0,0,0,2640,2640,-28,-28,0,0,14
1754,m1608,20150901,2640,2640,2608,2608,2601,2601,2603,-39,-37,6,156200,12
1755,m1608,20150902,2601,2603,2592,2607,2592,2607,2599,4,-4,4,103980,8
1756,m1608,20150907,2607,2599,0,0,0,2599,2599,0,0,0,0,8
1757,m1608,20150908,2599,2599,0,0,0,2599,2599,0,0,0,0,8
1758,m1608,20150909,2599,2599,2645,2645,2601,2601,2623,2,24,4,104920,8
1759,m1608,20150910,2601,2623,0,0,0,2623,2623,0,0,0,0,8
1760,m1608,20150911,2623,2623,2682,2682,2596,2596,2640,-27,17,52,1372940,8
1761,m1608,20150914,2596,2640,2611,2649,2611,2649,2630,9,-10,4,105200,12
1762,m1608,20150915,2649,2630,2647,2654,2632,2654,2650,24,20,30,795220,32
1763,m1608,20150916,2654,2650,2654,2661,2639,2652,2648,2,-2,28,741640,38
1764,m1608,20150917,2652,2648,2637,2652,2637,2641,2643,-7,-5,12,317260,38
1765,m1608,20150918,2641,2643,2630,2630,2617,2617,2622,-26,-21,10,262200,40
1766,m1608,20150921,2617,2622,2611,2620,2591,2613,2605,-9,-17,12,312700,40
1767,m1608,20150922,2613,2605,0,0,0,2605,2605,0,0,0,0,40
1768,m1608,20150923,2605,2605,2616,2616,2616,2616,2616,11,11,2,52320,40
1769,m1608,20150924,2616,2616,0,0,0,2607,2607,-9,-9,0,0,40
1770,m1608,20150925,2607,2607,2601,2601,2601,2601,2601,-6,-6,2,52020,38
1771,m1608,20150928,2601,2601,2601,2620,2596,2617,2605,16,4,24,625300,40
1772,m1608,20150929,2617,2605,2606,2613,2580,2580,2602,-25,-3,8,208180,38
1773,m1608,20150930,2580,2602,2568,2601,2568,2601,2588,-1,-14,8,207060,36
1774,m1608,20151008,2601,2588,2596,2596,2596,2596,2596,8,8,2,51920,38
1775,m1608,20151009,2596,2596,2581,2581,2581,2581,2581,-15,-15,4,103240,38
1776,m1608,20151012,2581,2581,2569,2590,2569,2590,2578,9,-3,14,361040,34
1777,m1608,20151013,2590,2578,0,0,0,2578,2578,0,0,0,0,34
1778,m1608,20151014,2578,2578,2592,2626,2582,2613,2609,35,31,42,1095960,52
1779,m1608,20151015,2613,2609,2618,2618,2616,2616,2617,7,8,24,628280,34
1780,m1608,20151016,2616,2617,0,0,0,2614,2614,-3,-3,0,0,34
1781,m1608,20151019,2614,2614,2602,2606,2589,2593,2596,-21,-18,24,623060,38
1782,m1608,20151020,2593,2596,2595,2598,2581,2581,2593,-15,-3,24,622400,36
1783,m1608,20151021,2581,2593,2606,2606,2570,2570,2587,-23,-6,28,724540,38
1784,m1608,20151022,2570,2587,2585,2594,2585,2594,2589,7,2,4,103580,36
1785,m1608,20151023,2594,2589,2563,2563,2559,2562,2561,-27,-28,12,307360,38
1786,m1608,20151026,2562,2561,2546,2546,2539,2539,2542,-22,-19,4,101700,36
1787,m1608,20151027,2539,2542,2512,2512,2512,2512,2512,-30,-30,2,50240,38
1788,m1608,20151028,2512,2512,2542,2542,2524,2524,2533,12,21,22,557340,48
1789,m1608,20151029,2524,2533,2526,2526,2512,2523,2523,-10,-10,12,302780,38
1790,m1608,20151030,2523,2523,2512,2512,2512,2512,2512,-11,-11,2,50240,40
1791,m1608,20151102,2512,2512,2515,2519,2515,2519,2517,7,5,4,100680,40
1792,m1608,20151103,2519,2517,0,0,0,2517,2517,0,0,0,0,40
1793,m1608,20151104,2517,2517,0,0,0,2517,2517,0,0,0,0,40
1794,m1608,20151105,2517,2517,2492,2492,2491,2492,2491,-25,-26,6,149500,44
1795,m1608,20151106,2492,2491,0,0,0,2479,2479,-12,-12,0,0,44
1796,m1608,20151109,2479,2479,0,0,0,2479,2479,0,0,0,0,44
1797,m1608,20151110,2479,2479,0,0,0,2471,2471,-8,-8,0,0,44
1798,m1608,20151111,2471,2471,0,0,0,2468,2468,-3,-3,0,0,44
1799,m1608,20151112,2468,2468,2456,2456,2456,2456,2456,-12,-12,2,49120,44
1800,m1608,20151113,2456,2456,0,0,0,2456,2456,0,0,0,0,44
1801,m1608,20151116,2456,2456,0,0,0,2445,2445,-11,-11,0,0,44
1802,m1608,20151117,2445,2445,0,0,0,2430,2430,-15,-15,0,0,44
1803,m1608,20151118,2430,2430,0,0,0,2430,2430,0,0,0,0,44
1804,m1608,20151119,2430,2430,0,0,0,2430,2430,0,0,0,0,44
1805,m1608,20151120,2430,2430,2377,2381,2340,2365,2368,-65,-62,10,236800,40
1806,m1608,20151123,2365,2368,2323,2360,2322,2360,2335,-8,-33,6,140100,42
1807,m1608,20151124,2360,2335,0,0,0,2335,2335,0,0,0,0,42
1808,m1608,20151125,2335,2335,2351,2351,2351,2351,2351,16,16,6,141060,40
1809,m1608,20151126,2351,2351,0,0,0,2351,2351,0,0,0,0,40
1810,m1608,20151127,2351,2351,2372,2375,2365,2365,2371,14,20,8,189680,38
1811,m1608,20151130,2365,2371,2354,2381,2354,2381,2367,10,-4,4,94700,36
1812,m1608,20151201,2381,2367,0,0,0,2367,2367,0,0,0,0,36
1813,m1608,20151202,2367,2367,2402,2402,2402,2402,2402,35,35,2,48040,36
1814,m1608,20151203,2402,2402,2375,2375,2370,2370,2371,-32,-31,14,332060,46
1815,m1608,20151204,2370,2371,0,0,0,2371,2371,0,0,0,0,46
1816,m1608,20151207,2371,2371,2407,2407,2407,2407,2407,36,36,4,96280,48
1817,m1608,20151208,2407,2407,2320,2320,2319,2319,2319,-88,-88,22,510200,46
1818,m1608,20151209,2319,2319,2337,2346,2335,2346,2339,27,20,8,187120,46
1819,m1608,20151210,2346,2339,0,0,0,2339,2339,0,0,0,0,46
1820,m1608,20151211,2339,2339,2301,2353,2301,2321,2325,-18,-14,6,139500,46
1821,m1608,20151214,2321,2325,0,0,0,2348,2348,23,23,0,0,46
1822,m1608,20151215,2348,2348,0,0,0,2348,2348,0,0,0,0,46
1823,m1608,20151216,2348,2348,0,0,0,2348,2348,0,0,0,0,46
1824,m1608,20151217,2348,2348,2396,2396,2358,2358,2382,10,34,10,238220,52
1825,m1608,20151218,2358,2382,2361,2380,2361,2377,2369,-5,-13,12,284360,50
1826,m1608,20151221,2377,2369,2403,2403,2384,2393,2393,24,24,22,526540,40
1827,m1608,20151222,2393,2393,2411,2411,2411,2411,2411,18,18,2,48220,40
1828,m1608,20151223,2411,2411,2442,2442,2410,2411,2436,0,25,24,584820,40
1829,m1608,20151224,2411,2436,2411,2412,2407,2408,2408,-28,-28,16,385360,32
1830,m1608,20151225,2408,2408,0,0,0,2396,2396,-12,-12,0,0,32
1831,m1608,20151228,2396,2396,2373,2392,2372,2392,2380,-4,-16,12,285700,28
1832,m1608,20151229,2392,2380,2373,2376,2364,2366,2369,-14,-11,8,189580,30
1833,m1608,20151230,2366,2369,0,0,0,2369,2369,0,0,0,0,30
1834,m1608,20151231,2369,2369,0,0,0,2373,2373,4,4,0,0,30
1835,m1609,20150917,2615,2615,2630,2650,2601,2608,2616,-7,1,61878,1619256520,39866
1836,m1609,20150918,2608,2616,2601,2607,2586,2590,2597,-26,-19,28420,738152920,55920
1837,m1609,20150921,2590,2597,2593,2593,2546,2579,2566,-18,-31,30636,786132980,70112
1838,m1609,20150922,2579,2566,2576,2583,2570,2577,2576,11,10,7292,187895000,70814
1839,m1609,20150923,2577,2576,2561,2572,2549,2562,2558,-14,-18,24550,628115820,75170
1840,m1609,20150924,2562,2558,2564,2567,2549,2551,2554,-7,-4,15652,399879180,80136
1841,m1609,20150925,2551,2554,2545,2566,2540,2563,2555,9,1,14628,373823100,82312
1842,m1609,20150928,2563,2555,2571,2581,2556,2563,2567,8,12,14380,369274520,83188
1843,m1609,20150929,2563,2567,2556,2562,2528,2531,2539,-36,-28,30406,772254280,95448
1844,m1609,20150930,2531,2539,2538,2558,2531,2545,2545,6,6,22472,572105940,97562
1845,m1609,20151008,2545,2545,2556,2558,2537,2539,2548,-6,3,27196,693042320,112142
1846,m1609,20151009,2539,2548,2540,2553,2518,2520,2537,-28,-11,47854,1214368980,134916
1847,m1609,20151012,2520,2537,2530,2552,2524,2546,2538,9,1,42894,1088699540,144324
1848,m1609,20151013,2546,2538,2542,2551,2536,2545,2541,7,3,19780,502786920,143624
1849,m1609,20151014,2545,2541,2550,2588,2545,2582,2574,41,33,43856,1128909740,138482
1850,m1609,20151015,2582,2574,2585,2591,2568,2568,2578,-6,4,32764,844851720,146610
1851,m1609,20151016,2568,2578,2572,2579,2563,2566,2571,-12,-7,38480,989354740,151914
1852,m1609,20151019,2566,2571,2564,2565,2547,2549,2554,-22,-17,37382,954823020,155990
1853,m1609,20151020,2549,2554,2548,2568,2533,2549,2552,-5,-2,61168,1561363360,174168
1854,m1609,20151021,2549,2552,2556,2560,2536,2538,2548,-14,-4,36462,929246740,183660
1855,m1609,20151022,2538,2548,2537,2560,2537,2558,2549,10,1,39972,1018919360,187942
1856,m1609,20151023,2558,2549,2561,2563,2522,2530,2537,-19,-12,52602,1334711500,189456
1857,m1609,20151026,2530,2537,2524,2537,2502,2503,2514,-34,-23,54586,1372306760,206696
1858,m1609,20151027,2503,2514,2501,2503,2474,2489,2484,-25,-30,110960,2757275840,238762
1859,m1609,20151028,2489,2484,2493,2498,2481,2487,2489,3,5,41222,1026167440,245944
1860,m1609,20151029,2487,2489,2489,2491,2476,2479,2480,-10,-9,49588,1230113980,255542
1861,m1609,20151030,2479,2480,2478,2483,2467,2473,2473,-7,-7,27498,680209480,258724
1862,m1609,20151102,2473,2473,2473,2482,2461,2475,2475,2,2,18744,464025900,259084
1863,m1609,20151103,2475,2475,2470,2476,2451,2451,2460,-24,-15,36498,898123580,256848
1864,m1609,20151104,2451,2460,2450,2467,2444,2460,2457,0,-3,37414,919356460,260470
1865,m1609,20151105,2460,2457,2460,2478,2446,2448,2459,-9,2,51666,1270619920,268232
1866,m1609,20151106,2448,2459,2452,2454,2425,2435,2437,-24,-22,61800,1506326020,274590
1867,m1609,20151109,2435,2437,2437,2451,2423,2448,2439,11,2,45398,1107299940,275342
1868,m1609,20151110,2448,2439,2448,2449,2427,2429,2437,-10,-2,48402,1179926500,274814
1869,m1609,20151111,2429,2437,2428,2445,2414,2419,2429,-18,-8,54090,1314320580,278720
1870,m1609,20151112,2419,2429,2424,2444,2419,2432,2434,3,5,41994,1022417740,277118
1871,m1609,20151113,2432,2434,2426,2440,2418,2420,2429,-14,-5,37506,911058900,281118
1872,m1609,20151116,2420,2429,2418,2424,2400,2403,2412,-26,-17,54600,1317456140,287448
1873,m1609,20151117,2403,2412,2408,2409,2389,2397,2399,-15,-13,54256,1301864720,295098
1874,m1609,20151118,2397,2399,2399,2419,2396,2402,2408,3,9,47362,1140506540,291820
1875,m1609,20151119,2402,2408,2408,2415,2350,2354,2371,-54,-37,115004,2726886740,319022
1876,m1609,20151120,2354,2371,2350,2363,2319,2322,2334,-49,-37,133826,3123957640,364238
1877,m1609,20151123,2322,2334,2319,2325,2251,2264,2287,-70,-47,198404,4538278860,387124
1878,m1609,20151124,2264,2287,2268,2322,2253,2315,2291,28,4,202466,4638698180,368464
1879,m1609,20151125,2315,2291,2321,2337,2296,2322,2315,31,24,154480,3577346600,406292
1880,m1609,20151126,2322,2315,2318,2384,2305,2373,2350,58,35,179140,4210834440,394324
1881,m1609,20151127,2373,2350,2390,2390,2350,2374,2369,24,19,158118,3746047300,367168
1882,m1609,20151130,2374,2369,2371,2375,2347,2358,2359,-11,-10,108468,2559286560,377366
1883,m1609,20151201,2358,2359,2361,2391,2344,2373,2372,14,13,110110,2612769540,377346
1884,m1609,20151202,2373,2372,2390,2399,2372,2386,2386,14,14,80368,1917684060,372798
1885,m1609,20151203,2386,2386,2387,2388,2349,2351,2362,-35,-24,100930,2384281560,387898
1886,m1609,20151204,2351,2362,2350,2363,2334,2359,2348,-3,-14,113032,2654428700,388474
1887,m1609,20151207,2359,2348,2352,2390,2351,2384,2372,36,24,89092,2114028540,386066
1888,m1609,20151208,2384,2372,2383,2383,2304,2331,2336,-41,-36,129778,3031676480,404070
1889,m1609,20151209,2331,2336,2334,2337,2310,2321,2322,-15,-14,82154,1908100000,414792
1890,m1609,20151210,2321,2322,2323,2335,2302,2310,2317,-12,-5,89078,2064230340,431940
1891,m1609,20151211,2310,2317,2310,2350,2307,2348,2328,31,11,113946,2652946300,440884
1892,m1609,20151214,2348,2328,2346,2364,2325,2362,2348,34,20,216646,5087173020,472824
1893,m1609,20151215,2362,2348,2350,2390,2341,2355,2366,7,18,315444,7463607340,483092
1894,m1609,20151216,2355,2366,2356,2370,2340,2363,2357,-3,-9,151364,3569031420,498744
1895,m1609,20151217,2363,2357,2357,2374,2322,2326,2345,-31,-12,192228,4508917240,513774
1896,m1609,20151218,2326,2345,2326,2375,2320,2371,2352,26,7,199660,4697067980,531330
1897,m1609,20151221,2371,2352,2380,2420,2371,2418,2392,66,40,207840,4973488200,521924
1898,m1609,20151222,2418,2392,2419,2423,2398,2405,2412,13,20,249154,6010399920,543796
1899,m1609,20151223,2405,2412,2405,2415,2390,2397,2400,-15,-12,174778,4196002000,560740
1900,m1609,20151224,2397,2400,2396,2403,2375,2384,2388,-16,-12,172214,4113314120,570926
1901,m1609,20151225,2384,2388,2380,2391,2363,2366,2376,-22,-12,119214,2833267500,577496
1902,m1609,20151228,2366,2376,2365,2372,2338,2345,2353,-31,-23,140356,3302979360,590194
1903,m1609,20151229,2345,2353,2346,2371,2341,2370,2358,17,5,181058,4271010080,616022
1904,m1609,20151230,2370,2358,2369,2381,2358,2369,2369,11,11,280056,6637205920,657380
1905,m1609,20151231,2369,2369,2365,2381,2361,2379,2370,10,1,157718,3739091040,644876
1906,m1611,20151116,2434,2434,0,0,0,2434,2434,0,0,0,0,0
1907,m1611,20151117,2434,2434,0,0,0,2429,2429,-5,-5,0,0,0
1908,m1611,20151118,2429,2429,0,0,0,2429,2429,0,0,0,0,0
1909,m1611,20151119,2429,2429,2370,2450,2365,2365,2393,-64,-36,16,382900,2
1910,m1611,20151120,2365,2393,2391,2391,2312,2371,2365,-22,-28,8,189260,6
1911,m1611,20151123,2371,2365,2346,2346,2278,2278,2312,-87,-53,4,92480,10
1912,m1611,20151124,2278,2312,2323,2323,2312,2312,2317,0,5,4,92700,12
1913,m1611,20151125,2312,2317,2334,2348,2334,2348,2344,31,27,28,656340,34
1914,m1611,20151126,2348,2344,2390,2403,2380,2397,2393,53,49,10,239340,34
1915,m1611,20151127,2397,2393,2360,2393,2360,2380,2375,-13,-18,12,285100,30
1916,m1611,20151130,2380,2375,2366,2367,2366,2367,2366,-8,-9,4,94660,32
1917,m1611,20151201,2367,2366,2365,2404,2365,2368,2379,2,13,6,142740,32
1918,m1611,20151202,2368,2379,2377,2402,2377,2401,2394,22,15,20,478920,44
1919,m1611,20151203,2401,2394,2375,2380,2375,2380,2377,-14,-17,4,95100,46
1920,m1611,20151204,2380,2377,2302,2375,2302,2372,2352,-5,-25,50,1176180,44
1921,m1611,20151207,2372,2352,2378,2410,2378,2391,2388,39,36,18,430000,46
1922,m1611,20151208,2391,2388,2389,2453,2330,2347,2357,-41,-31,90,2122180,72
1923,m1611,20151209,2347,2357,2346,2355,2335,2337,2344,-20,-13,34,796980,70
1924,m1611,20151210,2337,2344,2345,2345,2333,2333,2343,-11,-1,12,281160,62
1925,m1611,20151211,2333,2343,2336,2365,2332,2364,2338,21,-5,158,3695480,162
1926,m1611,20151214,2364,2338,2365,2371,2351,2371,2363,33,25,38,898120,170
1927,m1611,20151215,2371,2363,2393,2393,2368,2368,2386,5,23,30,715900,142
1928,m1611,20151216,2368,2386,2370,2384,2362,2384,2373,-2,-13,16,379760,146
1929,m1611,20151217,2384,2373,0,0,0,2349,2349,-24,-24,0,0,146
1930,m1611,20151218,2349,2349,0,0,0,2375,2375,26,26,0,0,146
1931,m1611,20151221,2375,2375,2405,2465,2391,2465,2408,90,33,24,578100,146
1932,m1611,20151222,2465,2408,2422,2440,2410,2410,2421,2,13,56,1355880,166
1933,m1611,20151223,2410,2421,2416,2418,2404,2411,2410,-10,-11,34,819600,164
1934,m1611,20151224,2411,2410,2411,2411,2390,2398,2402,-12,-8,18,432400,166
1935,m1611,20151225,2398,2402,2396,2399,2376,2383,2387,-19,-15,14,334240,166
1936,m1611,20151228,2383,2387,2385,2385,2358,2358,2367,-29,-20,6,142040,170
1937,m1611,20151229,2358,2367,2365,2399,2357,2382,2379,15,12,62,1475520,174
1938,m1611,20151230,2382,2379,2393,2395,2380,2387,2386,8,7,34,811520,172
1939,m1611,20151231,2387,2386,0,0,0,2386,2386,0,0,0,0,172
1940,m1612,20151215,2328,2328,0,0,0,2328,2328,0,0,0,0,0
1941,m1612,20151216,2328,2328,0,0,0,2343,2343,15,15,0,0,0
1942,m1612,20151217,2343,2343,0,0,0,2343,2343,0,0,0,0,0
1943,m1612,20151218,2343,2343,0,0,0,2343,2343,0,0,0,0,0
1944,m1612,20151221,2343,2343,0,0,0,2370,2370,27,27,0,0,0
1945,m1612,20151222,2370,2370,0,0,0,2394,2394,24,24,0,0,0
1946,m1612,20151223,2394,2394,0,0,0,2394,2394,0,0,0,0,0
1947,m1612,20151224,2394,2394,0,0,0,2394,2394,0,0,0,0,0
1948,m1612,20151225,2394,2394,0,0,0,2394,2394,0,0,0,0,0
1949,m1612,20151228,2394,2394,0,0,0,2394,2394,0,0,0,0,0
1950,m1612,20151229,2394,2394,2347,2399,2347,2395,2371,1,-23,20,474320,2
1951,m1612,20151230,2395,2371,2370,2370,2370,2370,2370,-1,-1,2,47400,0
1952,m1612,20151231,2370,2370,2405,2405,2405,2405,2405,35,35,2,48100,2
