1,jd1501,20150105,4690,4492,4700,4700,4580,4580,4640,88,148,112,5197640,36
2,jd1501,20150106,4580,4640,4918,4918,4363,4686,4649,46,9,32,1487840,20
3,jd1501,20150107,4686,4649,4690,4690,4690,4690,4690,41,41,2,93800,18
4,jd1501,20150108,4690,4690,4581,4587,4581,4587,4586,-103,-104,12,550320,6
5,jd1501,20150109,4587,4586,4587,4587,4587,4587,4587,1,1,2,91740,4
6,jd1501,20150112,4587,4587,0,0,0,4587,4587,0,0,0,0,4
7,jd1501,20150113,4587,4587,4312,4312,4312,4312,4312,-275,-275,2,86240,4
8,jd1501,20150114,4312,4312,0,0,0,4312,4312,0,0,0,0,4
9,jd1501,20150115,4312,4312,0,0,0,4312,4312,0,0,0,0,4
10,jd1501,20150116,4312,4312,4430,4430,4430,4430,4631,118,319,2,88600,0
11,jd1502,20150105,4467,4467,0,0,0,4467,4467,0,0,0,0,62
12,jd1502,20150106,4467,4467,0,0,0,4467,4467,0,0,0,0,62
13,jd1502,20150107,4467,4467,4252,4545,4252,4545,4398,78,-69,4,175940,62
14,jd1502,20150108,4545,4398,4398,4398,4398,4398,4398,0,0,2,87960,60
15,jd1502,20150109,4398,4398,4500,4500,4500,4500,4500,102,102,12,540000,58
16,jd1502,20150112,4500,4500,0,0,0,4500,4500,0,0,0,0,58
17,jd1502,20150113,4500,4500,4500,4500,4500,4500,4500,0,0,6,270000,58
18,jd1502,20150114,4500,4500,4500,4533,4500,4533,4512,33,12,16,722000,48
19,jd1502,20150115,4533,4512,4484,4484,4484,4484,4484,-28,-28,2,89680,48
20,jd1502,20150116,4484,4484,4510,4510,4510,4510,4510,26,26,2,90200,46
21,jd1502,20150119,4510,4510,4498,4498,4498,4498,4498,-12,-12,2,89960,44
22,jd1502,20150120,4498,4498,4497,4500,4486,4486,4492,-12,-6,16,718800,28
23,jd1502,20150121,4486,4492,0,0,0,4492,4492,0,0,0,0,28
24,jd1502,20150122,4492,4492,0,0,0,4492,4492,0,0,0,0,28
25,jd1502,20150123,4492,4492,4506,4506,4503,4503,4505,11,13,14,630780,26
26,jd1502,20150126,4503,4505,4500,4596,4500,4586,4567,81,62,10,456720,20
27,jd1502,20150127,4586,4567,4500,4500,4500,4500,4500,-67,-67,4,180000,16
28,jd1502,20150128,4500,4500,4500,4500,4500,4500,4500,0,0,4,180000,12
29,jd1502,20150129,4500,4500,4480,4717,4300,4300,4518,-200,18,68,3072280,0
30,jd1502,20150130,4300,4518,0,0,0,4518,4518,0,0,0,0,0
31,jd1502,20150202,4518,4518,0,0,0,4518,4518,0,0,0,0,0
32,jd1502,20150203,4518,4518,0,0,0,4518,4518,0,0,0,0,0
33,jd1502,20150204,4518,4518,0,0,0,4518,4518,0,0,0,0,0
34,jd1502,20150205,4518,4518,0,0,0,4518,4518,0,0,0,0,0
35,jd1502,20150206,4518,4518,0,0,0,4518,4518,0,0,0,0,0
36,jd1502,20150209,4518,4518,0,0,0,4518,4518,0,0,0,0,0
37,jd1502,20150210,4518,4518,0,0,0,4518,4518,0,0,0,0,0
38,jd1502,20150211,4518,4518,0,0,0,4518,4518,0,0,0,0,0
39,jd1502,20150212,4518,4518,0,0,0,4518,4518,0,0,0,0,0
40,jd1502,20150213,4518,4518,0,0,0,4518,4518,0,0,0,0,0
41,jd1503,20150105,4196,4203,4196,4220,4196,4208,4207,5,4,80,3366100,518
42,jd1503,20150106,4208,4207,4201,4213,4183,4194,4198,-13,-9,80,3359100,474
43,jd1503,20150107,4194,4198,4171,4197,4059,4163,4152,-35,-46,84,3488360,472
44,jd1503,20150108,4163,4152,4190,4190,4175,4175,4184,23,32,6,251080,472
45,jd1503,20150109,4175,4184,4184,4200,4167,4200,4179,16,-5,42,1755340,484
46,jd1503,20150112,4200,4179,4181,4227,4165,4200,4189,21,10,50,2094800,472
47,jd1503,20150113,4200,4189,4150,4197,4141,4178,4164,-11,-25,32,1332520,458
48,jd1503,20150114,4178,4164,4270,4270,4152,4185,4181,21,17,186,7777700,356
49,jd1503,20150115,4185,4181,4195,4205,4195,4205,4200,24,19,26,1092180,344
50,jd1503,20150116,4205,4200,4195,4218,4195,4218,4206,18,6,12,504820,336
51,jd1503,20150119,4218,4206,4183,4221,4183,4217,4209,11,3,30,1262700,330
52,jd1503,20150120,4217,4209,4202,4202,4200,4200,4201,-9,-8,6,252080,324
53,jd1503,20150121,4200,4201,4240,4265,4192,4192,4219,-9,18,28,1181560,322
54,jd1503,20150122,4192,4219,4155,4260,4153,4238,4229,19,10,94,3976020,298
55,jd1503,20150123,4238,4229,4227,4231,4212,4212,4220,-17,-9,12,506480,294
56,jd1503,20150126,4212,4220,4247,4247,4228,4228,4238,8,18,6,254280,296
57,jd1503,20150127,4228,4238,4313,4313,4211,4222,4249,-16,11,22,934980,288
58,jd1503,20150128,4222,4249,4219,4246,4206,4246,4225,-3,-24,18,760600,288
59,jd1503,20150129,4246,4225,4207,4219,4206,4206,4213,-19,-12,12,505560,280
60,jd1503,20150130,4206,4213,4166,4199,4166,4180,4181,-33,-32,6,250900,280
61,jd1503,20150202,4180,4181,0,0,0,4188,4188,7,7,0,0,280
62,jd1503,20150203,4188,4188,4200,4233,4200,4233,4216,45,28,4,168660,278
63,jd1503,20150204,4233,4216,4240,4253,4151,4201,4216,-15,0,38,1602400,264
64,jd1503,20150205,4201,4216,0,0,0,4216,4216,0,0,0,0,264
65,jd1503,20150206,4216,4216,0,0,0,4216,4216,0,0,0,0,264
66,jd1503,20150209,4216,4216,4229,4236,4228,4236,4233,20,17,14,592620,260
67,jd1503,20150210,4236,4233,4221,4244,4210,4210,4232,-23,-1,14,592520,250
68,jd1503,20150211,4210,4232,4182,4223,4182,4186,4202,-46,-30,12,504300,248
69,jd1503,20150212,4186,4202,4229,4240,4184,4209,4227,7,25,132,5580560,130
70,jd1503,20150213,4209,4227,4201,4201,4201,4201,4201,-26,-26,12,504120,122
71,jd1503,20150216,4201,4201,0,0,0,4201,4201,0,0,0,0,122
72,jd1503,20150217,4201,4201,4208,4210,4198,4210,4204,9,3,20,840900,110
73,jd1503,20150225,4210,4204,4199,4296,4187,4187,4220,-17,16,68,2869760,88
74,jd1503,20150226,4187,4220,4151,4224,4151,4224,4187,4,-33,38,1591280,56
75,jd1503,20150227,4224,4187,4266,4266,3980,4100,4192,-87,5,56,2348000,18
76,jd1503,20150302,4100,4192,4023,4200,4023,4200,4090,8,-102,16,654460,4
77,jd1503,20150303,4200,4090,0,0,0,4090,4090,0,0,0,0,4
78,jd1503,20150304,4090,4090,0,0,0,4090,4090,0,0,0,0,4
79,jd1503,20150305,4090,4090,0,0,0,4090,4090,0,0,0,0,4
80,jd1503,20150306,4090,4090,0,0,0,4090,4090,0,0,0,0,4
81,jd1503,20150309,4090,4090,0,0,0,4090,4090,0,0,0,0,4
82,jd1503,20150310,4090,4090,0,0,0,4090,4090,0,0,0,0,4
83,jd1503,20150311,4090,4090,0,0,0,3845,3845,-245,-245,0,0,4
84,jd1503,20150312,3845,3845,3615,3615,3615,3615,3615,-230,-230,2,72300,4
85,jd1503,20150313,3615,3615,3327,3327,3326,3326,3908,-289,293,4,133060,0
86,jd1504,20150105,4189,4167,0,0,0,4171,4171,4,4,0,0,32
87,jd1504,20150106,4171,4171,0,0,0,4171,4171,0,0,0,0,32
88,jd1504,20150107,4171,4171,4155,4155,4148,4148,4151,-23,-20,4,166060,30
89,jd1504,20150108,4148,4151,0,0,0,4155,4155,4,4,0,0,30
90,jd1504,20150109,4155,4155,0,0,0,4155,4155,0,0,0,0,30
91,jd1504,20150112,4155,4155,4204,4209,4156,4207,4186,52,31,20,837320,36
92,jd1504,20150113,4207,4186,4178,4180,4175,4175,4177,-11,-9,10,417740,30
93,jd1504,20150114,4175,4177,4169,4169,4109,4109,4138,-68,-39,6,248300,28
94,jd1504,20150115,4109,4138,4145,4145,4145,4145,4145,7,7,6,248700,22
95,jd1504,20150116,4145,4145,0,0,0,4145,4145,0,0,0,0,22
96,jd1504,20150119,4145,4145,4215,4215,4215,4215,4215,70,70,2,84300,22
97,jd1504,20150120,4215,4215,0,0,0,4215,4215,0,0,0,0,22
98,jd1504,20150121,4215,4215,4204,4204,4204,4204,4204,-11,-11,2,84080,20
99,jd1504,20150122,4204,4204,4121,4121,4121,4121,4121,-83,-83,2,82420,20
100,jd1504,20150123,4121,4121,0,0,0,4121,4121,0,0,0,0,20
101,jd1504,20150126,4121,4121,0,0,0,4121,4121,0,0,0,0,20
102,jd1504,20150127,4121,4121,0,0,0,4121,4121,0,0,0,0,20
103,jd1504,20150128,4121,4121,0,0,0,4121,4121,0,0,0,0,20
104,jd1504,20150129,4121,4121,0,0,0,4121,4121,0,0,0,0,20
105,jd1504,20150130,4121,4121,0,0,0,4150,4150,29,29,0,0,20
106,jd1504,20150202,4150,4150,0,0,0,4150,4150,0,0,0,0,20
107,jd1504,20150203,4150,4150,0,0,0,4150,4150,0,0,0,0,20
108,jd1504,20150204,4150,4150,4229,4229,4229,4229,4229,79,79,2,84580,20
109,jd1504,20150205,4229,4229,4200,4220,4121,4220,4190,-9,-39,42,1760120,16
110,jd1504,20150206,4220,4190,4168,4168,4163,4163,4165,-27,-25,4,166620,16
111,jd1504,20150209,4163,4165,4217,4217,4159,4214,4203,49,38,10,420360,18
112,jd1504,20150210,4214,4203,0,0,0,4203,4203,0,0,0,0,18
113,jd1504,20150211,4203,4203,4147,4147,4147,4147,4147,-56,-56,6,248820,18
114,jd1504,20150212,4147,4147,0,0,0,4147,4147,0,0,0,0,18
115,jd1504,20150213,4147,4147,0,0,0,4147,4147,0,0,0,0,18
116,jd1504,20150216,4147,4147,0,0,0,4147,4147,0,0,0,0,18
117,jd1504,20150217,4147,4147,4100,4180,4100,4180,4140,33,-7,4,165600,16
118,jd1504,20150225,4180,4140,0,0,0,4180,4180,40,40,0,0,16
119,jd1504,20150226,4180,4180,4147,4147,4147,4147,4147,-33,-33,4,165880,18
120,jd1504,20150227,4147,4147,4299,4299,4180,4289,4240,142,93,18,763260,14
121,jd1504,20150302,4289,4240,4120,4270,4120,4270,4182,30,-58,6,250960,12
122,jd1504,20150303,4270,4182,0,0,0,4182,4182,0,0,0,0,12
123,jd1504,20150304,4182,4182,0,0,0,4182,4182,0,0,0,0,12
124,jd1504,20150305,4182,4182,0,0,0,4182,4182,0,0,0,0,12
125,jd1504,20150306,4182,4182,4250,4250,4136,4136,4205,-46,23,10,420520,6
126,jd1504,20150309,4136,4205,0,0,0,4171,4171,-34,-34,0,0,6
127,jd1504,20150310,4171,4171,0,0,0,4171,4171,0,0,0,0,6
128,jd1504,20150311,4171,4171,0,0,0,4171,4171,0,0,0,0,6
129,jd1504,20150312,4171,4171,4100,4100,4060,4060,4080,-111,-91,4,163200,6
130,jd1504,20150313,4060,4080,4260,4260,3940,3993,4093,-87,13,28,1146200,12
131,jd1504,20150316,3993,4093,0,0,0,4045,4045,-48,-48,0,0,12
132,jd1504,20150317,4045,4045,0,0,0,4045,4045,0,0,0,0,12
133,jd1504,20150318,4045,4045,0,0,0,4045,4045,0,0,0,0,12
134,jd1504,20150319,4045,4045,3843,3931,3843,3871,3866,-174,-179,10,386620,10
135,jd1504,20150320,3871,3866,3750,3750,3750,3750,3750,-116,-116,4,150000,10
136,jd1504,20150323,3750,3750,0,0,0,3750,3750,0,0,0,0,10
137,jd1504,20150324,3750,3750,3900,3900,3900,3900,3900,150,150,2,78000,10
138,jd1504,20150325,3900,3900,0,0,0,3876,3876,-24,-24,0,0,10
139,jd1504,20150326,3876,3876,3788,3788,3788,3788,3788,-88,-88,2,75760,12
140,jd1504,20150327,3788,3788,0,0,0,3788,3788,0,0,0,0,12
141,jd1504,20150330,3788,3788,3670,3888,3670,3888,3756,100,-32,6,225380,8
142,jd1504,20150331,3888,3756,3937,3937,3600,3600,3709,-156,-47,8,296740,6
143,jd1504,20150401,3600,3709,3488,3488,3487,3487,3487,-222,-222,6,209240,0
144,jd1504,20150402,3487,3487,0,0,0,3487,3487,0,0,0,0,0
145,jd1504,20150403,3487,3487,0,0,0,3487,3487,0,0,0,0,0
146,jd1504,20150407,3487,3487,0,0,0,3487,3487,0,0,0,0,0
147,jd1504,20150408,3487,3487,0,0,0,3487,3487,0,0,0,0,0
148,jd1504,20150409,3487,3487,0,0,0,3487,3487,0,0,0,0,0
149,jd1504,20150410,3487,3487,0,0,0,3487,3487,0,0,0,0,0
150,jd1504,20150413,3487,3487,0,0,0,3487,3487,0,0,0,0,0
151,jd1504,20150414,3487,3487,0,0,0,3487,3487,0,0,0,0,0
152,jd1504,20150415,3487,3487,0,0,0,3487,3487,0,0,0,0,0
153,jd1505,20150105,4268,4302,4255,4309,4255,4290,4284,-12,-18,142820,6119095180,135654
154,jd1505,20150106,4290,4284,4306,4321,4261,4276,4285,-8,1,136410,5846437760,138582
155,jd1505,20150107,4276,4285,4275,4296,4229,4285,4265,0,-20,192750,8221632680,137774
156,jd1505,20150108,4285,4265,4293,4300,4268,4273,4280,8,15,80840,3460405800,136002
157,jd1505,20150109,4273,4280,4268,4293,4250,4258,4272,-22,-8,121418,5187114760,135114
158,jd1505,20150112,4258,4272,4280,4305,4262,4268,4279,-4,7,103344,4422944860,133178
159,jd1505,20150113,4268,4279,4255,4260,4183,4188,4218,-91,-61,145442,6135795100,147428
160,jd1505,20150114,4188,4218,4176,4190,4102,4125,4139,-93,-79,152262,6302124260,146908
161,jd1505,20150115,4125,4139,4136,4162,4132,4143,4148,4,9,79456,3296497960,142486
162,jd1505,20150116,4143,4148,4148,4174,4120,4151,4146,3,-2,99068,4107723740,141642
163,jd1505,20150119,4151,4146,4140,4204,4121,4167,4166,21,20,137890,5745526700,133328
164,jd1505,20150120,4167,4166,4160,4186,4132,4154,4156,-12,-10,88422,3675009180,133962
165,jd1505,20150121,4154,4156,4156,4184,4050,4090,4146,-66,-10,121804,5051180060,145174
166,jd1505,20150122,4090,4146,4100,4123,4067,4113,4097,-33,-49,158866,6509336140,147590
167,jd1505,20150123,4113,4097,4113,4128,4090,4120,4110,23,13,99200,4077523660,142116
168,jd1505,20150126,4120,4110,4110,4182,4085,4179,4127,69,17,143166,5908551660,135874
169,jd1505,20150127,4179,4127,4188,4235,4156,4166,4194,39,67,203140,8520103880,127688
170,jd1505,20150128,4166,4194,4145,4195,4145,4186,4173,-8,-21,88976,3713534560,127006
171,jd1505,20150129,4186,4173,4183,4188,4112,4119,4139,-54,-34,115422,4777989720,132448
172,jd1505,20150130,4119,4139,4113,4135,4094,4120,4118,-19,-21,105612,4349206720,127890
173,jd1505,20150202,4120,4118,4119,4145,4082,4089,4114,-29,-4,92218,3794390280,134986
174,jd1505,20150203,4089,4114,4090,4160,4082,4159,4124,45,10,123966,5113593180,124320
175,jd1505,20150204,4159,4124,4160,4186,4132,4144,4159,20,35,100748,4190937320,118496
176,jd1505,20150205,4144,4159,4140,4196,4138,4173,4173,14,14,145730,6082508180,122888
177,jd1505,20150206,4173,4173,4194,4196,4153,4168,4169,-5,-4,89594,3735564540,122372
178,jd1505,20150209,4168,4169,4224,4230,4156,4166,4184,-3,15,100888,4221612080,123090
179,jd1505,20150210,4166,4184,4162,4184,4151,4159,4167,-25,-17,83500,3479777900,122688
180,jd1505,20150211,4159,4167,4156,4160,4111,4118,4131,-49,-36,86632,3578981820,125982
181,jd1505,20150212,4118,4131,4115,4134,4090,4091,4110,-40,-21,84406,3469215000,130326
182,jd1505,20150213,4091,4110,4088,4131,4073,4113,4113,3,3,100710,4142504880,117794
183,jd1505,20150216,4113,4113,4110,4138,4104,4113,4119,0,6,64922,2674442840,113452
184,jd1505,20150217,4113,4119,4114,4128,4083,4106,4105,-13,-14,72678,2983800580,111314
185,jd1505,20150225,4106,4105,4085,4202,4051,4197,4157,92,52,157912,6565611100,114310
186,jd1505,20150226,4197,4157,4205,4215,4170,4187,4188,30,31,90732,3800441220,117856
187,jd1505,20150227,4187,4188,4185,4279,4183,4272,4243,84,55,187854,7971586140,121512
188,jd1505,20150302,4272,4243,4270,4308,4255,4304,4287,61,44,95190,4081018540,122800
189,jd1505,20150303,4304,4287,4299,4299,4251,4283,4275,-4,-12,89302,3817842600,119120
190,jd1505,20150304,4283,4275,4280,4332,4240,4249,4281,-26,6,188576,8073157980,114392
191,jd1505,20150305,4249,4281,4236,4243,4208,4228,4225,-53,-56,69958,2956233860,104564
192,jd1505,20150306,4228,4225,4234,4257,4136,4142,4192,-83,-33,118708,4976907140,87374
193,jd1505,20150309,4142,4192,4107,4146,4096,4115,4122,-77,-70,76946,3171760680,85808
194,jd1505,20150310,4115,4122,4120,4140,4106,4120,4122,-2,0,51584,2126375480,84924
195,jd1505,20150311,4120,4122,4120,4151,4106,4139,4135,17,13,60554,2503913280,87328
196,jd1505,20150312,4139,4135,4158,4181,4120,4134,4153,-1,18,90126,3743682820,86266
197,jd1505,20150313,4134,4153,4129,4147,4092,4122,4115,-31,-38,79284,3262755960,82858
198,jd1505,20150316,4122,4115,4133,4165,4120,4159,4145,44,30,60336,2501008060,76708
199,jd1505,20150317,4159,4145,4151,4168,4132,4150,4145,5,0,39066,1619526300,72434
200,jd1505,20150318,4150,4145,4150,4156,4114,4148,4135,3,-10,46284,1914214700,69864
201,jd1505,20150319,4148,4135,4150,4198,4121,4122,4151,-13,16,70052,2908311120,71498
202,jd1505,20150320,4122,4151,4122,4135,4107,4127,4120,-24,-31,47388,1952802460,68010
203,jd1505,20150323,4127,4120,4133,4145,4110,4136,4130,16,10,48756,2014025560,67564
204,jd1505,20150324,4136,4130,4137,4163,4115,4120,4137,-10,7,58526,2421447620,66350
205,jd1505,20150325,4120,4137,4112,4115,3931,3931,3991,-206,-146,206936,8260846400,99364
206,jd1505,20150326,3931,3991,3920,3944,3870,3887,3904,-104,-87,133728,5221665580,99278
207,jd1505,20150327,3887,3904,3883,3917,3876,3884,3895,-20,-9,61810,2408066820,93598
208,jd1505,20150330,3884,3895,3883,3927,3882,3915,3909,20,14,65750,2570359020,82088
209,jd1505,20150331,3915,3909,3930,3949,3884,3946,3918,37,9,57544,2254973660,68082
210,jd1505,20150401,3946,3918,3948,3973,3901,3906,3936,-12,18,53200,2094448160,55136
211,jd1505,20150402,3906,3936,3920,3924,3799,3814,3832,-122,-104,61598,2360985500,48902
212,jd1505,20150403,3814,3832,3802,3860,3800,3811,3831,-21,-1,31820,1219198460,43740
213,jd1505,20150407,3811,3831,3761,3776,3650,3652,3694,-179,-137,39230,1449163160,42984
214,jd1505,20150408,3652,3694,3641,3677,3632,3675,3656,-19,-38,23798,870115560,39890
215,jd1505,20150409,3675,3656,3673,3699,3653,3691,3677,35,21,19532,718371480,35758
216,jd1505,20150410,3691,3677,3705,3788,3688,3763,3735,86,58,29356,1096518780,29688
217,jd1505,20150413,3763,3735,3760,3798,3738,3777,3762,42,27,12206,459191040,26816
218,jd1505,20150414,3777,3762,3777,3815,3752,3797,3796,35,34,14670,556909620,23192
219,jd1505,20150415,3797,3796,3859,3859,3607,3796,3778,0,-18,16146,610091500,17752
220,jd1505,20150416,3796,3778,3780,3828,3773,3800,3805,22,27,8524,324423160,15390
221,jd1505,20150417,3800,3805,3810,3840,3789,3831,3817,26,12,5912,225709820,13616
222,jd1505,20150420,3831,3817,3850,3913,3835,3847,3858,30,41,4392,169468460,12440
223,jd1505,20150421,3847,3858,3833,3860,3815,3837,3838,-21,-20,3536,135734960,11324
224,jd1505,20150422,3837,3838,3825,3852,3817,3835,3831,-3,-7,3260,124913940,10290
225,jd1505,20150423,3835,3831,3825,3849,3819,3834,3830,3,-1,3108,119066100,9486
226,jd1505,20150424,3834,3830,3834,3854,3826,3845,3838,15,8,2614,100327280,8074
227,jd1505,20150427,3845,3838,3838,3838,3789,3793,3803,-45,-35,2482,94393300,7272
228,jd1505,20150428,3793,3803,3790,3825,3780,3798,3804,-5,1,2596,98771640,5854
229,jd1505,20150429,3798,3804,3788,3799,3770,3771,3778,-33,-26,2184,82531500,4356
230,jd1505,20150430,3771,3778,3780,3780,3601,3647,3732,-131,-46,5358,199986000,342
231,jd1505,20150504,3647,3732,3700,3700,3509,3509,3594,-223,-138,218,7836700,150
232,jd1505,20150505,3509,3594,3380,3569,3379,3381,3394,-213,-200,130,4413320,78
233,jd1505,20150506,3381,3394,3480,3480,3480,3480,3480,86,86,4,139200,74
234,jd1505,20150507,3480,3480,0,0,0,3480,3480,0,0,0,0,74
235,jd1505,20150508,3480,3480,3381,3381,3381,3381,3381,-99,-99,22,743820,52
236,jd1505,20150511,3381,3381,0,0,0,3381,3381,0,0,0,0,52
237,jd1505,20150512,3381,3381,3280,3480,3280,3480,3346,99,-35,12,401600,44
238,jd1505,20150513,3480,3346,3181,3181,3181,3181,3181,-165,-165,2,63620,42
239,jd1505,20150514,3181,3181,3000,3200,2991,3000,3047,-181,-134,8,243820,42
240,jd1505,20150515,3000,3047,2865,2865,2865,2865,3492,-182,445,2,57300,0
241,jd1506,20150105,4260,4268,4265,4300,4265,4300,4277,32,9,6,256640,52
242,jd1506,20150106,4300,4277,4273,4273,4252,4267,4264,-10,-13,6,255840,52
243,jd1506,20150107,4267,4264,0,0,0,4264,4264,0,0,0,0,52
244,jd1506,20150108,4264,4264,0,0,0,4264,4264,0,0,0,0,52
245,jd1506,20150109,4264,4264,0,0,0,4264,4264,0,0,0,0,52
246,jd1506,20150112,4264,4264,4237,4300,4237,4244,4270,-20,6,12,512420,48
247,jd1506,20150113,4244,4270,4240,4240,4201,4219,4216,-51,-54,10,421600,46
248,jd1506,20150114,4219,4216,4160,4160,4160,4160,4160,-56,-56,2,83200,44
249,jd1506,20150115,4160,4160,4212,4213,4150,4150,4177,-10,17,34,1420320,50
250,jd1506,20150116,4150,4177,4116,4155,4116,4155,4131,-22,-46,14,578460,38
251,jd1506,20150119,4155,4131,4110,4208,4110,4150,4165,19,34,8,333200,38
252,jd1506,20150120,4150,4165,0,0,0,4165,4165,0,0,0,0,38
253,jd1506,20150121,4165,4165,4157,4157,4115,4121,4131,-44,-34,6,247860,36
254,jd1506,20150122,4121,4131,4142,4153,4090,4153,4116,22,-15,14,576360,38
255,jd1506,20150123,4153,4116,4157,4157,4157,4157,4157,41,41,12,498840,46
256,jd1506,20150126,4157,4157,4155,4161,4155,4161,4158,4,1,8,332640,50
257,jd1506,20150127,4161,4158,4224,4234,4224,4234,4226,76,68,22,929880,52
258,jd1506,20150128,4234,4226,4176,4176,4176,4176,4176,-50,-50,2,83520,50
259,jd1506,20150129,4176,4176,4154,4177,4121,4174,4157,-2,-19,30,1247300,50
260,jd1506,20150130,4174,4157,4160,4200,4160,4200,4177,43,20,14,584820,50
261,jd1506,20150202,4200,4177,0,0,0,4177,4177,0,0,0,0,50
262,jd1506,20150203,4177,4177,0,0,0,4177,4177,0,0,0,0,50
263,jd1506,20150204,4177,4177,4158,4225,4158,4225,4191,48,14,4,167660,50
264,jd1506,20150205,4225,4191,0,0,0,4191,4191,0,0,0,0,50
265,jd1506,20150206,4191,4191,4264,4267,4207,4267,4247,76,56,8,339760,54
266,jd1506,20150209,4267,4247,4231,4250,4230,4250,4240,3,-7,8,339220,54
267,jd1506,20150210,4250,4240,0,0,0,4229,4229,-11,-11,0,0,54
268,jd1506,20150211,4229,4229,4216,4216,4200,4200,4208,-29,-21,4,168320,58
269,jd1506,20150212,4200,4208,4218,4255,4173,4173,4201,-35,-7,26,1092300,64
270,jd1506,20150213,4173,4201,0,0,0,4201,4201,0,0,0,0,64
271,jd1506,20150216,4201,4201,4174,4174,4174,4174,4174,-27,-27,2,83480,64
272,jd1506,20150217,4174,4174,4252,4252,4175,4215,4204,41,30,8,336340,62
273,jd1506,20150225,4215,4204,4156,4269,4156,4269,4230,65,26,20,846180,64
274,jd1506,20150226,4269,4230,4274,4275,4270,4270,4274,40,44,34,1453300,84
275,jd1506,20150227,4270,4274,4300,4330,4300,4302,4304,28,30,18,774840,86
276,jd1506,20150302,4302,4304,4334,4350,4334,4345,4341,41,37,16,694560,86
277,jd1506,20150303,4345,4341,4344,4350,4344,4350,4349,9,8,12,521880,86
278,jd1506,20150304,4350,4349,0,0,0,4349,4349,0,0,0,0,86
279,jd1506,20150305,4349,4349,4329,4331,4274,4331,4323,-18,-26,24,1037660,106
280,jd1506,20150306,4331,4323,4301,4331,4301,4307,4314,-16,-9,12,517680,110
281,jd1506,20150309,4307,4314,4255,4289,4255,4289,4273,-25,-41,8,341840,114
282,jd1506,20150310,4289,4273,4291,4291,4291,4291,4291,18,18,2,85820,116
283,jd1506,20150311,4291,4291,0,0,0,4300,4300,9,9,0,0,116
284,jd1506,20150312,4300,4300,4348,4348,4315,4315,4328,15,28,16,692480,122
285,jd1506,20150313,4315,4328,4336,4336,4300,4300,4312,-28,-16,6,258720,124
286,jd1506,20150316,4300,4312,4310,4346,4300,4346,4319,34,7,46,1986820,138
287,jd1506,20150317,4346,4319,4344,4344,4268,4287,4308,-32,-11,36,1551120,146
288,jd1506,20150318,4287,4308,4281,4324,4280,4286,4294,-22,-14,14,601240,150
289,jd1506,20150319,4286,4294,4352,4352,4283,4297,4311,3,17,30,1293420,162
290,jd1506,20150320,4297,4311,4299,4299,4275,4291,4289,-20,-22,44,1887300,186
291,jd1506,20150323,4291,4289,4286,4305,4252,4300,4281,11,-8,82,3511140,214
292,jd1506,20150324,4300,4281,4289,4310,4255,4303,4281,22,0,78,3339540,222
293,jd1506,20150325,4303,4281,4260,4278,4155,4220,4223,-61,-58,100,4223340,238
294,jd1506,20150326,4220,4223,4187,4254,4187,4200,4208,-23,-15,42,1767360,240
295,jd1506,20150327,4200,4208,4212,4232,4205,4221,4219,13,11,40,1687920,246
296,jd1506,20150330,4221,4219,4228,4228,4219,4219,4224,0,5,6,253460,248
297,jd1506,20150331,4219,4224,4205,4216,4171,4215,4207,-9,-17,48,2019600,254
298,jd1506,20150401,4215,4207,4188,4201,4172,4191,4193,-16,-14,36,1509580,248
299,jd1506,20150402,4191,4193,4181,4181,4080,4130,4128,-63,-65,84,3468060,208
300,jd1506,20150403,4130,4128,4051,4051,4051,4051,4051,-77,-77,8,324080,208
301,jd1506,20150407,4051,4051,4058,4063,3933,3940,3972,-111,-79,146,5800340,220
302,jd1506,20150408,3940,3972,3940,3940,3902,3939,3918,-33,-54,30,1175420,220
303,jd1506,20150409,3939,3918,3933,3939,3918,3925,3925,7,7,22,863600,220
304,jd1506,20150410,3925,3925,3940,4010,3940,3970,3977,45,52,40,1590860,224
305,jd1506,20150413,3970,3977,3993,3993,3968,3968,3977,-9,0,22,875020,226
306,jd1506,20150414,3968,3977,3978,4008,3973,3982,3989,5,12,30,1196700,226
307,jd1506,20150415,3982,3989,3820,3985,3820,3950,3959,-39,-30,74,2929780,232
308,jd1506,20150416,3950,3959,3971,3984,3962,3979,3974,20,15,36,1430960,220
309,jd1506,20150417,3979,3974,3984,4010,3984,3997,3989,23,15,40,1595980,202
310,jd1506,20150420,3997,3989,4002,4002,4000,4000,4001,11,12,8,320100,202
311,jd1506,20150421,4000,4001,3995,4008,3995,4000,4000,-1,-1,8,320060,204
312,jd1506,20150422,4000,4000,3991,3991,3991,3991,3991,-9,-9,6,239460,208
313,jd1506,20150423,3991,3991,4006,4007,3977,4007,4001,16,10,12,480180,200
314,jd1506,20150424,4007,4001,4015,4016,4015,4016,4015,15,14,8,321240,208
315,jd1506,20150427,4016,4015,4008,4008,3981,4000,3992,-15,-23,8,319420,208
316,jd1506,20150428,4000,3992,3982,4049,3982,4006,4024,14,32,26,1046300,204
317,jd1506,20150429,4006,4024,4049,4050,4003,4006,4031,-18,7,22,886840,204
318,jd1506,20150430,4006,4031,3989,4045,3968,3983,4002,-48,-29,96,3842360,236
319,jd1506,20150504,3983,4002,3970,4016,3900,3910,3940,-92,-62,134,5280420,258
320,jd1506,20150505,3910,3940,3878,3928,3820,3909,3856,-31,-84,194,7482080,242
321,jd1506,20150506,3909,3856,3860,3923,3812,3856,3873,0,17,42,1626820,250
322,jd1506,20150507,3856,3873,3802,3884,3802,3884,3842,11,-31,48,1844400,232
323,jd1506,20150508,3884,3842,3843,3849,3811,3838,3831,-4,-11,68,2605240,196
324,jd1506,20150511,3838,3831,3799,3810,3740,3776,3779,-55,-52,46,1738720,194
325,jd1506,20150512,3776,3779,3780,3809,3743,3765,3768,-14,-11,56,2110260,194
326,jd1506,20150513,3765,3768,3702,3744,3617,3625,3695,-143,-73,68,2513060,192
327,jd1506,20150514,3625,3695,3649,3696,3649,3652,3661,-43,-34,60,2196780,198
328,jd1506,20150515,3652,3661,3786,3786,3658,3659,3683,-2,22,48,1767860,186
329,jd1506,20150518,3659,3683,3671,3721,3631,3688,3675,5,-8,132,4851800,202
330,jd1506,20150519,3688,3675,3638,3663,3620,3637,3629,-38,-46,70,2540600,230
331,jd1506,20150520,3637,3629,3525,3628,3525,3586,3597,-43,-32,46,1655040,220
332,jd1506,20150521,3586,3597,3599,3600,3529,3529,3566,-68,-31,60,2139880,210
333,jd1506,20150522,3529,3566,3466,3469,3394,3431,3423,-135,-143,104,3560040,172
334,jd1506,20150525,3431,3423,3423,3446,3332,3341,3371,-82,-52,86,2899140,170
335,jd1506,20150526,3341,3371,3370,3370,3260,3324,3296,-47,-75,46,1516380,174
336,jd1506,20150527,3324,3296,3272,3325,3272,3308,3301,12,5,58,1915020,140
337,jd1506,20150528,3308,3301,3338,3348,3281,3311,3310,10,9,106,3509400,84
338,jd1506,20150529,3311,3310,3280,3280,3178,3178,3217,-132,-93,92,2959740,8
339,jd1506,20150601,3178,3217,3027,3027,3027,3027,3027,-190,-190,4,121080,6
340,jd1506,20150602,3027,3027,0,0,0,3027,3027,0,0,0,0,6
341,jd1506,20150603,3027,3027,3000,3000,3000,3000,3000,-27,-27,2,60000,4
342,jd1506,20150604,3000,3000,3179,3179,3179,3179,3179,179,179,2,63580,2
343,jd1506,20150605,3179,3179,0,0,0,3179,3179,0,0,0,0,2
344,jd1506,20150608,3179,3179,0,0,0,3179,3179,0,0,0,0,2
345,jd1506,20150609,3179,3179,3369,3369,3369,3369,3369,190,190,2,67380,0
346,jd1506,20150610,3369,3369,0,0,0,3369,3369,0,0,0,0,0
347,jd1506,20150611,3369,3369,0,0,0,3369,3369,0,0,0,0,0
348,jd1506,20150612,3369,3369,0,0,0,3120,3120,-249,-249,0,0,0
349,jd1509,20150105,4526,4539,4524,4549,4523,4544,4536,5,-3,7056,320068840,24062
350,jd1509,20150106,4544,4536,4554,4568,4522,4535,4538,-1,2,6636,301143640,24846
351,jd1509,20150107,4535,4538,4538,4606,4516,4605,4564,67,26,18718,854430840,27316
352,jd1509,20150108,4605,4564,4591,4603,4568,4579,4589,15,25,9942,456250320,29254
353,jd1509,20150109,4579,4589,4586,4613,4575,4594,4593,5,4,10250,470873640,31660
354,jd1509,20150112,4594,4593,4613,4656,4594,4628,4627,35,34,17022,787642340,36858
355,jd1509,20150113,4628,4627,4610,4619,4579,4580,4595,-47,-32,17612,809360440,36162
356,jd1509,20150114,4580,4595,4583,4590,4455,4480,4510,-115,-85,26514,1195835000,34560
357,jd1509,20150115,4480,4510,4500,4520,4482,4509,4503,-1,-7,8576,386225980,34564
358,jd1509,20150116,4509,4503,4508,4524,4455,4478,4484,-25,-19,20474,918137040,35982
359,jd1509,20150119,4478,4484,4497,4540,4466,4524,4507,40,23,18736,844520680,33848
360,jd1509,20150120,4524,4507,4515,4538,4507,4535,4523,28,16,9772,441999760,33104
361,jd1509,20150121,4535,4523,4549,4562,4490,4504,4530,-19,7,12826,581037100,32970
362,jd1509,20150122,4504,4530,4500,4515,4480,4510,4497,-20,-33,15188,683139940,34960
363,jd1509,20150123,4510,4497,4505,4517,4495,4513,4506,16,9,8910,401555360,36030
364,jd1509,20150126,4513,4506,4501,4624,4494,4622,4553,116,47,26322,1198470240,43930
365,jd1509,20150127,4622,4553,4620,4725,4613,4663,4663,110,110,37604,1753536220,47426
366,jd1509,20150128,4663,4663,4702,4702,4624,4645,4648,-18,-15,18884,877785880,49504
367,jd1509,20150129,4645,4648,4650,4650,4591,4605,4613,-43,-35,19306,890601820,51974
368,jd1509,20150130,4605,4613,4605,4648,4582,4634,4618,21,5,19966,922101860,54198
369,jd1509,20150202,4634,4618,4623,4647,4595,4596,4622,-22,4,13934,644098660,52442
370,jd1509,20150203,4596,4622,4598,4637,4590,4623,4622,1,0,16240,750701900,53588
371,jd1509,20150204,4623,4622,4650,4656,4621,4628,4636,6,14,11952,554206320,52040
372,jd1509,20150205,4628,4636,4630,4660,4600,4608,4629,-28,-7,17138,793489340,50966
373,jd1509,20150206,4608,4629,4618,4628,4586,4604,4603,-25,-26,17658,812855380,50650
374,jd1509,20150209,4604,4603,4618,4647,4541,4546,4575,-57,-28,30938,1415472840,46604
375,jd1509,20150210,4546,4575,4547,4552,4524,4549,4539,-26,-36,19016,863257680,47224
376,jd1509,20150211,4549,4539,4546,4561,4520,4539,4549,0,10,17336,788638840,46100
377,jd1509,20150212,4539,4549,4542,4550,4502,4510,4521,-39,-28,18502,836607120,46968
378,jd1509,20150213,4510,4521,4505,4540,4492,4519,4517,-2,-4,20460,924309240,44352
379,jd1509,20150216,4519,4517,4520,4536,4505,4515,4519,-2,2,11568,522850380,44728
380,jd1509,20150217,4515,4519,4505,4530,4505,4526,4518,7,-1,10568,477507220,43714
381,jd1509,20150225,4526,4518,4518,4599,4510,4589,4572,71,54,30000,1371759800,49134
382,jd1509,20150226,4589,4572,4600,4607,4571,4588,4583,16,11,23034,1055838860,52338
383,jd1509,20150227,4588,4583,4584,4649,4579,4649,4620,66,37,32874,1518908740,52726
384,jd1509,20150302,4649,4620,4640,4666,4626,4660,4649,40,29,19928,926505560,50990
385,jd1509,20150303,4660,4649,4646,4657,4621,4646,4640,-3,-9,19974,926811040,48614
386,jd1509,20150304,4646,4640,4630,4672,4630,4655,4653,15,13,27770,1292273860,50026
387,jd1509,20150305,4655,4653,4643,4645,4615,4636,4633,-17,-20,13924,645230040,48966
388,jd1509,20150306,4636,4633,4631,4664,4584,4596,4624,-37,-9,30112,1392400580,46986
389,jd1509,20150309,4596,4624,4585,4601,4566,4584,4583,-40,-41,21180,970866520,45822
390,jd1509,20150310,4584,4583,4589,4618,4577,4604,4599,21,16,17964,826242400,45864
391,jd1509,20150311,4604,4599,4602,4646,4596,4645,4629,46,30,25796,1194306140,49936
392,jd1509,20150312,4645,4629,4649,4697,4648,4668,4676,39,47,46144,2157982780,54292
393,jd1509,20150313,4668,4676,4668,4676,4606,4622,4635,-54,-41,32148,1490201060,50670
394,jd1509,20150316,4622,4635,4618,4690,4614,4684,4653,49,18,35178,1636971620,57348
395,jd1509,20150317,4684,4653,4688,4690,4653,4672,4668,19,15,23274,1086504320,57372
396,jd1509,20150318,4672,4668,4666,4675,4642,4664,4660,-4,-8,27774,1294480660,56194
397,jd1509,20150319,4664,4660,4676,4721,4653,4661,4686,1,26,63886,2993805760,61422
398,jd1509,20150320,4661,4686,4663,4677,4626,4652,4646,-34,-40,33632,1562743480,59230
399,jd1509,20150323,4652,4646,4660,4685,4632,4683,4661,37,15,44494,2074156260,67756
400,jd1509,20150324,4683,4661,4700,4710,4663,4664,4680,3,19,55142,2581107440,68750
401,jd1509,20150325,4664,4680,4660,4666,4509,4537,4576,-143,-104,159762,7311556260,69018
402,jd1509,20150326,4537,4576,4531,4580,4525,4555,4557,-21,-19,56700,2583869900,66982
403,jd1509,20150327,4555,4557,4558,4585,4551,4576,4571,19,14,41522,1898012560,67562
404,jd1509,20150330,4576,4571,4576,4598,4541,4551,4564,-20,-7,51336,2343183440,68722
405,jd1509,20150331,4551,4564,4553,4580,4513,4577,4541,13,-23,59220,2689417220,70464
406,jd1509,20150401,4577,4541,4578,4587,4523,4523,4555,-18,14,64212,2925163200,76380
407,jd1509,20150402,4523,4555,4518,4532,4350,4383,4415,-172,-140,214606,9475580140,101376
408,jd1509,20150403,4383,4415,4370,4388,4313,4324,4348,-91,-67,140330,6102244760,104318
409,jd1509,20150407,4324,4348,4288,4305,4226,4242,4254,-106,-94,141922,6037691380,117062
410,jd1509,20150408,4242,4254,4232,4277,4232,4262,4258,8,4,77562,3302646740,111760
411,jd1509,20150409,4262,4258,4243,4286,4243,4263,4268,5,10,75852,3238065060,106762
412,jd1509,20150410,4263,4268,4263,4382,4260,4359,4331,91,63,154818,6705640380,98260
413,jd1509,20150413,4359,4331,4360,4380,4333,4375,4351,44,20,74616,3246753520,97334
414,jd1509,20150414,4375,4351,4375,4428,4351,4382,4398,31,47,131174,5769954320,93346
415,jd1509,20150415,4382,4398,4370,4397,4353,4387,4373,-11,-25,91812,4015813000,93038
416,jd1509,20150416,4387,4373,4392,4422,4330,4350,4380,-23,7,114882,5032333380,96306
417,jd1509,20150417,4350,4380,4360,4480,4353,4450,4406,70,26,134274,5917431660,87520
418,jd1509,20150420,4450,4406,4462,4507,4430,4439,4460,33,54,85864,3829686700,85512
419,jd1509,20150421,4439,4460,4426,4480,4417,4447,4448,-13,-12,68086,3028485520,84366
420,jd1509,20150422,4447,4448,4425,4470,4425,4465,4453,17,5,54720,2436876500,85080
421,jd1509,20150423,4465,4453,4460,4488,4430,4474,4459,21,6,91308,4072278040,84146
422,jd1509,20150424,4474,4459,4495,4504,4450,4473,4471,14,12,63780,2851866540,82254
423,jd1509,20150427,4473,4471,4465,4488,4433,4468,4466,-3,-5,76980,3438508140,82356
424,jd1509,20150428,4468,4466,4467,4566,4460,4526,4530,60,64,148018,6705632680,83666
425,jd1509,20150429,4526,4530,4527,4538,4503,4513,4516,-17,-14,56050,2531309740,80560
426,jd1509,20150430,4513,4516,4520,4520,4421,4469,4454,-47,-62,119316,5314815100,80474
427,jd1509,20150504,4469,4454,4460,4495,4459,4461,4475,7,21,72098,3226829140,81930
428,jd1509,20150505,4461,4475,4464,4525,4436,4512,4486,37,11,117402,5267058100,86220
429,jd1509,20150506,4512,4486,4520,4541,4486,4493,4509,7,23,76202,3436257440,81704
430,jd1509,20150507,4493,4509,4486,4517,4461,4488,4495,-21,-14,72342,3252018480,81362
431,jd1509,20150508,4488,4495,4476,4485,4400,4414,4442,-81,-53,127494,5663954420,89090
432,jd1509,20150511,4414,4442,4410,4419,4348,4370,4374,-72,-68,115542,5054821320,97670
433,jd1509,20150512,4370,4374,4365,4395,4350,4379,4377,5,3,64004,2802032340,94326
434,jd1509,20150513,4379,4377,4368,4399,4360,4368,4380,-9,3,59030,2586073540,95548
435,jd1509,20150514,4368,4380,4355,4440,4312,4439,4393,59,13,138406,6081450140,99806
436,jd1509,20150515,4439,4393,4445,4472,4433,4469,4451,76,58,101838,4532816000,93988
437,jd1509,20150518,4469,4451,4472,4485,4452,4455,4466,4,15,60988,2724083720,92360
438,jd1509,20150519,4455,4466,4455,4455,4380,4380,4411,-86,-55,92848,4096088040,88374
439,jd1509,20150520,4380,4411,4350,4392,4338,4341,4365,-70,-46,75298,3286773340,83490
440,jd1509,20150521,4341,4365,4343,4389,4341,4360,4368,-5,3,63642,2780382540,85590
441,jd1509,20150522,4360,4368,4360,4397,4317,4382,4363,14,-5,127560,5565858420,86558
442,jd1509,20150525,4382,4363,4364,4368,4254,4284,4301,-79,-62,138544,5959266580,97460
443,jd1509,20150526,4284,4301,4295,4316,4255,4255,4287,-46,-14,101048,4332684180,100324
444,jd1509,20150527,4255,4287,4242,4305,4206,4287,4272,0,-15,114072,4873423280,100624
445,jd1509,20150528,4287,4272,4290,4310,4275,4297,4289,25,17,69062,2962548380,98352
446,jd1509,20150529,4297,4289,4285,4294,4253,4287,4284,-2,-5,53436,2289314900,95566
447,jd1509,20150601,4287,4284,4285,4349,4273,4283,4313,-1,29,103774,4476021580,93062
448,jd1509,20150602,4283,4313,4278,4293,4260,4275,4275,-38,-38,71854,3072136480,95610
449,jd1509,20150603,4275,4275,4275,4308,4220,4222,4268,-53,-7,113304,4836757100,111334
450,jd1509,20150604,4222,4268,4208,4208,4152,4191,4178,-77,-90,165986,6935739960,112606
451,jd1509,20150605,4191,4178,4187,4194,4170,4178,4182,0,4,62306,2605711880,109956
452,jd1509,20150608,4178,4182,4160,4200,4135,4178,4181,-4,-1,85352,3569193520,112998
453,jd1509,20150609,4178,4181,4190,4233,4188,4220,4214,39,33,97428,4106479520,108058
454,jd1509,20150610,4220,4214,4235,4245,4191,4194,4220,-20,6,69782,2945023840,108324
455,jd1509,20150611,4194,4220,4200,4220,4188,4200,4206,-20,-14,61208,2574599240,110532
456,jd1509,20150612,4200,4206,4194,4218,4106,4116,4162,-90,-44,137404,5719033620,115998
457,jd1509,20150615,4116,4162,4101,4110,4036,4049,4067,-113,-95,113318,4608716040,112314
458,jd1509,20150616,4049,4067,4049,4076,4049,4061,4062,-6,-5,50424,2048539680,110072
459,jd1509,20150617,4061,4062,4065,4099,4020,4029,4048,-33,-14,98000,3967256780,113256
460,jd1509,20150618,4029,4048,4032,4045,4002,4029,4022,-19,-26,91590,3684539160,115026
461,jd1509,20150619,4029,4022,4035,4060,4024,4036,4038,14,16,76408,3086100960,110414
462,jd1509,20150623,4036,4038,4048,4088,4041,4074,4068,36,30,89088,3624111580,108364
463,jd1509,20150624,4074,4068,4078,4082,4035,4047,4050,-21,-18,72446,2934749720,105092
464,jd1509,20150625,4047,4050,4060,4173,4060,4134,4123,84,73,109370,4510370320,93920
465,jd1509,20150626,4134,4123,4145,4145,4073,4085,4107,-38,-16,76016,3122100340,88004
466,jd1509,20150629,4085,4107,4065,4090,4045,4068,4066,-39,-41,70708,2875189420,88242
467,jd1509,20150630,4068,4066,4060,4060,3965,3969,3990,-97,-76,96574,3853425320,86114
468,jd1509,20150701,3969,3990,4000,4112,3992,4027,4026,37,36,69972,2817613540,86174
469,jd1509,20150702,4027,4026,4026,4029,3983,4009,4001,-17,-25,54432,2177867960,87132
470,jd1509,20150703,4009,4001,4024,4057,4010,4037,4035,36,34,71288,2876857260,84946
471,jd1509,20150706,4037,4035,4050,4079,3992,4040,4031,5,-4,73148,2948950460,80262
472,jd1509,20150707,4040,4031,4041,4065,4018,4036,4045,5,14,63408,2565264220,79030
473,jd1509,20150708,4036,4045,3970,3970,3843,3843,3875,-202,-170,103004,3992187160,62944
474,jd1509,20150709,3843,3875,3950,4080,3911,4010,3985,135,110,121612,4846833860,57252
475,jd1509,20150710,4010,3985,4047,4165,4043,4132,4111,147,126,133516,5490002740,52644
476,jd1509,20150713,4132,4111,4162,4188,4111,4144,4140,33,29,76886,3183545380,52574
477,jd1509,20150714,4144,4140,4145,4226,4144,4198,4189,58,49,104494,4377391320,55052
478,jd1509,20150715,4198,4189,4185,4188,4148,4180,4164,-9,-25,50416,2099511520,54614
479,jd1509,20150716,4180,4164,4150,4199,4119,4174,4163,10,-1,60066,2500925400,55472
480,jd1509,20150717,4174,4163,4144,4178,4130,4168,4153,5,-10,51830,2152739420,54774
481,jd1509,20150720,4168,4153,4156,4257,4146,4248,4202,95,49,95606,4017974640,69168
482,jd1509,20150721,4248,4202,4258,4329,4255,4304,4298,102,96,145174,6240583520,69938
483,jd1509,20150722,4304,4298,4310,4322,4260,4280,4288,-18,-10,97318,4173536320,67164
484,jd1509,20150723,4280,4288,4288,4370,4278,4364,4329,76,41,124522,5390617620,75542
485,jd1509,20150724,4364,4329,4380,4387,4341,4370,4358,41,29,111328,4852030800,74116
486,jd1509,20150727,4370,4358,4379,4389,4266,4318,4320,-40,-38,125816,5436491460,62600
487,jd1509,20150728,4318,4320,4310,4470,4281,4450,4403,130,83,220974,9730617180,83152
488,jd1509,20150729,4450,4403,4459,4470,4410,4429,4435,26,32,152882,6780335740,74866
489,jd1509,20150730,4429,4435,4438,4440,4351,4378,4389,-57,-46,140304,6158819000,63052
490,jd1509,20150731,4378,4389,4378,4422,4378,4422,4400,33,11,88152,3879089680,62296
491,jd1509,20150803,4422,4400,4422,4435,4296,4345,4362,-55,-38,109292,4768347660,45140
492,jd1509,20150804,4345,4362,4360,4377,4321,4336,4338,-26,-24,45506,1974425920,41434
493,jd1509,20150805,4336,4338,4335,4343,4122,4225,4239,-113,-99,67926,2879481520,31414
494,jd1509,20150806,4225,4239,4224,4279,4224,4234,4248,-5,9,30372,1290299100,27544
495,jd1509,20150807,4234,4248,4245,4245,4166,4227,4202,-21,-46,32254,1355355360,21338
496,jd1509,20150810,4227,4202,4215,4268,4215,4235,4244,33,42,15004,636797320,19968
497,jd1509,20150811,4235,4244,4255,4278,4225,4231,4250,-13,6,15236,647546680,17342
498,jd1509,20150812,4231,4250,4250,4268,4220,4246,4247,-4,-3,9988,424229580,15674
499,jd1509,20150813,4246,4247,4247,4293,4241,4266,4259,19,12,10266,437247560,14264
500,jd1509,20150814,4266,4259,4272,4383,4272,4323,4327,64,68,17770,768927860,11298
501,jd1509,20150817,4323,4327,4350,4350,4286,4316,4309,-11,-18,6650,286563000,10298
502,jd1509,20150818,4316,4309,4298,4345,4298,4315,4322,6,13,6284,271611160,9938
503,jd1509,20150819,4315,4322,4328,4336,4300,4330,4320,8,-2,4966,214551980,9470
504,jd1509,20150820,4330,4320,4345,4365,4318,4326,4331,6,11,3938,170566300,8410
505,jd1509,20150821,4326,4331,4332,4348,4330,4330,4338,-1,7,2826,122604240,7374
506,jd1509,20150824,4330,4338,4336,4339,4260,4330,4304,-8,-34,5618,241842920,5654
507,jd1509,20150825,4330,4304,4313,4364,4301,4313,4322,9,18,2440,105480460,4796
508,jd1509,20150826,4313,4322,4330,4333,4235,4243,4282,-79,-40,3270,140033980,3896
509,jd1509,20150827,4243,4282,4255,4255,4151,4190,4206,-92,-76,3294,138560360,2672
510,jd1509,20150828,4190,4206,4180,4242,4160,4174,4189,-32,-17,2486,104150380,1690
511,jd1509,20150831,4174,4189,4180,4180,3980,3980,4132,-209,-57,2198,90840540,234
512,jd1509,20150901,3980,4132,3977,3986,3885,3885,3905,-247,-227,160,6248000,88
513,jd1509,20150902,3885,3905,3918,3918,3867,3867,3892,-38,-13,4,155700,84
514,jd1509,20150907,3867,3892,3885,3885,3885,3885,3885,-7,-7,10,388500,74
515,jd1509,20150908,3885,3885,3886,4118,3885,4118,3964,233,79,26,1030820,48
516,jd1509,20150909,4118,3964,0,0,0,3964,3964,0,0,0,0,48
517,jd1509,20150910,3964,3964,3985,3985,3985,3985,3985,21,21,2,79700,46
518,jd1509,20150911,3985,3985,0,0,0,3950,3950,-35,-35,0,0,46
519,jd1509,20150914,3950,3950,0,0,0,3950,3950,0,0,0,0,46
520,jd1509,20150915,3950,3950,3960,3960,3960,3960,3960,10,10,2,79200,44
521,jd1509,20150916,3960,3960,0,0,0,3912,3912,-48,-48,0,0,0
522,jd1510,20150105,4375,4416,4427,4427,4427,4427,4427,11,11,2,88540,22
523,jd1510,20150106,4427,4427,0,0,0,4427,4427,0,0,0,0,22
524,jd1510,20150107,4427,4427,4415,4429,4415,4429,4422,2,-5,4,176880,20
525,jd1510,20150108,4429,4422,0,0,0,4422,4422,0,0,0,0,20
526,jd1510,20150109,4422,4422,0,0,0,4422,4422,0,0,0,0,20
527,jd1510,20150112,4422,4422,4381,4420,4381,4420,4399,-2,-23,10,439940,24
528,jd1510,20150113,4420,4399,4388,4388,4338,4367,4365,-32,-34,12,523860,32
529,jd1510,20150114,4367,4365,4321,4321,4300,4303,4304,-62,-61,14,602680,26
530,jd1510,20150115,4303,4304,4344,4344,4284,4325,4308,21,4,10,430840,26
531,jd1510,20150116,4325,4308,4328,4328,4258,4258,4277,-50,-31,20,855440,28
532,jd1510,20150119,4258,4277,4288,4288,4288,4288,4288,11,11,2,85760,26
533,jd1510,20150120,4288,4288,0,0,0,4297,4297,9,9,0,0,26
534,jd1510,20150121,4297,4297,4332,4332,4332,4332,4332,35,35,2,86640,26
535,jd1510,20150122,4332,4332,4263,4263,4262,4262,4262,-70,-70,8,341000,32
536,jd1510,20150123,4262,4262,0,0,0,4262,4262,0,0,0,0,32
537,jd1510,20150126,4262,4262,4369,4369,4369,4369,4369,107,107,8,349520,40
538,jd1510,20150127,4369,4369,4399,4450,4377,4397,4403,28,34,12,528460,48
539,jd1510,20150128,4397,4403,4343,4392,4343,4392,4367,-11,-36,4,174700,48
540,jd1510,20150129,4392,4367,0,0,0,4367,4367,0,0,0,0,48
541,jd1510,20150130,4367,4367,4335,4335,4314,4314,4321,-53,-46,6,259260,52
542,jd1510,20150202,4314,4321,4362,4362,4362,4362,4362,41,41,2,87240,52
543,jd1510,20150203,4362,4362,4421,4421,4376,4399,4396,37,34,8,351680,50
544,jd1510,20150204,4399,4396,4410,4410,4346,4346,4378,-50,-18,4,175120,48
545,jd1510,20150205,4346,4378,0,0,0,4378,4378,0,0,0,0,48
546,jd1510,20150206,4378,4378,4398,4398,4356,4356,4371,-22,-7,6,262280,48
547,jd1510,20150209,4356,4371,4359,4359,4359,4359,4359,-12,-12,6,261540,48
548,jd1510,20150210,4359,4359,4348,4392,4344,4344,4361,-15,2,6,261680,46
549,jd1510,20150211,4344,4361,4365,4365,4365,4365,4365,4,4,2,87300,46
550,jd1510,20150212,4365,4365,4358,4358,4354,4354,4356,-11,-9,4,174240,42
551,jd1510,20150213,4354,4356,4367,4368,4360,4360,4363,4,7,8,349100,42
552,jd1510,20150216,4360,4363,0,0,0,4363,4363,0,0,0,0,42
553,jd1510,20150217,4363,4363,4368,4444,4368,4444,4395,81,32,6,263700,40
554,jd1510,20150225,4444,4395,4394,4399,4394,4399,4396,4,1,8,351740,36
555,jd1510,20150226,4399,4396,0,0,0,4396,4396,0,0,0,0,36
556,jd1510,20150227,4396,4396,4402,4436,4402,4436,4415,40,19,12,529900,30
557,jd1510,20150302,4436,4415,4454,4479,4441,4467,4462,52,47,12,535460,32
558,jd1510,20150303,4467,4462,0,0,0,4462,4462,0,0,0,0,32
559,jd1510,20150304,4462,4462,0,0,0,4462,4462,0,0,0,0,32
560,jd1510,20150305,4462,4462,4471,4471,4451,4451,4460,-11,-2,6,267620,32
561,jd1510,20150306,4451,4460,0,0,0,4455,4455,-5,-5,0,0,32
562,jd1510,20150309,4455,4455,0,0,0,4442,4442,-13,-13,0,0,32
563,jd1510,20150310,4442,4442,0,0,0,4439,4439,-3,-3,0,0,32
564,jd1510,20150311,4439,4439,4481,4481,4449,4449,4475,10,36,12,537080,26
565,jd1510,20150312,4449,4475,4612,4612,4429,4480,4507,5,32,6,270420,24
566,jd1510,20150313,4480,4507,0,0,0,4481,4481,-26,-26,0,0,24
567,jd1510,20150316,4481,4481,0,0,0,4481,4481,0,0,0,0,24
568,jd1510,20150317,4481,4481,0,0,0,4481,4481,0,0,0,0,24
569,jd1510,20150318,4481,4481,4554,4554,4554,4554,4554,73,73,8,364320,22
570,jd1510,20150319,4554,4554,0,0,0,4554,4554,0,0,0,0,22
571,jd1510,20150320,4554,4554,0,0,0,4554,4554,0,0,0,0,22
572,jd1510,20150323,4554,4554,4454,4454,4454,4454,4454,-100,-100,2,89080,24
573,jd1510,20150324,4454,4454,0,0,0,4460,4460,6,6,0,0,24
574,jd1510,20150325,4460,4460,4450,4450,4450,4450,4450,-10,-10,2,89000,22
575,jd1510,20150326,4450,4450,0,0,0,4450,4450,0,0,0,0,22
576,jd1510,20150327,4450,4450,0,0,0,4450,4450,0,0,0,0,22
577,jd1510,20150330,4450,4450,0,0,0,4450,4450,0,0,0,0,22
578,jd1510,20150331,4450,4450,0,0,0,4450,4450,0,0,0,0,22
579,jd1510,20150401,4450,4450,0,0,0,4450,4450,0,0,0,0,22
580,jd1510,20150402,4450,4450,4304,4304,4300,4300,4301,-150,-149,18,774180,22
581,jd1510,20150403,4300,4301,4327,4327,4255,4255,4291,-46,-10,4,171640,22
582,jd1510,20150407,4255,4291,4200,4221,4151,4161,4182,-130,-109,22,920080,20
583,jd1510,20150408,4161,4182,4210,4220,4176,4177,4198,-5,16,12,503800,18
584,jd1510,20150409,4177,4198,0,0,0,4198,4198,0,0,0,0,18
585,jd1510,20150410,4198,4198,4299,4299,4299,4299,4299,101,101,2,85980,18
586,jd1510,20150413,4299,4299,4300,4300,4300,4300,4300,1,1,2,86000,18
587,jd1510,20150414,4300,4300,4330,4330,4330,4330,4330,30,30,2,86600,16
588,jd1510,20150415,4330,4330,4260,4260,4260,4260,4260,-70,-70,2,85200,16
589,jd1510,20150416,4260,4260,4370,4370,4278,4307,4329,47,69,10,432940,14
590,jd1510,20150417,4307,4329,4391,4391,4386,4386,4388,57,59,4,175540,18
591,jd1510,20150420,4386,4388,4380,4380,4380,4380,4380,-8,-8,2,87600,18
592,jd1510,20150421,4380,4380,0,0,0,4380,4380,0,0,0,0,18
593,jd1510,20150422,4380,4380,0,0,0,4380,4380,0,0,0,0,18
594,jd1510,20150423,4380,4380,0,0,0,4380,4380,0,0,0,0,18
595,jd1510,20150424,4380,4380,4357,4387,4357,4387,4367,7,-13,6,262040,18
596,jd1510,20150427,4387,4367,4380,4380,4380,4380,4380,13,13,2,87600,18
597,jd1510,20150428,4380,4380,4400,4422,4400,4421,4414,41,34,14,618060,18
598,jd1510,20150429,4421,4414,0,0,0,4414,4414,0,0,0,0,18
599,jd1510,20150430,4414,4414,4365,4379,4354,4379,4361,-35,-53,10,436180,14
600,jd1510,20150504,4379,4361,0,0,0,4361,4361,0,0,0,0,14
601,jd1510,20150505,4361,4361,0,0,0,4386,4386,25,25,0,0,14
602,jd1510,20150506,4386,4386,4403,4403,4403,4403,4403,17,17,2,88060,12
603,jd1510,20150507,4403,4403,0,0,0,4403,4403,0,0,0,0,12
604,jd1510,20150508,4403,4403,4341,4341,4340,4340,4340,-63,-63,4,173620,10
605,jd1510,20150511,4340,4340,4327,4327,4327,4327,4327,-13,-13,2,86540,10
606,jd1510,20150512,4327,4327,0,0,0,4327,4327,0,0,0,0,10
607,jd1510,20150513,4327,4327,4267,4267,4267,4267,4267,-60,-60,2,85340,10
608,jd1510,20150514,4267,4267,4218,4218,4218,4218,4218,-49,-49,4,168720,10
609,jd1510,20150515,4218,4218,4257,4260,4257,4260,4259,42,41,6,255540,14
610,jd1510,20150518,4260,4259,0,0,0,4259,4259,0,0,0,0,14
611,jd1510,20150519,4259,4259,0,0,0,4259,4259,0,0,0,0,14
612,jd1510,20150520,4259,4259,0,0,0,4259,4259,0,0,0,0,14
613,jd1510,20150521,4259,4259,0,0,0,4259,4259,0,0,0,0,14
614,jd1510,20150522,4259,4259,0,0,0,4249,4249,-10,-10,0,0,14
615,jd1510,20150525,4249,4249,4120,4120,4120,4120,4120,-129,-129,2,82400,16
616,jd1510,20150526,4120,4120,4055,4152,4055,4081,4094,-39,-26,38,1555720,34
617,jd1510,20150527,4081,4094,0,0,0,4094,4094,0,0,0,0,34
618,jd1510,20150528,4094,4094,4108,4109,4108,4109,4108,15,14,4,164340,32
619,jd1510,20150529,4109,4108,0,0,0,4108,4108,0,0,0,0,32
620,jd1510,20150601,4108,4108,4107,4107,4107,4107,4107,-1,-1,2,82140,34
621,jd1510,20150602,4107,4107,0,0,0,4107,4107,0,0,0,0,34
622,jd1510,20150603,4107,4107,4098,4098,4098,4098,4098,-9,-9,4,163920,32
623,jd1510,20150604,4098,4098,4052,4130,4029,4081,4068,-17,-30,24,976360,38
624,jd1510,20150605,4081,4068,4106,4106,4050,4050,4073,-18,5,6,244380,38
625,jd1510,20150608,4050,4073,4100,4100,4092,4092,4096,19,23,4,163840,40
626,jd1510,20150609,4092,4096,4096,4138,4093,4120,4111,24,15,66,2713580,40
627,jd1510,20150610,4120,4111,4041,4119,4041,4110,4090,-1,-21,6,245400,40
628,jd1510,20150611,4110,4090,0,0,0,4090,4090,0,0,0,0,40
629,jd1510,20150612,4090,4090,4087,4087,4060,4064,4071,-26,-19,20,814280,42
630,jd1510,20150615,4064,4071,4013,4014,4012,4012,4013,-59,-58,14,561820,46
631,jd1510,20150616,4012,4013,4049,4049,4049,4049,4049,36,36,2,80980,48
632,jd1510,20150617,4049,4049,4030,4030,4000,4000,4010,-49,-39,24,962520,62
633,jd1510,20150618,4000,4010,4010,4010,3933,3975,3965,-35,-45,24,951820,58
634,jd1510,20150619,3975,3965,0,0,0,3965,3965,0,0,0,0,58
635,jd1510,20150623,3965,3965,3996,3996,3995,3995,3995,30,30,4,159820,58
636,jd1510,20150624,3995,3995,0,0,0,3995,3995,0,0,0,0,58
637,jd1510,20150625,3995,3995,4028,4047,4028,4047,4040,52,45,6,242420,58
638,jd1510,20150626,4047,4040,4059,4059,4000,4000,4029,-40,-11,8,322360,60
639,jd1510,20150629,4000,4029,4025,4025,3980,3982,3997,-47,-32,10,399760,64
640,jd1510,20150630,3982,3997,3960,3965,3929,3959,3943,-38,-54,22,867660,50
641,jd1510,20150701,3959,3943,3938,3988,3938,3988,3973,45,30,22,874200,62
642,jd1510,20150702,3988,3973,3945,3967,3924,3967,3946,-6,-27,14,552480,66
643,jd1510,20150703,3967,3946,3983,3983,3980,3980,3981,34,35,4,159260,62
644,jd1510,20150706,3980,3981,4017,4019,3932,3978,3981,-3,0,44,1751780,62
645,jd1510,20150707,3978,3981,3999,3999,3940,3943,3982,-38,1,26,1035440,62
646,jd1510,20150708,3943,3982,3900,3900,3786,3801,3818,-181,-164,102,3894360,56
647,jd1510,20150709,3801,3818,3948,3998,3876,3920,3936,102,118,60,2361700,66
648,jd1510,20150710,3920,3936,3965,4017,3931,3931,3982,-5,46,34,1353980,58
649,jd1510,20150713,3931,3982,3962,3991,3962,3989,3981,7,-1,8,318520,54
650,jd1510,20150714,3989,3981,4060,4108,4035,4047,4068,66,87,146,5939700,68
651,jd1510,20150715,4047,4068,4059,4059,4059,4059,4059,-9,-9,8,324720,60
652,jd1510,20150716,4059,4059,3995,3995,3995,3995,3995,-64,-64,2,79900,58
653,jd1510,20150717,3995,3995,4115,4115,4017,4094,4071,99,76,10,407160,58
654,jd1510,20150720,4094,4071,4008,4099,3935,4093,4048,22,-23,34,1376460,46
655,jd1510,20150721,4093,4048,4150,4150,4056,4119,4107,71,59,16,657180,42
656,jd1510,20150722,4119,4107,0,0,0,4107,4107,0,0,0,0,42
657,jd1510,20150723,4107,4107,4127,4129,4101,4128,4123,21,16,26,1072220,36
658,jd1510,20150724,4128,4123,4150,4188,4150,4188,4166,65,43,86,3583340,70
659,jd1510,20150727,4188,4166,4180,4181,4139,4179,4170,13,4,26,1084320,68
660,jd1510,20150728,4179,4170,4161,4194,4155,4194,4178,24,8,32,1337080,64
661,jd1510,20150729,4194,4178,4175,4175,4172,4172,4173,-6,-5,6,250380,70
662,jd1510,20150730,4172,4173,4151,4170,4150,4151,4155,-22,-18,14,581700,76
663,jd1510,20150731,4151,4155,4164,4171,4140,4140,4165,-15,10,24,999700,92
664,jd1510,20150803,4140,4165,4195,4198,4016,4110,4138,-55,-27,22,910420,98
665,jd1510,20150804,4110,4138,0,0,0,4138,4138,0,0,0,0,98
666,jd1510,20150805,4138,4138,4005,4138,4005,4069,4074,-69,-64,24,977880,100
667,jd1510,20150806,4069,4074,4012,4048,4012,4048,4022,-26,-52,44,1769700,112
668,jd1510,20150807,4048,4022,4035,4044,3978,3982,4006,-40,-16,56,2243640,104
669,jd1510,20150810,3982,4006,4004,4010,4004,4010,4007,4,1,8,320560,108
670,jd1510,20150811,4010,4007,4052,4052,4000,4000,4011,-7,4,26,1043000,120
671,jd1510,20150812,4000,4011,4001,4210,3992,4013,4044,2,33,64,2588620,126
672,jd1510,20150813,4013,4044,4119,4119,3980,4044,4025,0,-19,14,563620,130
673,jd1510,20150814,4044,4025,4109,4109,3874,4003,4018,-22,-7,130,5224080,186
674,jd1510,20150817,4003,4018,4000,4000,3950,3950,3967,-68,-51,56,2221740,220
675,jd1510,20150818,3950,3967,3999,3999,3934,3946,3952,-21,-15,26,1027760,232
676,jd1510,20150819,3946,3952,3931,3972,3931,3970,3956,18,4,52,2057120,240
677,jd1510,20150820,3970,3956,3985,3998,3954,3967,3975,11,19,54,2147000,250
678,jd1510,20150821,3967,3975,3989,4000,3975,3976,3985,1,10,32,1275480,264
679,jd1510,20150824,3976,3985,3851,3997,3810,3953,3951,-32,-34,114,4504640,252
680,jd1510,20150825,3953,3951,3985,4037,3933,3949,3974,-2,23,42,1669200,248
681,jd1510,20150826,3949,3974,3970,3989,3885,3901,3926,-73,-48,242,9502740,324
682,jd1510,20150827,3901,3926,3851,3937,3851,3885,3906,-41,-20,160,6250320,354
683,jd1510,20150828,3885,3906,3873,3949,3852,3856,3888,-50,-18,80,3110600,380
684,jd1510,20150831,3856,3888,3865,3880,3710,3710,3840,-178,-48,170,6528820,440
685,jd1510,20150901,3710,3840,3762,3853,3730,3730,3787,-110,-53,214,8105700,480
686,jd1510,20150902,3730,3787,3766,3786,3740,3761,3759,-26,-28,146,5489380,486
687,jd1510,20150907,3761,3759,3766,3769,3723,3728,3742,-31,-17,50,1871120,470
688,jd1510,20150908,3728,3742,3747,3776,3725,3769,3753,27,11,32,1201260,470
689,jd1510,20150909,3769,3753,3800,3819,3725,3728,3775,-25,22,200,7550500,464
690,jd1510,20150910,3728,3775,3721,3813,3680,3790,3762,15,-13,144,5418240,464
691,jd1510,20150911,3790,3762,3762,3815,3762,3796,3797,34,35,152,5772680,474
692,jd1510,20150914,3796,3797,3780,3839,3780,3799,3809,2,12,334,12723640,470
693,jd1510,20150915,3799,3809,3780,3806,3780,3783,3794,-26,-15,122,4629600,434
694,jd1510,20150916,3783,3794,3775,3785,3741,3752,3764,-42,-30,178,6700820,374
695,jd1510,20150917,3752,3764,3761,3771,3755,3758,3764,-6,0,104,3915040,352
696,jd1510,20150918,3758,3764,3761,3770,3731,3759,3752,-5,-12,46,1725920,320
697,jd1510,20150921,3759,3752,3736,3770,3736,3765,3761,13,9,42,1579900,302
698,jd1510,20150922,3765,3761,3759,3768,3740,3756,3753,-5,-8,116,4353960,248
699,jd1510,20150923,3756,3753,3748,3768,3748,3758,3758,5,5,48,1804140,228
700,jd1510,20150924,3758,3758,3766,3766,3716,3730,3741,-28,-17,76,2843220,170
701,jd1510,20150925,3730,3741,3759,3760,3706,3715,3727,-26,-14,90,3354760,160
702,jd1510,20150928,3715,3727,3720,3720,3666,3666,3699,-61,-28,46,1701600,124
703,jd1510,20150929,3666,3699,3699,3699,3515,3515,3576,-184,-123,118,4220080,40
704,jd1510,20150930,3515,3576,3412,3509,3398,3398,3417,-178,-159,88,3007640,16
705,jd1510,20151008,3398,3417,3396,3396,3310,3310,3365,-107,-52,14,471180,16
706,jd1510,20151009,3310,3365,3350,3350,3350,3350,3350,-15,-15,4,134000,16
707,jd1510,20151012,3350,3350,0,0,0,3350,3350,0,0,0,0,16
708,jd1510,20151013,3350,3350,0,0,0,3350,3350,0,0,0,0,16
709,jd1510,20151014,3350,3350,0,0,0,3350,3350,0,0,0,0,16
710,jd1510,20151015,3350,3350,0,0,0,3350,3350,0,0,0,0,16
711,jd1510,20151016,3350,3350,0,0,0,3350,3350,0,0,0,0,16
712,jd1510,20151019,3350,3350,0,0,0,3350,3350,0,0,0,0,16
713,jd1510,20151020,3350,3350,0,0,0,3350,3350,0,0,0,0,16
714,jd1510,20151021,3350,3350,0,0,0,3362,3362,12,12,0,0,0
715,jd1511,20150105,4273,4302,0,0,0,4302,4302,0,0,0,0,10
716,jd1511,20150106,4302,4302,4277,4277,4277,4277,4277,-25,-25,2,85540,10
717,jd1511,20150107,4277,4277,4283,4315,4283,4315,4299,38,22,4,171960,10
718,jd1511,20150108,4315,4299,0,0,0,4299,4299,0,0,0,0,10
719,jd1511,20150109,4299,4299,0,0,0,4299,4299,0,0,0,0,10
720,jd1511,20150112,4299,4299,4290,4340,4290,4340,4317,41,18,8,345400,14
721,jd1511,20150113,4340,4317,4281,4281,4241,4241,4263,-76,-54,8,341060,18
722,jd1511,20150114,4241,4263,4212,4212,4204,4212,4209,-51,-54,12,505120,12
723,jd1511,20150115,4212,4209,4265,4265,4265,4265,4265,56,56,2,85300,14
724,jd1511,20150116,4265,4265,4202,4220,4178,4220,4200,-45,-65,6,252000,16
725,jd1511,20150119,4220,4200,4247,4247,4184,4239,4223,39,23,6,253400,12
726,jd1511,20150120,4239,4223,0,0,0,4223,4223,0,0,0,0,12
727,jd1511,20150121,4223,4223,0,0,0,4223,4223,0,0,0,0,12
728,jd1511,20150122,4223,4223,4207,4207,4207,4207,4207,-16,-16,4,168280,12
729,jd1511,20150123,4207,4207,4210,4225,4168,4175,4179,-32,-28,20,835880,22
730,jd1511,20150126,4175,4179,4180,4193,4160,4193,4178,14,-1,8,334260,28
731,jd1511,20150127,4193,4178,4247,4280,4190,4190,4239,12,61,8,339140,32
732,jd1511,20150128,4190,4239,4194,4194,4194,4194,4194,-45,-45,2,83880,30
733,jd1511,20150129,4194,4194,4206,4206,4206,4206,4206,12,12,2,84120,30
734,jd1511,20150130,4206,4206,4166,4207,4157,4207,4171,1,-35,8,333740,34
735,jd1511,20150202,4207,4171,0,0,0,4180,4180,9,9,0,0,34
736,jd1511,20150203,4180,4180,4227,4227,4227,4227,4227,47,47,2,84540,32
737,jd1511,20150204,4227,4227,4216,4267,4216,4250,4248,23,21,12,509800,34
738,jd1511,20150205,4250,4248,4264,4275,4264,4275,4265,27,17,18,767740,22
739,jd1511,20150206,4275,4265,4227,4227,4227,4227,4227,-38,-38,2,84540,20
740,jd1511,20150209,4227,4227,4230,4230,4230,4230,4230,3,3,2,84600,18
741,jd1511,20150210,4230,4230,4200,4200,4200,4200,4200,-30,-30,2,84000,18
742,jd1511,20150211,4200,4200,0,0,0,4200,4200,0,0,0,0,18
743,jd1511,20150212,4200,4200,4176,4176,4176,4176,4176,-24,-24,2,83520,18
744,jd1511,20150213,4176,4176,4226,4226,4226,4226,4226,50,50,2,84520,16
745,jd1511,20150216,4226,4226,0,0,0,4226,4226,0,0,0,0,16
746,jd1511,20150217,4226,4226,0,0,0,4256,4256,30,30,0,0,16
747,jd1511,20150225,4256,4256,0,0,0,4256,4256,0,0,0,0,16
748,jd1511,20150226,4256,4256,4194,4194,4194,4194,4194,-62,-62,2,83880,16
749,jd1511,20150227,4194,4194,4227,4227,4227,4227,4227,33,33,2,84540,16
750,jd1511,20150302,4227,4227,4345,4346,4345,4346,4345,119,118,8,347640,20
751,jd1511,20150303,4346,4345,4241,4250,4241,4250,4245,-95,-100,4,169820,20
752,jd1511,20150304,4250,4245,0,0,0,4254,4254,9,9,0,0,20
753,jd1511,20150305,4254,4254,0,0,0,4254,4254,0,0,0,0,20
754,jd1511,20150306,4254,4254,0,0,0,4254,4254,0,0,0,0,20
755,jd1511,20150309,4254,4254,0,0,0,4254,4254,0,0,0,0,20
756,jd1511,20150310,4254,4254,0,0,0,4254,4254,0,0,0,0,20
757,jd1511,20150311,4254,4254,4424,4424,4424,4424,4424,170,170,4,176960,16
758,jd1511,20150312,4424,4424,0,0,0,4415,4415,-9,-9,0,0,16
759,jd1511,20150313,4415,4415,0,0,0,4400,4400,-15,-15,0,0,16
760,jd1511,20150316,4400,4400,0,0,0,4400,4400,0,0,0,0,16
761,jd1511,20150317,4400,4400,0,0,0,4400,4400,0,0,0,0,16
762,jd1511,20150318,4400,4400,0,0,0,4400,4400,0,0,0,0,16
763,jd1511,20150319,4400,4400,4330,4330,4330,4330,4330,-70,-70,2,86600,16
764,jd1511,20150320,4330,4330,0,0,0,4330,4330,0,0,0,0,16
765,jd1511,20150323,4330,4330,0,0,0,4330,4330,0,0,0,0,16
766,jd1511,20150324,4330,4330,0,0,0,4330,4330,0,0,0,0,16
767,jd1511,20150325,4330,4330,0,0,0,4321,4321,-9,-9,0,0,16
768,jd1511,20150326,4321,4321,0,0,0,4304,4304,-17,-17,0,0,16
769,jd1511,20150327,4304,4304,0,0,0,4317,4317,13,13,0,0,16
770,jd1511,20150330,4317,4317,0,0,0,4311,4311,-6,-6,0,0,16
771,jd1511,20150331,4311,4311,0,0,0,4290,4290,-21,-21,0,0,16
772,jd1511,20150401,4290,4290,0,0,0,4303,4303,13,13,0,0,16
773,jd1511,20150402,4303,4303,4200,4280,4155,4155,4226,-148,-77,16,676300,14
774,jd1511,20150403,4155,4226,0,0,0,4226,4226,0,0,0,0,14
775,jd1511,20150407,4226,4226,0,0,0,4150,4150,-76,-76,0,0,14
776,jd1511,20150408,4150,4150,4182,4182,4182,4182,4182,32,32,2,83640,16
777,jd1511,20150409,4182,4182,4146,4146,4146,4146,4146,-36,-36,2,82920,16
778,jd1511,20150410,4146,4146,4190,4190,4190,4190,4190,44,44,2,83800,14
779,jd1511,20150413,4190,4190,0,0,0,4190,4190,0,0,0,0,14
780,jd1511,20150414,4190,4190,0,0,0,4190,4190,0,0,0,0,14
781,jd1511,20150415,4190,4190,0,0,0,4190,4190,0,0,0,0,14
782,jd1511,20150416,4190,4190,0,0,0,4257,4257,67,67,0,0,14
783,jd1511,20150417,4257,4257,0,0,0,4315,4315,58,58,0,0,14
784,jd1511,20150420,4315,4315,4312,4312,4312,4312,4312,-3,-3,6,258720,14
785,jd1511,20150421,4312,4312,0,0,0,4312,4312,0,0,0,0,14
786,jd1511,20150422,4312,4312,4358,4358,4358,4358,4358,46,46,2,87160,14
787,jd1511,20150423,4358,4358,0,0,0,4358,4358,0,0,0,0,14
788,jd1511,20150424,4358,4358,0,0,0,4358,4358,0,0,0,0,14
789,jd1511,20150427,4358,4358,0,0,0,4358,4358,0,0,0,0,14
790,jd1511,20150428,4358,4358,0,0,0,4373,4373,15,15,0,0,14
791,jd1511,20150429,4373,4373,4377,4377,4377,4377,4377,4,4,2,87540,14
792,jd1511,20150430,4377,4377,0,0,0,4377,4377,0,0,0,0,14
793,jd1511,20150504,4377,4377,0,0,0,4397,4397,20,20,0,0,14
794,jd1511,20150505,4397,4397,0,0,0,4407,4407,10,10,0,0,14
795,jd1511,20150506,4407,4407,0,0,0,4424,4424,17,17,0,0,14
796,jd1511,20150507,4424,4424,0,0,0,4411,4411,-13,-13,0,0,14
797,jd1511,20150508,4411,4411,0,0,0,4348,4348,-63,-63,0,0,14
798,jd1511,20150511,4348,4348,0,0,0,4340,4340,-8,-8,0,0,14
799,jd1511,20150512,4340,4340,0,0,0,4340,4340,0,0,0,0,14
800,jd1511,20150513,4340,4340,4244,4297,4244,4297,4270,-43,-70,4,170820,14
801,jd1511,20150514,4297,4270,4255,4255,4221,4221,4229,-49,-41,8,338360,14
802,jd1511,20150515,4221,4229,0,0,0,4229,4229,0,0,0,0,14
803,jd1511,20150518,4229,4229,4294,4357,4244,4337,4301,108,72,14,602240,22
804,jd1511,20150519,4337,4301,0,0,0,4299,4299,-2,-2,0,0,22
805,jd1511,20150520,4299,4299,0,0,0,4299,4299,0,0,0,0,22
806,jd1511,20150521,4299,4299,0,0,0,4299,4299,0,0,0,0,22
807,jd1511,20150522,4299,4299,4163,4219,4122,4219,4180,-80,-119,8,334460,24
808,jd1511,20150525,4219,4180,0,0,0,4180,4180,0,0,0,0,24
809,jd1511,20150526,4180,4180,4073,4101,4073,4096,4091,-84,-89,14,572840,30
810,jd1511,20150527,4096,4091,4084,4131,4084,4131,4121,40,30,22,906800,38
811,jd1511,20150528,4131,4121,0,0,0,4121,4121,0,0,0,0,38
812,jd1511,20150529,4121,4121,0,0,0,4121,4121,0,0,0,0,38
813,jd1511,20150601,4121,4121,4127,4135,4127,4135,4129,14,8,6,247780,42
814,jd1511,20150602,4135,4129,0,0,0,4129,4129,0,0,0,0,42
815,jd1511,20150603,4129,4129,4118,4118,4118,4118,4118,-11,-11,2,82360,42
816,jd1511,20150604,4118,4118,4084,4084,4080,4080,4083,-38,-35,8,326640,42
817,jd1511,20150605,4080,4083,0,0,0,4083,4083,0,0,0,0,42
818,jd1511,20150608,4083,4083,4154,4154,4059,4060,4083,-23,0,8,326640,44
819,jd1511,20150609,4060,4083,0,0,0,4098,4098,15,15,0,0,44
820,jd1511,20150610,4098,4098,4126,4126,4126,4126,4126,28,28,2,82520,42
821,jd1511,20150611,4126,4126,4150,4160,4150,4160,4153,34,27,6,249220,40
822,jd1511,20150612,4160,4153,0,0,0,4153,4153,0,0,0,0,40
823,jd1511,20150615,4153,4153,4048,4058,4048,4056,4053,-97,-100,24,972880,44
824,jd1511,20150616,4056,4053,4057,4057,4011,4011,4036,-42,-17,44,1776260,54
825,jd1511,20150617,4011,4036,3991,3994,3941,3967,3974,-69,-62,44,1748840,86
826,jd1511,20150618,3967,3974,3923,3968,3824,3959,3906,-15,-68,46,1796960,100
827,jd1511,20150619,3959,3906,3902,3931,3890,3890,3911,-16,5,38,1486340,130
828,jd1511,20150623,3890,3911,3893,3920,3893,3920,3913,9,2,14,547920,134
829,jd1511,20150624,3920,3913,3926,3926,3850,3850,3886,-63,-27,50,1943120,162
830,jd1511,20150625,3850,3886,3902,3931,3902,3915,3920,29,34,30,1176000,168
831,jd1511,20150626,3915,3920,3891,3911,3885,3899,3897,-21,-23,34,1325020,170
832,jd1511,20150629,3899,3897,3893,4020,3867,3884,3903,-13,6,48,1873560,182
833,jd1511,20150630,3884,3903,3804,3889,3804,3849,3864,-54,-39,68,2628140,174
834,jd1511,20150701,3849,3864,3918,3918,3863,3901,3894,37,30,32,1246140,182
835,jd1511,20150702,3901,3894,3937,3937,3865,3897,3889,3,-5,30,1166780,190
836,jd1511,20150703,3897,3889,3904,3914,3895,3903,3905,14,16,12,468660,182
837,jd1511,20150706,3903,3905,3863,3886,3860,3863,3865,-42,-40,16,618400,176
838,jd1511,20150707,3863,3865,3899,3910,3850,3850,3891,-15,26,24,934020,182
839,jd1511,20150708,3850,3891,3800,3800,3727,3727,3747,-164,-144,18,674580,190
840,jd1511,20150709,3727,3747,3773,3934,3773,3850,3882,103,135,40,1553020,192
841,jd1511,20150710,3850,3882,3903,3961,3864,3928,3916,46,34,44,1723320,196
842,jd1511,20150713,3928,3916,3980,3989,3930,3967,3972,51,56,36,1430080,204
843,jd1511,20150714,3967,3972,4080,4080,3960,4004,4030,32,58,32,1289820,216
844,jd1511,20150715,4004,4030,3961,4000,3961,3999,3975,-31,-55,30,1192700,212
845,jd1511,20150716,3999,3975,3998,3998,3961,3998,3990,23,15,28,1117240,216
846,jd1511,20150717,3998,3990,3963,3997,3963,3997,3980,7,-10,12,477680,208
847,jd1511,20150720,3997,3980,4000,4028,3997,4003,4014,23,34,14,561980,212
848,jd1511,20150721,4003,4014,4023,4097,4023,4069,4042,55,28,48,1940460,234
849,jd1511,20150722,4069,4042,4086,4090,4030,4030,4076,-12,34,16,652180,236
850,jd1511,20150723,4030,4076,3961,4147,3961,4088,4069,12,-7,50,2034500,248
851,jd1511,20150724,4088,4069,4100,4119,4061,4073,4086,4,17,42,1716460,258
852,jd1511,20150727,4073,4086,4119,4119,4035,4079,4062,-7,-24,28,1137360,262
853,jd1511,20150728,4079,4062,4025,4083,4010,4080,4055,18,-7,18,729920,258
854,jd1511,20150729,4080,4055,4114,4114,4081,4110,4096,55,41,12,491560,258
855,jd1511,20150730,4110,4096,4119,4120,4060,4060,4098,-36,2,16,655740,260
856,jd1511,20150731,4060,4098,4059,4123,4050,4095,4083,-3,-15,86,3511620,296
857,jd1511,20150803,4095,4083,4090,4111,4057,4078,4079,-5,-4,34,1386860,304
858,jd1511,20150804,4078,4079,4096,4098,4066,4077,4080,-2,1,22,897760,298
859,jd1511,20150805,4077,4080,4016,4032,3936,4001,3998,-79,-82,80,3199140,294
860,jd1511,20150806,4001,3998,0,0,0,3998,3998,0,0,0,0,294
861,jd1511,20150807,3998,3998,3943,3988,3918,3920,3946,-78,-52,102,4025880,244
862,jd1511,20150810,3920,3946,3984,3989,3984,3989,3985,43,39,16,637740,242
863,jd1511,20150811,3989,3985,3995,3995,3995,3995,3995,10,10,2,79900,242
864,jd1511,20150812,3995,3995,0,0,0,3995,3995,0,0,0,0,242
865,jd1511,20150813,3995,3995,3982,4040,3982,4029,4017,34,22,30,1205120,230
866,jd1511,20150814,4029,4017,4055,4056,4026,4026,4045,9,28,14,566300,222
867,jd1511,20150817,4026,4045,4014,4015,4014,4015,4014,-30,-31,4,160580,222
868,jd1511,20150818,4015,4014,3908,4043,3815,3988,3956,-26,-58,96,3798540,210
869,jd1511,20150819,3988,3956,3968,3986,3945,3986,3970,30,14,22,873500,206
870,jd1511,20150820,3986,3970,0,0,0,3970,3970,0,0,0,0,206
871,jd1511,20150821,3970,3970,3961,3983,3961,3983,3970,13,0,12,476440,206
872,jd1511,20150824,3983,3970,3950,3950,3895,3917,3912,-53,-58,32,1252080,188
873,jd1511,20150825,3917,3912,3955,3967,3925,3947,3942,35,30,22,867420,178
874,jd1511,20150826,3947,3942,3902,3902,3890,3890,3900,-52,-42,18,702040,162
875,jd1511,20150827,3890,3900,3918,3918,3908,3909,3911,9,11,6,234700,164
876,jd1511,20150828,3909,3911,3950,3950,3901,3910,3919,-1,8,42,1646140,160
877,jd1511,20150831,3910,3919,3851,3896,3851,3867,3870,-52,-49,66,2554280,170
878,jd1511,20150901,3867,3870,3918,3944,3821,3840,3861,-30,-9,40,1544600,160
879,jd1511,20150902,3840,3861,3802,3802,3802,3802,3802,-59,-59,2,76040,162
880,jd1511,20150907,3802,3802,3835,3835,3835,3835,3835,33,33,2,76700,164
881,jd1511,20150908,3835,3835,3841,3841,3841,3841,3841,6,6,2,76820,164
882,jd1511,20150909,3841,3841,3801,3802,3800,3800,3800,-41,-41,8,304060,172
883,jd1511,20150910,3800,3800,3819,3819,3819,3819,3819,19,19,2,76380,172
884,jd1511,20150911,3819,3819,0,0,0,3819,3819,0,0,0,0,172
885,jd1511,20150914,3819,3819,3800,3800,3720,3784,3767,-35,-52,18,678080,164
886,jd1511,20150915,3784,3767,3778,3790,3761,3761,3776,-6,9,12,453160,156
887,jd1511,20150916,3761,3776,3754,3769,3754,3762,3760,-14,-16,8,300800,152
888,jd1511,20150917,3762,3760,3752,3760,3752,3760,3757,0,-3,6,225420,148
889,jd1511,20150918,3760,3757,3687,3756,3686,3733,3709,-24,-48,42,1557800,128
890,jd1511,20150921,3733,3709,3699,3738,3699,3738,3718,29,9,26,966860,116
891,jd1511,20150922,3738,3718,3699,3699,3681,3681,3690,-37,-28,4,147600,112
892,jd1511,20150923,3681,3690,3631,3698,3630,3698,3661,8,-29,24,878800,108
893,jd1511,20150924,3698,3661,3720,3720,3696,3696,3703,35,42,12,444360,112
894,jd1511,20150925,3696,3703,0,0,0,3701,3701,-2,-2,0,0,112
895,jd1511,20150928,3701,3701,3681,3698,3608,3698,3680,-3,-21,18,662520,108
896,jd1511,20150929,3698,3680,3675,3679,3636,3636,3656,-44,-24,12,438800,108
897,jd1511,20150930,3636,3656,3522,3535,3509,3510,3517,-146,-139,32,1125700,108
898,jd1511,20151008,3510,3517,3539,3539,3435,3435,3511,-82,-6,14,491620,102
899,jd1511,20151009,3435,3511,3441,3452,3441,3452,3446,-59,-65,4,137860,100
900,jd1511,20151012,3452,3446,3424,3424,3301,3376,3351,-70,-95,18,603340,92
901,jd1511,20151013,3376,3351,3203,3477,3203,3329,3332,-22,-19,72,2399220,84
902,jd1511,20151014,3329,3332,0,0,0,3325,3325,-7,-7,0,0,84
903,jd1511,20151015,3325,3325,3332,3338,3332,3338,3333,13,8,10,333380,80
904,jd1511,20151016,3338,3333,3289,3289,3289,3289,3289,-44,-44,2,65780,82
905,jd1511,20151019,3289,3289,3200,3324,3200,3286,3249,-3,-40,24,779880,80
906,jd1511,20151020,3286,3249,3299,3300,3299,3300,3299,51,50,6,197980,78
907,jd1511,20151021,3300,3299,3290,3332,3290,3332,3311,33,12,4,132440,76
908,jd1511,20151022,3332,3311,0,0,0,3311,3311,0,0,0,0,76
909,jd1511,20151023,3311,3311,3339,3339,3300,3300,3319,-11,8,4,132780,72
910,jd1511,20151026,3300,3319,3281,3281,3165,3222,3214,-97,-105,32,1028540,64
911,jd1511,20151027,3222,3214,3191,3191,3121,3160,3145,-54,-69,22,692040,62
912,jd1511,20151028,3160,3145,3119,3179,3115,3125,3129,-20,-16,26,813660,54
913,jd1511,20151029,3125,3129,3125,3149,3050,3107,3109,-22,-20,60,1865580,38
914,jd1511,20151030,3107,3109,3000,3062,3000,3000,3033,-109,-76,42,1273960,38
915,jd1511,20151102,3000,3033,3050,3070,3050,3070,3061,37,28,14,428600,30
916,jd1511,20151103,3070,3061,0,0,0,3061,3061,0,0,0,0,30
917,jd1511,20151104,3061,3061,0,0,0,3061,3061,0,0,0,0,30
918,jd1511,20151105,3061,3061,0,0,0,3070,3070,9,9,0,0,30
919,jd1511,20151106,3070,3070,0,0,0,3070,3070,0,0,0,0,30
920,jd1511,20151109,3070,3070,3051,3051,3051,3051,3051,-19,-19,6,183060,24
921,jd1511,20151110,3051,3051,3050,3050,3050,3050,3050,-1,-1,2,61000,22
922,jd1511,20151111,3050,3050,0,0,0,3050,3050,0,0,0,0,22
923,jd1511,20151112,3050,3050,0,0,0,3050,3050,0,0,0,0,22
924,jd1511,20151113,3050,3050,0,0,0,3057,3057,7,7,0,0,0
925,jd1512,20150105,4400,4400,4444,4444,4444,4444,4444,44,44,2,88880,2
926,jd1512,20150106,4444,4444,0,0,0,4390,4390,-54,-54,0,0,2
927,jd1512,20150107,4390,4390,0,0,0,4390,4390,0,0,0,0,2
928,jd1512,20150108,4390,4390,0,0,0,4390,4390,0,0,0,0,2
929,jd1512,20150109,4390,4390,4440,4440,4440,4440,4440,50,50,4,177600,6
930,jd1512,20150112,4440,4440,4351,4415,4351,4415,4383,-25,-57,4,175320,8
931,jd1512,20150113,4415,4383,0,0,0,4383,4383,0,0,0,0,8
932,jd1512,20150114,4383,4383,0,0,0,4374,4374,-9,-9,0,0,8
933,jd1512,20150115,4374,4374,4334,4338,4311,4311,4327,-63,-47,6,259660,12
934,jd1512,20150116,4311,4327,4256,4260,4230,4230,4245,-97,-82,22,934040,24
935,jd1512,20150119,4230,4245,4250,4298,4250,4298,4273,53,28,12,512820,12
936,jd1512,20150120,4298,4273,4288,4288,4288,4288,4288,15,15,2,85760,12
937,jd1512,20150121,4288,4288,0,0,0,4288,4288,0,0,0,0,12
938,jd1512,20150122,4288,4288,4234,4234,4203,4203,4218,-85,-70,8,337460,18
939,jd1512,20150123,4203,4218,4217,4217,4217,4217,4217,-1,-1,4,168680,22
940,jd1512,20150126,4217,4217,0,0,0,4200,4200,-17,-17,0,0,22
941,jd1512,20150127,4200,4200,0,0,0,4200,4200,0,0,0,0,22
942,jd1512,20150128,4200,4200,0,0,0,4200,4200,0,0,0,0,22
943,jd1512,20150129,4200,4200,0,0,0,4200,4200,0,0,0,0,22
944,jd1512,20150130,4200,4200,4188,4188,4188,4188,4188,-12,-12,2,83760,20
945,jd1512,20150202,4188,4188,0,0,0,4188,4188,0,0,0,0,20
946,jd1512,20150203,4188,4188,0,0,0,4188,4188,0,0,0,0,20
947,jd1512,20150204,4188,4188,0,0,0,4188,4188,0,0,0,0,20
948,jd1512,20150205,4188,4188,0,0,0,4188,4188,0,0,0,0,20
949,jd1512,20150206,4188,4188,0,0,0,4188,4188,0,0,0,0,20
950,jd1512,20150209,4188,4188,4147,4190,4147,4189,4175,1,-13,6,250520,20
951,jd1512,20150210,4189,4175,4141,4141,4141,4141,4141,-34,-34,2,82820,20
952,jd1512,20150211,4141,4141,4211,4211,4211,4211,4211,70,70,4,168440,16
953,jd1512,20150212,4211,4211,0,0,0,4168,4168,-43,-43,0,0,16
954,jd1512,20150213,4168,4168,4165,4165,4165,4165,4165,-3,-3,8,333200,12
955,jd1512,20150216,4165,4165,4111,4111,4111,4111,4111,-54,-54,2,82220,12
956,jd1512,20150217,4111,4111,4178,4192,4178,4192,4188,81,77,12,502600,20
957,jd1512,20150225,4192,4188,4217,4217,4217,4217,4217,29,29,2,84340,20
958,jd1512,20150226,4217,4217,0,0,0,4217,4217,0,0,0,0,20
959,jd1512,20150227,4217,4217,4201,4203,4201,4203,4202,-14,-15,8,336200,22
960,jd1512,20150302,4203,4202,4208,4241,4208,4241,4231,39,29,14,592420,14
961,jd1512,20150303,4241,4231,0,0,0,4231,4231,0,0,0,0,14
962,jd1512,20150304,4231,4231,0,0,0,4231,4231,0,0,0,0,14
963,jd1512,20150305,4231,4231,0,0,0,4231,4231,0,0,0,0,14
964,jd1512,20150306,4231,4231,0,0,0,4231,4231,0,0,0,0,14
965,jd1512,20150309,4231,4231,4173,4173,4173,4173,4173,-58,-58,6,250380,8
966,jd1512,20150310,4173,4173,0,0,0,4173,4173,0,0,0,0,8
967,jd1512,20150311,4173,4173,4249,4249,4249,4249,4249,76,76,4,169960,8
968,jd1512,20150312,4249,4249,0,0,0,4249,4249,0,0,0,0,8
969,jd1512,20150313,4249,4249,0,0,0,4249,4249,0,0,0,0,8
970,jd1512,20150316,4249,4249,0,0,0,4249,4249,0,0,0,0,8
971,jd1512,20150317,4249,4249,0,0,0,4249,4249,0,0,0,0,8
972,jd1512,20150318,4249,4249,4214,4214,4214,4214,4214,-35,-35,2,84280,8
973,jd1512,20150319,4214,4214,0,0,0,4214,4214,0,0,0,0,8
974,jd1512,20150320,4214,4214,0,0,0,4214,4214,0,0,0,0,8
975,jd1512,20150323,4214,4214,0,0,0,4122,4122,-92,-92,0,0,8
976,jd1512,20150324,4122,4122,0,0,0,4138,4138,16,16,0,0,8
977,jd1512,20150325,4138,4138,0,0,0,4138,4138,0,0,0,0,8
978,jd1512,20150326,4138,4138,0,0,0,4138,4138,0,0,0,0,8
979,jd1512,20150327,4138,4138,4197,4287,4197,4287,4242,149,104,4,169680,8
980,jd1512,20150330,4287,4242,4326,4326,4326,4326,4326,84,84,6,259560,12
981,jd1512,20150331,4326,4326,0,0,0,4326,4326,0,0,0,0,12
982,jd1512,20150401,4326,4326,0,0,0,4326,4326,0,0,0,0,12
983,jd1512,20150402,4326,4326,0,0,0,4238,4238,-88,-88,0,0,12
984,jd1512,20150403,4238,4238,0,0,0,4188,4188,-50,-50,0,0,12
985,jd1512,20150407,4188,4188,4040,4106,4000,4054,4038,-134,-150,18,726960,6
986,jd1512,20150408,4054,4038,0,0,0,4044,4044,6,6,0,0,6
987,jd1512,20150409,4044,4044,4086,4145,4086,4107,4107,63,63,22,903600,20
988,jd1512,20150410,4107,4107,4161,4161,4161,4161,4161,54,54,6,249660,14
989,jd1512,20150413,4161,4161,0,0,0,4161,4161,0,0,0,0,14
990,jd1512,20150414,4161,4161,4143,4143,4143,4143,4143,-18,-18,4,165720,18
991,jd1512,20150415,4143,4143,0,0,0,4077,4077,-66,-66,0,0,18
992,jd1512,20150416,4077,4077,0,0,0,4102,4102,25,25,0,0,18
993,jd1512,20150417,4102,4102,0,0,0,4157,4157,55,55,0,0,18
994,jd1512,20150420,4157,4157,0,0,0,4155,4155,-2,-2,0,0,18
995,jd1512,20150421,4155,4155,4171,4173,4129,4129,4163,-26,8,14,582840,6
996,jd1512,20150422,4129,4163,0,0,0,4207,4207,44,44,0,0,6
997,jd1512,20150423,4207,4207,0,0,0,4207,4207,0,0,0,0,6
998,jd1512,20150424,4207,4207,4214,4214,4214,4214,4214,7,7,2,84280,8
999,jd1512,20150427,4214,4214,4188,4188,4188,4188,4188,-26,-26,6,251280,14
1000,jd1512,20150428,4188,4188,4234,4234,4234,4234,4234,46,46,2,84680,12
1001,jd1512,20150429,4234,4234,0,0,0,4234,4234,0,0,0,0,12
1002,jd1512,20150430,4234,4234,0,0,0,4229,4229,-5,-5,0,0,12
1003,jd1512,20150504,4229,4229,4176,4176,4176,4176,4176,-53,-53,2,83520,12
1004,jd1512,20150505,4176,4176,0,0,0,4199,4199,23,23,0,0,12
1005,jd1512,20150506,4199,4199,4275,4275,4275,4275,4275,76,76,2,85500,12
1006,jd1512,20150507,4275,4275,0,0,0,4262,4262,-13,-13,0,0,12
1007,jd1512,20150508,4262,4262,0,0,0,4202,4202,-60,-60,0,0,12
1008,jd1512,20150511,4202,4202,4277,4277,4175,4175,4251,-27,49,8,340120,12
1009,jd1512,20150512,4175,4251,4242,4242,4200,4200,4214,-51,-37,6,252840,14
1010,jd1512,20150513,4200,4214,0,0,0,4147,4147,-67,-67,0,0,14
1011,jd1512,20150514,4147,4147,0,0,0,4147,4147,0,0,0,0,14
1012,jd1512,20150515,4147,4147,0,0,0,4187,4187,40,40,0,0,14
1013,jd1512,20150518,4187,4187,4239,4239,4238,4238,4238,51,51,6,254320,18
1014,jd1512,20150519,4238,4238,0,0,0,4236,4236,-2,-2,0,0,18
1015,jd1512,20150520,4236,4236,4124,4182,4124,4180,4169,-56,-67,10,416920,14
1016,jd1512,20150521,4180,4169,0,0,0,4169,4169,0,0,0,0,14
1017,jd1512,20150522,4169,4169,4163,4169,4163,4169,4166,0,-3,4,166640,14
1018,jd1512,20150525,4169,4166,0,0,0,4145,4145,-21,-21,0,0,14
1019,jd1512,20150526,4145,4145,4128,4128,4128,4128,4128,-17,-17,2,82560,14
1020,jd1512,20150527,4128,4128,4106,4106,4098,4098,4100,-30,-28,6,246040,18
1021,jd1512,20150528,4098,4100,0,0,0,4100,4100,0,0,0,0,18
1022,jd1512,20150529,4100,4100,4157,4157,4157,4157,4157,57,57,2,83140,20
1023,jd1512,20150601,4157,4157,4151,4151,4148,4148,4150,-9,-7,6,249000,24
1024,jd1512,20150602,4148,4150,0,0,0,4149,4149,-1,-1,0,0,24
1025,jd1512,20150603,4149,4149,4114,4114,4114,4114,4114,-35,-35,2,82280,26
1026,jd1512,20150604,4114,4114,4082,4092,4082,4092,4087,-22,-27,4,163480,30
1027,jd1512,20150605,4092,4087,4116,4116,4116,4116,4116,29,29,4,164640,34
1028,jd1512,20150608,4116,4116,0,0,0,4116,4116,0,0,0,0,34
1029,jd1512,20150609,4116,4116,0,0,0,4117,4117,1,1,0,0,34
1030,jd1512,20150610,4117,4117,0,0,0,4145,4145,28,28,0,0,34
1031,jd1512,20150611,4145,4145,0,0,0,4172,4172,27,27,0,0,34
1032,jd1512,20150612,4172,4172,4076,4076,4075,4075,4075,-97,-97,4,163020,34
1033,jd1512,20150615,4075,4075,4060,4060,4060,4060,4060,-15,-15,2,81200,32
1034,jd1512,20150616,4060,4060,0,0,0,4060,4060,0,0,0,0,32
1035,jd1512,20150617,4060,4060,4049,4064,4031,4031,4045,-29,-15,14,566400,34
1036,jd1512,20150618,4031,4045,3997,4059,3996,4046,4023,1,-22,46,1850980,40
1037,jd1512,20150619,4046,4023,3962,3962,3962,3962,3962,-61,-61,4,158480,40
1038,jd1512,20150623,3962,3962,0,0,0,3964,3964,2,2,0,0,40
1039,jd1512,20150624,3964,3964,4042,4077,4036,4041,4060,77,96,24,974480,36
1040,jd1512,20150625,4041,4060,4115,4119,4112,4119,4114,59,54,10,411480,36
1041,jd1512,20150626,4119,4114,4106,4106,4106,4106,4106,-8,-8,2,82120,36
1042,jd1512,20150629,4106,4106,0,0,0,4106,4106,0,0,0,0,36
1043,jd1512,20150630,4106,4106,4070,4070,4070,4070,4070,-36,-36,6,244200,34
1044,jd1512,20150701,4070,4070,0,0,0,4070,4070,0,0,0,0,34
1045,jd1512,20150702,4070,4070,0,0,0,4070,4070,0,0,0,0,34
1046,jd1512,20150703,4070,4070,0,0,0,4109,4109,39,39,0,0,34
1047,jd1512,20150706,4109,4109,4105,4105,4085,4090,4093,-19,-16,16,655000,46
1048,jd1512,20150707,4090,4093,4044,4044,4044,4044,4044,-49,-49,4,161760,44
1049,jd1512,20150708,4044,4044,3911,3929,3871,3871,3896,-173,-148,12,467580,42
1050,jd1512,20150709,3871,3896,3871,4040,3871,4040,4001,144,105,10,400180,42
1051,jd1512,20150710,4040,4001,4070,4149,4047,4100,4102,99,101,16,656380,38
1052,jd1512,20150713,4100,4102,0,0,0,4160,4160,58,58,0,0,38
1053,jd1512,20150714,4160,4160,0,0,0,4220,4220,60,60,0,0,38
1054,jd1512,20150715,4220,4220,0,0,0,4163,4163,-57,-57,0,0,38
1055,jd1512,20150716,4163,4163,0,0,0,4163,4163,0,0,0,0,38
1056,jd1512,20150717,4163,4163,0,0,0,4163,4163,0,0,0,0,38
1057,jd1512,20150720,4163,4163,0,0,0,4163,4163,0,0,0,0,38
1058,jd1512,20150721,4163,4163,0,0,0,4163,4163,0,0,0,0,38
1059,jd1512,20150722,4163,4163,0,0,0,4163,4163,0,0,0,0,38
1060,jd1512,20150723,4163,4163,0,0,0,4163,4163,0,0,0,0,38
1061,jd1512,20150724,4163,4163,4200,4200,4200,4200,4200,37,37,4,168000,38
1062,jd1512,20150727,4200,4200,4153,4196,4091,4091,4146,-109,-54,6,248800,36
1063,jd1512,20150728,4091,4146,4180,4209,4099,4209,4162,63,16,6,249760,36
1064,jd1512,20150729,4209,4162,0,0,0,4162,4162,0,0,0,0,36
1065,jd1512,20150730,4162,4162,0,0,0,4162,4162,0,0,0,0,36
1066,jd1512,20150731,4162,4162,0,0,0,4162,4162,0,0,0,0,36
1067,jd1512,20150803,4162,4162,0,0,0,4162,4162,0,0,0,0,36
1068,jd1512,20150804,4162,4162,0,0,0,4162,4162,0,0,0,0,36
1069,jd1512,20150805,4162,4162,4102,4119,4044,4119,4077,-43,-85,40,1630900,52
1070,jd1512,20150806,4119,4077,4093,4094,4077,4077,4088,0,11,6,245280,48
1071,jd1512,20150807,4077,4088,4071,4078,4001,4045,4043,-43,-45,32,1294000,30
1072,jd1512,20150810,4045,4043,0,0,0,4067,4067,24,24,0,0,30
1073,jd1512,20150811,4067,4067,4128,4128,4128,4128,4128,61,61,2,82560,28
1074,jd1512,20150812,4128,4128,0,0,0,4114,4114,-14,-14,0,0,28
1075,jd1512,20150813,4114,4114,0,0,0,4100,4100,-14,-14,0,0,28
1076,jd1512,20150814,4100,4100,0,0,0,4100,4100,0,0,0,0,28
1077,jd1512,20150817,4100,4100,4112,4112,4112,4112,4112,12,12,2,82240,30
1078,jd1512,20150818,4112,4112,4031,4031,4031,4031,4031,-81,-81,2,80620,32
1079,jd1512,20150819,4031,4031,4021,4042,4009,4042,4024,11,-7,6,241440,32
1080,jd1512,20150820,4042,4024,0,0,0,4024,4024,0,0,0,0,32
1081,jd1512,20150821,4024,4024,0,0,0,4024,4024,0,0,0,0,32
1082,jd1512,20150824,4024,4024,3959,3979,3959,3979,3969,-45,-55,4,158760,28
1083,jd1512,20150825,3979,3969,4038,4038,4038,4038,4038,69,69,2,80760,28
1084,jd1512,20150826,4038,4038,3961,4229,3940,3940,3997,-98,-41,12,479640,24
1085,jd1512,20150827,3940,3997,3950,3962,3919,3948,3944,-49,-53,18,709980,32
1086,jd1512,20150828,3948,3944,4020,4049,3927,3927,3955,-17,11,18,712060,30
1087,jd1512,20150831,3927,3955,0,0,0,3929,3929,-26,-26,0,0,30
1088,jd1512,20150901,3929,3929,3931,3931,3931,3931,3931,2,2,2,78620,32
1089,jd1512,20150902,3931,3931,3930,3930,3851,3915,3881,-16,-50,10,388180,32
1090,jd1512,20150907,3915,3881,0,0,0,3881,3881,0,0,0,0,32
1091,jd1512,20150908,3881,3881,3904,3904,3904,3904,3904,23,23,2,78080,30
1092,jd1512,20150909,3904,3904,3972,3972,3972,3972,3972,68,68,2,79440,28
1093,jd1512,20150910,3972,3972,3938,3939,3934,3934,3936,-38,-36,10,393680,32
1094,jd1512,20150911,3934,3936,0,0,0,3936,3936,0,0,0,0,32
1095,jd1512,20150914,3936,3936,3853,3856,3830,3856,3840,-80,-96,30,1152100,52
1096,jd1512,20150915,3856,3840,3828,3830,3805,3805,3819,-35,-21,16,611060,50
1097,jd1512,20150916,3805,3819,3752,3780,3752,3780,3766,-39,-53,12,451940,44
1098,jd1512,20150917,3780,3766,3808,3808,3711,3711,3759,-55,-7,4,150380,44
1099,jd1512,20150918,3711,3759,3750,3750,3750,3750,3750,-9,-9,2,75000,42
1100,jd1512,20150921,3750,3750,3762,3762,3762,3762,3762,12,12,2,75240,40
1101,jd1512,20150922,3762,3762,3748,3748,3747,3747,3747,-15,-15,4,149900,38
1102,jd1512,20150923,3747,3747,3701,3724,3701,3715,3714,-32,-33,14,520040,38
1103,jd1512,20150924,3715,3714,3698,3698,3698,3698,3698,-16,-16,4,147920,38
1104,jd1512,20150925,3698,3698,3702,3702,3702,3702,3702,4,4,4,148080,38
1105,jd1512,20150928,3702,3702,3668,3689,3668,3689,3682,-13,-20,6,220920,36
1106,jd1512,20150929,3689,3682,3618,3618,3618,3618,3618,-64,-64,2,72360,38
1107,jd1512,20150930,3618,3618,3618,3618,3606,3616,3614,-2,-4,12,433740,40
1108,jd1512,20151008,3616,3614,3635,3759,3604,3604,3718,-10,104,48,1784940,78
1109,jd1512,20151009,3604,3718,3562,3644,3562,3626,3604,-92,-114,58,2090500,76
1110,jd1512,20151012,3626,3604,3626,3626,3461,3488,3485,-116,-119,102,3555700,60
1111,jd1512,20151013,3488,3485,3481,3491,3471,3487,3484,2,-1,46,1602940,58
1112,jd1512,20151014,3487,3484,3498,3499,3477,3495,3494,11,10,16,559120,50
1113,jd1512,20151015,3495,3494,3498,3504,3498,3500,3501,6,7,10,350100,50
1114,jd1512,20151016,3500,3501,3500,3506,3496,3496,3500,-5,-1,8,280040,46
1115,jd1512,20151019,3496,3500,3481,3481,3479,3479,3480,-21,-20,4,139200,44
1116,jd1512,20151020,3479,3480,3469,3475,3469,3471,3471,-9,-9,6,208300,40
1117,jd1512,20151021,3471,3471,3488,3489,3477,3477,3484,6,13,6,209080,36
1118,jd1512,20151022,3477,3484,3421,3483,3421,3483,3462,-1,-22,6,207720,38
1119,jd1512,20151023,3483,3462,3496,3498,3496,3498,3497,36,35,6,209820,36
1120,jd1512,20151026,3498,3497,3495,3496,3477,3478,3486,-19,-11,8,278920,36
1121,jd1512,20151027,3478,3486,3460,3460,3460,3460,3460,-26,-26,2,69200,36
1122,jd1512,20151028,3460,3460,0,0,0,3444,3444,-16,-16,0,0,36
1123,jd1512,20151029,3444,3444,3376,3377,3298,3336,3343,-108,-101,14,468100,36
1124,jd1512,20151030,3336,3343,3250,3322,3250,3259,3268,-84,-75,12,392180,36
1125,jd1512,20151102,3259,3268,3257,3257,3116,3250,3205,-18,-63,8,256440,36
1126,jd1512,20151103,3250,3205,0,0,0,3205,3205,0,0,0,0,36
1127,jd1512,20151104,3205,3205,0,0,0,3260,3260,55,55,0,0,36
1128,jd1512,20151105,3260,3260,3235,3299,3235,3299,3251,39,-9,8,260120,34
1129,jd1512,20151106,3299,3251,3309,3374,3309,3360,3348,109,97,10,334860,32
1130,jd1512,20151109,3360,3348,3410,3410,3389,3410,3403,62,55,6,204180,28
1131,jd1512,20151110,3410,3403,3388,3400,3388,3400,3396,-3,-7,6,203760,28
1132,jd1512,20151111,3400,3396,3380,3507,3377,3400,3410,4,14,16,545700,22
1133,jd1512,20151112,3400,3410,3247,3410,3242,3410,3353,0,-57,60,2011940,18
1134,jd1512,20151113,3410,3353,3276,3402,3276,3402,3339,49,-14,4,133560,18
1135,jd1512,20151116,3402,3339,3301,3333,3301,3333,3317,-6,-22,4,132680,16
1136,jd1512,20151117,3333,3317,3170,3170,3170,3170,3170,-147,-147,2,63400,16
1137,jd1512,20151118,3170,3170,3278,3324,3278,3324,3312,154,142,8,264960,18
1138,jd1512,20151119,3324,3312,3420,3420,3306,3309,3324,-3,12,16,531880,12
1139,jd1512,20151120,3309,3324,3441,3441,3441,3441,3441,117,117,4,137640,10
1140,jd1512,20151123,3441,3441,3612,3612,3269,3597,3439,156,-2,32,1100520,10
1141,jd1512,20151124,3597,3439,0,0,0,3439,3439,0,0,0,0,10
1142,jd1512,20151125,3439,3439,3460,3460,3271,3271,3365,-168,-74,4,134620,6
1143,jd1512,20151126,3271,3365,0,0,0,3365,3365,0,0,0,0,6
1144,jd1512,20151127,3365,3365,0,0,0,3365,3365,0,0,0,0,6
1145,jd1512,20151130,3365,3365,3365,3365,3200,3200,3282,-165,-83,4,131300,2
1146,jd1512,20151201,3200,3282,3360,3360,3360,3360,3360,78,78,2,67200,2
1147,jd1512,20151202,3360,3360,0,0,0,3360,3360,0,0,0,0,2
1148,jd1512,20151203,3360,3360,0,0,0,3360,3360,0,0,0,0,2
1149,jd1512,20151204,3360,3360,0,0,0,3360,3360,0,0,0,0,2
1150,jd1512,20151207,3360,3360,0,0,0,3360,3360,0,0,0,0,2
1151,jd1512,20151208,3360,3360,3280,3280,3280,3280,3280,-80,-80,2,65600,2
1152,jd1512,20151209,3280,3280,0,0,0,3280,3280,0,0,0,0,2
1153,jd1512,20151210,3280,3280,0,0,0,3280,3280,0,0,0,0,2
1154,jd1512,20151211,3280,3280,0,0,0,3280,3280,0,0,0,0,2
1155,jd1512,20151214,3280,3280,0,0,0,3320,3320,40,40,0,0,0
1156,jd1601,20150119,4309,4309,4093,4163,4093,4125,4124,-184,-185,922,38025340,656
1157,jd1601,20150120,4125,4124,4129,4145,4123,4143,4132,19,8,284,11737580,836
1158,jd1601,20150121,4143,4132,4160,4163,4109,4109,4123,-23,-9,1434,59136920,1920
1159,jd1601,20150122,4109,4123,4111,4111,4094,4102,4100,-21,-23,840,34444120,2508
1160,jd1601,20150123,4102,4100,4103,4105,4089,4096,4097,-4,-3,562,23026360,2726
1161,jd1601,20150126,4096,4097,4100,4134,4092,4122,4107,25,10,854,35078900,3142
1162,jd1601,20150127,4122,4107,4122,4190,4122,4168,4162,61,55,1682,70011280,3610
1163,jd1601,20150128,4168,4162,4161,4171,4145,4164,4160,2,-2,834,34697460,3666
1164,jd1601,20150129,4164,4160,4161,4187,4146,4150,4162,-10,2,910,37876000,3538
1165,jd1601,20150130,4150,4162,4150,4166,4147,4166,4154,4,-8,668,27752500,3542
1166,jd1601,20150202,4166,4154,4153,4182,4146,4146,4161,-8,7,434,18059580,3774
1167,jd1601,20150203,4146,4161,4146,4163,4146,4155,4153,-6,-8,448,18608700,3914
1168,jd1601,20150204,4155,4153,4163,4182,4163,4170,4171,17,18,502,20942980,3792
1169,jd1601,20150205,4170,4171,4165,4191,4157,4163,4172,-8,1,888,37053580,3990
1170,jd1601,20150206,4163,4172,4172,4185,4161,4168,4171,-4,-1,816,34042260,4234
1171,jd1601,20150209,4168,4171,4183,4205,4144,4145,4159,-26,-12,1482,61639200,5002
1172,jd1601,20150210,4145,4159,4143,4148,4124,4127,4132,-32,-27,1106,45704240,5580
1173,jd1601,20150211,4127,4132,4120,4128,4112,4117,4120,-15,-12,1928,79434720,6008
1174,jd1601,20150212,4117,4120,4116,4120,4098,4100,4111,-20,-9,1330,54677360,6316
1175,jd1601,20150213,4100,4111,4100,4117,4092,4099,4103,-12,-8,1786,73290020,7000
1176,jd1601,20150216,4099,4103,4101,4116,4101,4108,4108,5,5,1110,45605120,7298
1177,jd1601,20150217,4108,4108,4105,4116,4100,4108,4108,0,0,1164,47826460,7602
1178,jd1601,20150225,4108,4108,4120,4140,4093,4136,4127,28,19,1808,74625680,7798
1179,jd1601,20150226,4136,4127,4140,4151,4133,4144,4142,17,15,1506,62379760,8106
1180,jd1601,20150227,4144,4142,4148,4184,4146,4183,4171,41,29,2218,92530020,8472
1181,jd1601,20150302,4183,4171,4177,4198,4172,4192,4181,21,10,1532,64060280,8576
1182,jd1601,20150303,4192,4181,4192,4194,4168,4183,4177,2,-4,1034,43197520,8306
1183,jd1601,20150304,4183,4177,4185,4203,4171,4188,4188,11,11,1766,73963880,8592
1184,jd1601,20150305,4188,4188,4188,4189,4170,4178,4178,-10,-10,1194,49890180,8560
1185,jd1601,20150306,4178,4178,4181,4188,4144,4145,4165,-33,-13,1702,70891720,8648
1186,jd1601,20150309,4145,4165,4165,4165,4132,4155,4150,-10,-15,1252,51960500,8290
1187,jd1601,20150310,4155,4150,4170,4177,4147,4162,4164,12,14,658,27404880,8272
1188,jd1601,20150311,4162,4164,4162,4186,4162,4183,4178,19,14,1186,49555300,8414
1189,jd1601,20150312,4183,4178,4185,4228,4185,4198,4206,20,28,2678,112649960,8902
1190,jd1601,20150313,4198,4206,4198,4209,4160,4175,4180,-31,-26,1502,62797960,9120
1191,jd1601,20150316,4175,4180,4175,4209,4173,4205,4194,25,14,1820,76337900,8792
1192,jd1601,20150317,4205,4194,4210,4212,4191,4198,4200,4,6,1162,48807380,8846
1193,jd1601,20150318,4198,4200,4190,4205,4188,4191,4196,-9,-4,1224,51371080,8934
1194,jd1601,20150319,4191,4196,4204,4229,4196,4200,4209,4,13,2332,98169580,9528
1195,jd1601,20150320,4200,4209,4200,4203,4185,4200,4192,-9,-17,1488,62387020,9186
1196,jd1601,20150323,4200,4192,4201,4238,4195,4234,4215,42,23,2294,96709900,9290
1197,jd1601,20150324,4234,4215,4245,4250,4227,4231,4236,16,21,1890,80069780,9330
1198,jd1601,20150325,4231,4236,4229,4231,4145,4170,4180,-66,-56,7450,311471380,10552
1199,jd1601,20150326,4170,4180,4175,4198,4161,4189,4187,9,7,3142,131561820,10268
1200,jd1601,20150327,4189,4187,4188,4196,4181,4196,4189,9,2,1764,73901300,10012
1201,jd1601,20150330,4196,4189,4194,4203,4181,4185,4191,-4,2,1182,49545240,10188
1202,jd1601,20150331,4185,4191,4182,4205,4165,4205,4186,14,-5,2874,120319320,9314
1203,jd1601,20150401,4205,4186,4208,4213,4184,4186,4194,0,8,2038,85488320,9378
1204,jd1601,20150402,4186,4194,4183,4187,4091,4110,4127,-84,-67,8188,337996900,11082
1205,jd1601,20150403,4110,4127,4105,4114,4052,4056,4080,-71,-47,3900,159142740,12120
1206,jd1601,20150407,4056,4080,4030,4030,3973,3983,3993,-97,-87,6330,252819820,13774
1207,jd1601,20150408,3983,3993,3990,4005,3978,3989,3987,-4,-6,2210,88112960,13972
1208,jd1601,20150409,3989,3987,3985,4005,3980,3993,3994,6,7,2688,107363180,13968
1209,jd1601,20150410,3993,3994,3993,4047,3993,4033,4019,39,25,4770,191750500,13238
1210,jd1601,20150413,4033,4019,4030,4049,4007,4049,4024,30,5,2356,94827120,13488
1211,jd1601,20150414,4049,4024,4045,4077,4025,4050,4059,26,35,4068,165143840,12962
1212,jd1601,20150415,4050,4059,4054,4064,4035,4060,4047,1,-12,2070,83781840,13346
1213,jd1601,20150416,4060,4047,4069,4083,4027,4048,4057,1,10,3528,143150740,13686
1214,jd1601,20150417,4048,4057,4047,4116,4042,4093,4075,36,18,3588,146222340,13306
1215,jd1601,20150420,4093,4075,4109,4138,4091,4092,4105,17,30,3886,159532880,13374
1216,jd1601,20150421,4092,4105,4092,4127,4082,4108,4106,3,1,3058,125567020,13332
1217,jd1601,20150422,4108,4106,4122,4130,4101,4117,4111,11,5,1896,77949180,12962
1218,jd1601,20150423,4117,4111,4117,4135,4095,4119,4116,8,5,2838,116834660,12428
1219,jd1601,20150424,4119,4116,4136,4148,4112,4147,4131,31,15,3762,155420860,12206
1220,jd1601,20150427,4147,4131,4155,4157,4121,4146,4141,15,10,3946,163439760,12496
1221,jd1601,20150428,4146,4141,4140,4209,4140,4175,4188,34,47,5310,222432840,12144
1222,jd1601,20150429,4175,4188,4175,4190,4165,4166,4174,-22,-14,2604,108702680,12244
1223,jd1601,20150430,4166,4174,4174,4177,4117,4148,4139,-26,-35,6352,262935080,13930
1224,jd1601,20150504,4148,4139,4140,4180,4140,4162,4167,23,28,6002,250113920,14342
1225,jd1601,20150505,4162,4167,4170,4203,4156,4190,4179,23,12,6096,254784320,14110
1226,jd1601,20150506,4190,4179,4186,4215,4185,4189,4195,10,16,3808,159780400,14140
1227,jd1601,20150507,4189,4195,4180,4208,4165,4185,4187,-10,-8,4048,169493200,14010
1228,jd1601,20150508,4185,4187,4184,4184,4111,4125,4151,-62,-36,6652,276166580,15644
1229,jd1601,20150511,4125,4151,4125,4125,4077,4091,4094,-60,-57,8830,361584400,17810
1230,jd1601,20150512,4091,4094,4076,4103,4076,4093,4091,-1,-3,4978,203686260,17984
1231,jd1601,20150513,4093,4091,4088,4108,4081,4091,4097,0,6,3928,160944380,18336
1232,jd1601,20150514,4091,4097,4091,4137,4041,4135,4105,38,8,7512,308369320,16958
1233,jd1601,20150515,4135,4105,4148,4166,4140,4166,4152,61,47,5486,227781520,16476
1234,jd1601,20150518,4166,4152,4193,4193,4151,4168,4171,16,19,4578,190980800,16460
1235,jd1601,20150519,4168,4171,4160,4163,4108,4112,4129,-59,-42,6648,274550560,17286
1236,jd1601,20150520,4112,4129,4110,4118,4070,4075,4095,-54,-34,6982,285978720,17212
1237,jd1601,20150521,4075,4095,4080,4109,4077,4089,4096,-6,1,5106,209184260,16966
1238,jd1601,20150522,4089,4096,4089,4120,4060,4110,4092,14,-4,6692,273870600,16782
1239,jd1601,20150525,4110,4092,4100,4100,4041,4052,4064,-40,-28,9012,366317600,18960
1240,jd1601,20150526,4052,4064,4081,4098,4058,4070,4077,6,13,6962,283870780,18400
1241,jd1601,20150527,4070,4077,4060,4118,4042,4114,4089,37,12,7578,309918280,18210
1242,jd1601,20150528,4114,4089,4125,4128,4100,4112,4111,23,22,4988,205079960,18242
1243,jd1601,20150529,4112,4111,4106,4110,4090,4107,4102,-4,-9,2808,115189820,17806
1244,jd1601,20150601,4107,4102,4100,4160,4097,4115,4139,13,37,10536,436180760,18464
1245,jd1601,20150602,4115,4139,4117,4129,4089,4120,4115,-19,-24,5074,208828040,19036
1246,jd1601,20150603,4120,4115,4130,4148,4105,4111,4129,-4,14,6302,260221340,19360
1247,jd1601,20150604,4111,4129,4106,4125,4072,4123,4105,-6,-24,9966,409126580,19810
1248,jd1601,20150605,4123,4105,4115,4162,4112,4135,4136,30,31,10472,433177860,19908
1249,jd1601,20150608,4135,4136,4131,4145,4100,4131,4131,-5,-5,5528,228413500,21330
1250,jd1601,20150609,4131,4131,4141,4176,4134,4161,4160,30,29,10144,422013660,23086
1251,jd1601,20150610,4161,4160,4175,4190,4132,4137,4155,-23,-5,8682,360753820,22562
1252,jd1601,20150611,4137,4155,4149,4176,4133,4141,4146,-14,-9,5374,222815460,22876
1253,jd1601,20150612,4141,4146,4126,4149,4080,4093,4112,-53,-34,11476,471903960,23114
1254,jd1601,20150615,4093,4112,4080,4095,4052,4087,4077,-25,-35,12298,501424680,23400
1255,jd1601,20150616,4087,4077,4094,4100,4077,4089,4088,12,11,4590,187647120,23046
1256,jd1601,20150617,4089,4088,4096,4105,4062,4071,4082,-17,-6,8910,363770620,23308
1257,jd1601,20150618,4071,4082,4076,4089,4057,4070,4070,-12,-12,5338,217272240,23564
1258,jd1601,20150619,4070,4070,4060,4097,4060,4078,4084,8,14,5850,238928700,23334
1259,jd1601,20150623,4078,4084,4096,4109,4083,4104,4096,20,12,6232,255275040,22772
1260,jd1601,20150624,4104,4096,4100,4122,4091,4105,4105,9,9,7018,288144100,21736
1261,jd1601,20150625,4105,4105,4108,4171,4107,4162,4150,57,45,11246,466797940,19998
1262,jd1601,20150626,4162,4150,4170,4172,4143,4158,4156,8,6,7116,295789800,19466
1263,jd1601,20150629,4158,4156,4152,4170,4134,4158,4150,2,-6,7142,296444820,18300
1264,jd1601,20150630,4158,4150,4160,4160,4092,4126,4115,-24,-35,9402,386951200,16990
1265,jd1601,20150701,4126,4115,4160,4213,4144,4165,4166,50,51,8292,345475480,17056
1266,jd1601,20150702,4165,4166,4160,4168,4125,4148,4140,-18,-26,5120,211987720,16814
1267,jd1601,20150703,4148,4140,4155,4198,4154,4194,4182,54,42,11388,476341700,19406
1268,jd1601,20150706,4194,4182,4199,4232,4145,4179,4185,-3,3,16602,694808120,19278
1269,jd1601,20150707,4179,4185,4181,4206,4165,4168,4188,-17,3,12464,522012800,19986
1270,jd1601,20150708,4168,4188,4065,4082,3979,3979,4013,-209,-175,24160,969690260,18344
1271,jd1601,20150709,3979,4013,4030,4193,4030,4140,4111,127,98,23272,956894860,16190
1272,jd1601,20150710,4140,4111,4170,4220,4150,4187,4186,76,75,25080,1050020220,17956
1273,jd1601,20150713,4187,4186,4192,4220,4179,4186,4189,0,3,11958,500953560,19662
1274,jd1601,20150714,4186,4189,4195,4317,4184,4255,4247,66,58,39198,1664971800,25150
1275,jd1601,20150715,4255,4247,4245,4267,4228,4264,4244,17,-3,14878,631560780,26938
1276,jd1601,20150716,4264,4244,4243,4278,4228,4270,4258,26,14,24668,1050469820,30474
1277,jd1601,20150717,4270,4258,4240,4274,4220,4251,4245,-7,-13,20874,886152820,28950
1278,jd1601,20150720,4251,4245,4245,4305,4235,4290,4270,45,25,25936,1107532980,34602
1279,jd1601,20150721,4290,4270,4303,4355,4303,4334,4332,64,62,38144,1652740880,39934
1280,jd1601,20150722,4334,4332,4350,4350,4277,4300,4311,-32,-21,33376,1438947000,38804
1281,jd1601,20150723,4300,4311,4308,4326,4289,4321,4309,10,-2,29510,1271689920,39288
1282,jd1601,20150724,4321,4309,4329,4350,4280,4296,4302,-13,-7,27356,1177010380,39682
1283,jd1601,20150727,4296,4302,4281,4299,4185,4215,4233,-87,-69,42538,1800749900,38684
1284,jd1601,20150728,4215,4233,4210,4276,4180,4255,4243,22,10,53264,2260155660,44596
1285,jd1601,20150729,4255,4243,4261,4274,4201,4206,4230,-37,-13,41096,1738669660,46086
1286,jd1601,20150730,4206,4230,4210,4245,4185,4224,4217,-6,-13,42048,1773199120,47036
1287,jd1601,20150731,4224,4217,4227,4295,4226,4295,4263,78,46,56012,2387853340,55774
1288,jd1601,20150803,4295,4263,4293,4340,4260,4280,4299,17,36,87562,3764581640,57520
1289,jd1601,20150804,4280,4299,4290,4325,4281,4308,4307,9,8,59916,2580980000,63734
1290,jd1601,20150805,4308,4307,4319,4321,4202,4220,4252,-87,-55,100410,4269557000,60746
1291,jd1601,20150806,4220,4252,4220,4248,4160,4173,4217,-79,-35,77946,3287394560,62300
1292,jd1601,20150807,4173,4217,4150,4156,4057,4118,4110,-99,-107,119772,4923422800,55538
1293,jd1601,20150810,4118,4110,4125,4143,4091,4120,4121,10,11,54090,2229328380,59508
1294,jd1601,20150811,4120,4121,4136,4185,4120,4121,4152,0,31,97362,4043278500,63950
1295,jd1601,20150812,4121,4152,4112,4163,4105,4126,4138,-26,-14,66078,2734916480,67042
1296,jd1601,20150813,4126,4138,4112,4151,4091,4146,4126,8,-12,96136,3966730760,68226
1297,jd1601,20150814,4146,4126,4150,4193,4125,4127,4164,1,38,126850,5283001200,74570
1298,jd1601,20150817,4127,4164,4126,4140,4100,4120,4124,-44,-40,66580,2746242560,76898
1299,jd1601,20150818,4120,4124,4120,4137,4095,4098,4118,-26,-6,63886,2630906000,80566
1300,jd1601,20150819,4098,4118,4091,4145,4050,4137,4090,19,-28,117282,4797885240,80876
1301,jd1601,20150820,4137,4090,4135,4142,4072,4074,4108,-16,18,91428,3756463820,85874
1302,jd1601,20150821,4074,4108,4091,4105,4064,4069,4087,-39,-21,65770,2688633820,86904
1303,jd1601,20150824,4069,4087,4040,4050,3952,4013,4005,-74,-82,129436,5185149360,81528
1304,jd1601,20150825,4013,4005,4022,4070,3990,4019,4034,14,29,100700,4062277420,80416
1305,jd1601,20150826,4019,4034,4036,4044,3902,3923,3972,-111,-62,129628,5149478560,98984
1306,jd1601,20150827,3923,3972,3923,3960,3920,3942,3939,-30,-33,108958,4292428160,95714
1307,jd1601,20150828,3942,3939,3965,4046,3915,3923,3971,-16,32,179854,7143032260,106342
1308,jd1601,20150831,3923,3971,3924,3945,3883,3916,3917,-55,-54,129776,5083834260,109534
1309,jd1601,20150901,3916,3917,3922,3950,3910,3929,3926,12,9,87726,3444920300,111222
1310,jd1601,20150902,3929,3926,3921,3928,3880,3911,3904,-15,-22,115082,4493805160,112902
1311,jd1601,20150907,3911,3904,3939,3962,3909,3924,3934,20,30,110548,4350053000,121232
1312,jd1601,20150908,3924,3934,3924,3968,3924,3961,3945,27,11,115980,4576403500,124570
1313,jd1601,20150909,3961,3945,3985,3998,3915,3923,3953,-22,8,188574,7454728740,138622
1314,jd1601,20150910,3923,3953,3905,3963,3903,3935,3934,-18,-19,129686,5102312620,128960
1315,jd1601,20150911,3935,3934,3935,3957,3915,3950,3935,16,1,153620,6045576720,131566
1316,jd1601,20150914,3950,3935,3939,3966,3917,3927,3940,-8,5,173530,6838168520,128566
1317,jd1601,20150915,3927,3940,3925,3940,3852,3865,3921,-75,-19,123962,4861123400,128496
1318,jd1601,20150916,3865,3921,3876,3890,3840,3867,3863,-54,-58,187858,7257414180,136718
1319,jd1601,20150917,3867,3863,3880,3887,3844,3851,3859,-12,-4,110778,4275899100,145904
1320,jd1601,20150918,3851,3859,3854,3871,3830,3853,3853,-6,-6,125882,4850647140,145848
1321,jd1601,20150921,3853,3853,3858,3879,3850,3855,3863,2,10,115794,4473819020,140888
1322,jd1601,20150922,3855,3863,3858,3858,3797,3815,3819,-48,-44,173558,6628334980,154578
1323,jd1601,20150923,3815,3819,3808,3810,3779,3796,3797,-23,-22,98022,3722104440,152592
1324,jd1601,20150924,3796,3797,3794,3809,3780,3785,3793,-12,-4,84570,3208444120,157768
1325,jd1601,20150925,3785,3793,3791,3839,3791,3802,3814,9,21,156644,5975404200,145290
1326,jd1601,20150928,3802,3814,3808,3827,3758,3814,3806,0,-8,106408,4050150380,146030
1327,jd1601,20150929,3814,3806,3810,3818,3746,3766,3774,-40,-32,135862,5127814120,137242
1328,jd1601,20150930,3766,3774,3768,3779,3740,3749,3761,-25,-13,93502,3516809200,134586
1329,jd1601,20151008,3749,3761,3749,3808,3744,3762,3775,1,14,121204,4575992360,136474
1330,jd1601,20151009,3762,3775,3760,3800,3750,3780,3774,5,-1,130422,4922651640,136416
1331,jd1601,20151012,3780,3774,3750,3758,3681,3691,3708,-83,-66,216390,8024900300,166524
1332,jd1601,20151013,3691,3708,3687,3693,3662,3672,3673,-36,-35,117396,4312973080,175802
1333,jd1601,20151014,3672,3673,3688,3698,3666,3669,3679,-4,6,95138,3500477200,176582
1334,jd1601,20151015,3669,3679,3669,3696,3645,3683,3679,4,0,108724,4001038500,168386
1335,jd1601,20151016,3683,3679,3685,3702,3672,3675,3684,-4,5,94026,3464232740,163454
1336,jd1601,20151019,3675,3684,3683,3687,3616,3624,3650,-60,-34,107438,3921655980,174408
1337,jd1601,20151020,3624,3650,3630,3649,3629,3641,3638,-9,-12,51698,1881285660,163652
1338,jd1601,20151021,3641,3638,3646,3671,3621,3645,3648,7,10,87206,3181984160,158400
1339,jd1601,20151022,3645,3648,3659,3680,3650,3677,3665,29,17,88838,3256052060,154050
1340,jd1601,20151023,3677,3665,3674,3688,3640,3662,3663,-3,-2,100120,3667400440,150748
1341,jd1601,20151026,3662,3663,3661,3682,3653,3663,3664,0,1,61706,2261249640,153534
1342,jd1601,20151027,3663,3664,3659,3693,3626,3684,3659,20,-5,96184,3519577640,145034
1343,jd1601,20151028,3684,3659,3685,3699,3659,3669,3677,10,18,106390,3912815780,146904
1344,jd1601,20151029,3669,3677,3668,3670,3645,3665,3655,-12,-22,72312,2643321540,145196
1345,jd1601,20151030,3665,3655,3664,3675,3651,3655,3661,0,6,66000,2416588000,142984
1346,jd1601,20151102,3655,3661,3653,3670,3609,3664,3646,3,-15,92654,3378710320,140234
1347,jd1601,20151103,3664,3646,3661,3750,3656,3732,3700,86,54,192436,7121212140,138176
1348,jd1601,20151104,3732,3700,3733,3766,3722,3755,3749,55,49,122016,4574410160,139610
1349,jd1601,20151105,3755,3749,3756,3778,3742,3761,3762,12,13,112206,4221525760,131754
1350,jd1601,20151106,3761,3762,3765,3792,3745,3787,3767,25,5,115144,4338599280,124714
1351,jd1601,20151109,3787,3767,3791,3820,3751,3772,3776,5,9,104746,3955750540,122754
1352,jd1601,20151110,3772,3776,3766,3766,3720,3720,3738,-56,-38,83034,3104342760,114292
1353,jd1601,20151111,3720,3738,3720,3760,3703,3748,3735,10,-3,83060,3102361200,115820
1354,jd1601,20151112,3748,3735,3740,3800,3731,3797,3764,62,29,104078,3918336080,121352
1355,jd1601,20151113,3797,3764,3795,3807,3770,3789,3787,25,23,77528,2936058420,116228
1356,jd1601,20151116,3789,3787,3779,3784,3719,3720,3745,-67,-42,98956,3706807520,106036
1357,jd1601,20151117,3720,3745,3720,3731,3645,3686,3686,-59,-59,104142,3839042280,94130
1358,jd1601,20151118,3686,3686,3698,3698,3650,3679,3675,-7,-11,54524,2003825140,92664
1359,jd1601,20151119,3679,3675,3690,3716,3675,3688,3694,13,19,72430,2676154820,89310
1360,jd1601,20151120,3688,3694,3705,3800,3697,3793,3746,99,52,105466,3950821180,85908
1361,jd1601,20151123,3793,3746,3789,3848,3718,3754,3777,8,31,109090,4121191440,81138
1362,jd1601,20151124,3754,3777,3754,3792,3753,3779,3776,2,-1,50166,1894643180,80144
1363,jd1601,20151125,3779,3776,3771,3772,3660,3719,3711,-57,-65,108656,4033053440,74012
1364,jd1601,20151126,3719,3711,3715,3795,3703,3728,3739,17,28,64072,2395811080,69986
1365,jd1601,20151127,3728,3739,3716,3737,3693,3723,3715,-16,-24,41026,1524322980,64982
1366,jd1601,20151130,3723,3715,3736,3809,3725,3804,3776,89,61,55148,2082656740,60710
1367,jd1601,20151201,3804,3776,3810,3830,3763,3777,3794,1,18,37836,1435762100,49020
1368,jd1601,20151202,3777,3794,3795,3824,3780,3788,3796,-6,2,14846,563590920,46614
1369,jd1601,20151203,3788,3796,3783,3786,3766,3780,3777,-16,-19,9480,358089240,44740
1370,jd1601,20151204,3780,3777,3778,3782,3750,3767,3767,-10,-10,9100,342854180,43008
1371,jd1601,20151207,3767,3767,3770,3783,3761,3768,3771,1,4,8674,327157960,41750
1372,jd1601,20151208,3768,3771,3760,3770,3725,3765,3753,-6,-18,9230,346466600,39526
1373,jd1601,20151209,3765,3753,3760,3777,3746,3751,3755,-2,2,6374,239383480,36956
1374,jd1601,20151210,3751,3755,3740,3747,3680,3690,3710,-65,-45,15786,585664820,33200
1375,jd1601,20151211,3690,3710,3688,3710,3656,3694,3680,-16,-30,13000,478461760,30466
1376,jd1601,20151214,3694,3680,3680,3709,3667,3697,3694,17,14,8242,304539080,26944
1377,jd1601,20151215,3697,3694,3695,3719,3668,3684,3685,-10,-9,5088,187493020,25476
1378,jd1601,20151216,3684,3685,3673,3690,3672,3679,3681,-6,-4,2972,109420460,23866
1379,jd1601,20151217,3679,3681,3676,3692,3676,3679,3683,-2,2,3176,116972420,22248
1380,jd1601,20151218,3679,3683,3687,3713,3679,3711,3695,28,12,3754,138732200,20480
1381,jd1601,20151221,3711,3695,3710,3755,3709,3735,3727,40,32,6942,258773560,16554
1382,jd1601,20151222,3735,3727,3743,3762,3740,3758,3751,31,24,3724,139698620,14396
1383,jd1601,20151223,3758,3751,3765,3765,3726,3741,3748,-10,-3,1732,64919580,13430
1384,jd1601,20151224,3741,3748,3745,3760,3742,3753,3753,5,5,1170,43910220,12648
1385,jd1601,20151225,3753,3753,3757,3757,3730,3733,3740,-20,-13,1408,52672860,11670
1386,jd1601,20151228,3733,3740,3740,3740,3679,3681,3688,-59,-52,3832,141330520,8864
1387,jd1601,20151229,3681,3688,3690,3690,3665,3666,3671,-22,-17,3258,119627760,6420
1388,jd1601,20151230,3666,3671,3668,3688,3660,3678,3676,7,5,3440,126468520,3780
1389,jd1601,20151231,3678,3676,3678,3678,3600,3614,3645,-62,-31,4158,151576980,280
1390,jd1602,20150216,4111,4111,0,0,0,4111,4111,0,0,0,0,0
1391,jd1602,20150217,4111,4111,0,0,0,4111,4111,0,0,0,0,0
1392,jd1602,20150225,4111,4111,0,0,0,4111,4111,0,0,0,0,0
1393,jd1602,20150226,4111,4111,0,0,0,4120,4120,9,9,0,0,0
1394,jd1602,20150227,4120,4120,0,0,0,4124,4124,4,4,0,0,0
1395,jd1602,20150302,4124,4124,0,0,0,4124,4124,0,0,0,0,0
1396,jd1602,20150303,4124,4124,0,0,0,4151,4151,27,27,0,0,0
1397,jd1602,20150304,4151,4151,0,0,0,4151,4151,0,0,0,0,0
1398,jd1602,20150305,4151,4151,4298,4298,4298,4298,4298,147,147,4,171920,4
1399,jd1602,20150306,4298,4298,0,0,0,4290,4290,-8,-8,0,0,4
1400,jd1602,20150309,4290,4290,0,0,0,4279,4279,-11,-11,0,0,4
1401,jd1602,20150310,4279,4279,0,0,0,4279,4279,0,0,0,0,4
1402,jd1602,20150311,4279,4279,0,0,0,4279,4279,0,0,0,0,4
1403,jd1602,20150312,4279,4279,0,0,0,4279,4279,0,0,0,0,4
1404,jd1602,20150313,4279,4279,0,0,0,4279,4279,0,0,0,0,4
1405,jd1602,20150316,4279,4279,4248,4248,4248,4248,4248,-31,-31,2,84960,6
1406,jd1602,20150317,4248,4248,4217,4217,4217,4217,4217,-31,-31,2,84340,6
1407,jd1602,20150318,4217,4217,0,0,0,4217,4217,0,0,0,0,6
1408,jd1602,20150319,4217,4217,0,0,0,4217,4217,0,0,0,0,6
1409,jd1602,20150320,4217,4217,4214,4214,4138,4138,4188,-79,-29,6,251300,6
1410,jd1602,20150323,4138,4188,4122,4122,4122,4122,4122,-66,-66,2,82440,8
1411,jd1602,20150324,4122,4122,0,0,0,4122,4122,0,0,0,0,8
1412,jd1602,20150325,4122,4122,0,0,0,4068,4068,-54,-54,0,0,8
1413,jd1602,20150326,4068,4068,0,0,0,4068,4068,0,0,0,0,8
1414,jd1602,20150327,4068,4068,4000,4223,4000,4075,4170,7,102,14,583800,20
1415,jd1602,20150330,4075,4170,0,0,0,4162,4162,-8,-8,0,0,20
1416,jd1602,20150331,4162,4162,0,0,0,4162,4162,0,0,0,0,20
1417,jd1602,20150401,4162,4162,4162,4163,4130,4141,4145,-21,-17,12,497440,24
1418,jd1602,20150402,4141,4145,4110,4122,4006,4049,4081,-96,-64,20,816380,26
1419,jd1602,20150403,4049,4081,4083,4083,3992,3992,4020,-89,-61,10,402040,30
1420,jd1602,20150407,3992,4020,3921,3921,3907,3907,3911,-113,-109,6,234700,28
1421,jd1602,20150408,3907,3911,0,0,0,3911,3911,0,0,0,0,28
1422,jd1602,20150409,3911,3911,0,0,0,3911,3911,0,0,0,0,28
1423,jd1602,20150410,3911,3911,3961,3961,3922,3922,3941,11,30,12,472980,18
1424,jd1602,20150413,3922,3941,0,0,0,3941,3941,0,0,0,0,18
1425,jd1602,20150414,3941,3941,4029,4029,4000,4000,4021,59,80,8,321740,18
1426,jd1602,20150415,4000,4021,4020,4020,4000,4000,4013,-21,-8,6,240800,22
1427,jd1602,20150416,4000,4013,4030,4063,4030,4063,4048,50,35,20,809620,18
1428,jd1602,20150417,4063,4048,0,0,0,4048,4048,0,0,0,0,18
1429,jd1602,20150420,4048,4048,4094,4094,4086,4086,4088,38,40,6,245320,16
1430,jd1602,20150421,4086,4088,0,0,0,4088,4088,0,0,0,0,16
1431,jd1602,20150422,4088,4088,0,0,0,4088,4088,0,0,0,0,16
1432,jd1602,20150423,4088,4088,4100,4100,4100,4100,4100,12,12,8,328000,8
1433,jd1602,20150424,4100,4100,0,0,0,4100,4100,0,0,0,0,8
1434,jd1602,20150427,4100,4100,4078,4080,4078,4080,4079,-20,-21,4,163160,6
1435,jd1602,20150428,4080,4079,4136,4142,4017,4055,4071,-24,-8,70,2850180,36
1436,jd1602,20150429,4055,4071,4057,4057,4055,4055,4056,-16,-15,4,162240,32
1437,jd1602,20150430,4055,4056,4043,4099,4024,4090,4073,34,17,46,1873860,46
1438,jd1602,20150504,4090,4073,4087,4087,4087,4087,4087,14,14,4,163480,42
1439,jd1602,20150505,4087,4087,4084,4084,4084,4084,4084,-3,-3,20,816800,22
1440,jd1602,20150506,4084,4084,4212,4212,4082,4111,4134,27,50,22,909480,26
1441,jd1602,20150507,4111,4134,4065,4065,4065,4065,4065,-69,-69,2,81300,26
1442,jd1602,20150508,4065,4065,0,0,0,4031,4031,-34,-34,0,0,26
1443,jd1602,20150511,4031,4031,3961,4024,3956,4024,3994,-7,-37,10,399420,24
1444,jd1602,20150512,4024,3994,3980,3999,3980,3999,3986,5,-8,6,239180,30
1445,jd1602,20150513,3999,3986,4035,4072,4035,4072,4063,86,77,20,812740,28
1446,jd1602,20150514,4072,4063,4034,4099,4034,4099,4084,36,21,12,490120,18
1447,jd1602,20150515,4099,4084,4177,4177,4111,4111,4144,27,60,4,165760,18
1448,jd1602,20150518,4111,4144,0,0,0,4162,4162,18,18,0,0,18
1449,jd1602,20150519,4162,4162,4120,4120,4084,4084,4096,-78,-66,6,245760,20
1450,jd1602,20150520,4084,4096,4083,4083,4083,4083,4083,-13,-13,2,81660,20
1451,jd1602,20150521,4083,4083,0,0,0,4083,4083,0,0,0,0,20
1452,jd1602,20150522,4083,4083,4072,4072,4072,4072,4072,-11,-11,4,162880,16
1453,jd1602,20150525,4072,4072,4046,4046,3984,3984,4015,-88,-57,4,160600,16
1454,jd1602,20150526,3984,4015,4057,4060,4024,4060,4047,45,32,6,242820,16
1455,jd1602,20150527,4060,4047,0,0,0,4058,4058,11,11,0,0,16
1456,jd1602,20150528,4058,4058,0,0,0,4079,4079,21,21,0,0,16
1457,jd1602,20150529,4079,4079,0,0,0,4071,4071,-8,-8,0,0,16
1458,jd1602,20150601,4071,4071,0,0,0,4071,4071,0,0,0,0,16
1459,jd1602,20150602,4071,4071,0,0,0,4048,4048,-23,-23,0,0,16
1460,jd1602,20150603,4048,4048,4101,4109,4066,4066,4092,18,44,6,245520,16
1461,jd1602,20150604,4066,4092,0,0,0,4069,4069,-23,-23,0,0,16
1462,jd1602,20150605,4069,4069,0,0,0,4099,4099,30,30,0,0,16
1463,jd1602,20150608,4099,4099,4100,4109,4080,4085,4093,-14,-6,8,327480,18
1464,jd1602,20150609,4085,4093,4132,4143,4097,4143,4124,50,31,6,247440,18
1465,jd1602,20150610,4143,4124,4111,4111,4101,4101,4106,-23,-18,4,164240,18
1466,jd1602,20150611,4101,4106,0,0,0,4099,4099,-7,-7,0,0,18
1467,jd1602,20150612,4099,4099,0,0,0,4066,4066,-33,-33,0,0,18
1468,jd1602,20150615,4066,4066,4054,4054,4011,4011,4030,-55,-36,10,403060,18
1469,jd1602,20150616,4011,4030,4064,4064,3982,4049,4031,19,1,6,241900,20
1470,jd1602,20150617,4049,4031,0,0,0,4031,4031,0,0,0,0,20
1471,jd1602,20150618,4031,4031,0,0,0,4020,4020,-11,-11,0,0,20
1472,jd1602,20150619,4020,4020,0,0,0,4033,4033,13,13,0,0,20
1473,jd1602,20150623,4033,4033,0,0,0,4044,4044,11,11,0,0,20
1474,jd1602,20150624,4044,4044,0,0,0,4052,4052,8,8,0,0,20
1475,jd1602,20150625,4052,4052,0,0,0,4096,4096,44,44,0,0,20
1476,jd1602,20150626,4096,4096,4095,4095,4071,4080,4081,-16,-15,8,326520,14
1477,jd1602,20150629,4080,4081,0,0,0,4076,4076,-5,-5,0,0,14
1478,jd1602,20150630,4076,4076,4000,4000,4000,4000,4000,-76,-76,2,80000,14
1479,jd1602,20150701,4000,4000,0,0,0,4001,4001,1,1,0,0,14
1480,jd1602,20150702,4001,4001,0,0,0,3977,3977,-24,-24,0,0,14
1481,jd1602,20150703,3977,3977,4000,4000,4000,4000,4000,23,23,2,80000,16
1482,jd1602,20150706,4000,4000,4098,4098,4098,4098,4098,98,98,2,81960,14
1483,jd1602,20150707,4098,4098,4050,4050,4050,4050,4050,-48,-48,4,162000,16
1484,jd1602,20150708,4050,4050,3972,3985,3848,3848,3916,-202,-134,20,783220,8
1485,jd1602,20150709,3848,3916,0,0,0,3916,3916,0,0,0,0,8
1486,jd1602,20150710,3916,3916,4099,4100,3917,4100,4054,184,138,10,405460,10
1487,jd1602,20150713,4100,4054,0,0,0,4054,4054,0,0,0,0,10
1488,jd1602,20150714,4054,4054,0,0,0,4110,4110,56,56,0,0,10
1489,jd1602,20150715,4110,4110,0,0,0,4110,4110,0,0,0,0,10
1490,jd1602,20150716,4110,4110,4200,4200,4150,4150,4175,40,65,40,1670000,14
1491,jd1602,20150717,4150,4175,0,0,0,4175,4175,0,0,0,0,14
1492,jd1602,20150720,4175,4175,0,0,0,4199,4199,24,24,0,0,14
1493,jd1602,20150721,4199,4199,4198,4198,4198,4198,4198,-1,-1,2,83960,12
1494,jd1602,20150722,4198,4198,4171,4171,4171,4171,4171,-27,-27,2,83420,12
1495,jd1602,20150723,4171,4171,0,0,0,4171,4171,0,0,0,0,12
1496,jd1602,20150724,4171,4171,4177,4177,4177,4177,4177,6,6,2,83540,10
1497,jd1602,20150727,4177,4177,0,0,0,4149,4149,-28,-28,0,0,10
1498,jd1602,20150728,4149,4149,0,0,0,4149,4149,0,0,0,0,10
1499,jd1602,20150729,4149,4149,4145,4145,4145,4145,4145,-4,-4,2,82900,8
1500,jd1602,20150730,4145,4145,0,0,0,4144,4144,-1,-1,0,0,8
1501,jd1602,20150731,4144,4144,4223,4223,4112,4129,4183,-15,39,18,753080,16
1502,jd1602,20150803,4129,4183,0,0,0,4183,4183,0,0,0,0,16
1503,jd1602,20150804,4183,4183,0,0,0,4190,4190,7,7,0,0,16
1504,jd1602,20150805,4190,4190,4104,4104,4104,4104,4104,-86,-86,6,246240,16
1505,jd1602,20150806,4104,4104,0,0,0,4104,4104,0,0,0,0,16
1506,jd1602,20150807,4104,4104,3951,4080,3950,4045,3997,-59,-107,18,719560,20
1507,jd1602,20150810,4045,3997,0,0,0,3997,3997,0,0,0,0,20
1508,jd1602,20150811,3997,3997,3970,4009,3970,3997,3976,0,-21,54,2147500,46
1509,jd1602,20150812,3997,3976,0,0,0,3976,3976,0,0,0,0,46
1510,jd1602,20150813,3976,3976,0,0,0,3976,3976,0,0,0,0,46
1511,jd1602,20150814,3976,3976,3972,3972,3972,3972,3972,-4,-4,4,158880,46
1512,jd1602,20150817,3972,3972,3956,3973,3956,3973,3964,1,-8,4,158580,44
1513,jd1602,20150818,3973,3964,4046,4046,3956,3956,3982,-8,18,10,398200,46
1514,jd1602,20150819,3956,3982,3945,3960,3945,3950,3953,-32,-29,8,316280,46
1515,jd1602,20150820,3950,3953,3970,4017,3935,4017,3975,64,22,8,318020,48
1516,jd1602,20150821,4017,3975,0,0,0,3975,3975,0,0,0,0,48
1517,jd1602,20150824,3975,3975,3900,3963,3852,3963,3920,-12,-55,34,1332900,64
1518,jd1602,20150825,3963,3920,3980,3990,3980,3990,3987,70,67,12,478460,58
1519,jd1602,20150826,3990,3987,3872,3880,3872,3880,3876,-107,-111,8,310080,60
1520,jd1602,20150827,3880,3876,0,0,0,3879,3879,3,3,0,0,60
1521,jd1602,20150828,3879,3879,3900,3949,3861,3865,3901,-14,22,22,858220,66
1522,jd1602,20150831,3865,3901,3886,3886,3791,3806,3827,-95,-74,6,229660,66
1523,jd1602,20150901,3806,3827,3923,3945,3880,3890,3918,63,91,104,4075180,110
1524,jd1602,20150902,3890,3918,3905,3905,3856,3871,3879,-47,-39,16,620780,112
1525,jd1602,20150907,3871,3879,3898,3915,3890,3894,3902,15,23,18,702400,112
1526,jd1602,20150908,3894,3902,3890,3890,3890,3890,3890,-12,-12,2,77800,112
1527,jd1602,20150909,3890,3890,3917,3941,3901,3905,3921,15,31,56,2195760,110
1528,jd1602,20150910,3905,3921,3891,3891,3891,3891,3891,-30,-30,2,77820,110
1529,jd1602,20150911,3891,3891,3890,3890,3851,3860,3864,-31,-27,14,541020,108
1530,jd1602,20150914,3860,3864,0,0,0,3864,3864,0,0,0,0,108
1531,jd1602,20150915,3864,3864,3837,3841,3801,3801,3826,-63,-38,8,306120,106
1532,jd1602,20150916,3801,3826,3801,3801,3788,3791,3797,-35,-29,16,607520,100
1533,jd1602,20150917,3791,3797,3794,3794,3773,3773,3785,-24,-12,12,454280,106
1534,jd1602,20150918,3773,3785,0,0,0,3751,3751,-34,-34,0,0,106
1535,jd1602,20150921,3751,3751,3669,3669,3669,3669,3669,-82,-82,2,73380,108
1536,jd1602,20150922,3669,3669,3703,3707,3703,3707,3705,38,36,4,148200,110
1537,jd1602,20150923,3707,3705,0,0,0,3705,3705,0,0,0,0,110
1538,jd1602,20150924,3705,3705,3695,3706,3695,3706,3700,1,-5,4,148020,110
1539,jd1602,20150925,3706,3700,0,0,0,3700,3700,0,0,0,0,110
1540,jd1602,20150928,3700,3700,3687,3716,3687,3716,3698,16,-2,6,221900,108
1541,jd1602,20150929,3716,3698,3672,3701,3667,3686,3692,-12,-6,22,812440,112
1542,jd1602,20150930,3686,3692,3731,3738,3601,3601,3673,-91,-19,80,2938800,122
1543,jd1602,20151008,3601,3673,3591,3600,3576,3589,3590,-84,-83,20,718180,136
1544,jd1602,20151009,3589,3590,3553,3587,3553,3559,3568,-31,-22,12,428240,140
1545,jd1602,20151012,3559,3568,3550,3550,3475,3510,3506,-58,-62,20,701340,144
1546,jd1602,20151013,3510,3506,3480,3500,3480,3500,3493,-6,-13,6,209580,142
1547,jd1602,20151014,3500,3493,0,0,0,3493,3493,0,0,0,0,142
1548,jd1602,20151015,3493,3493,3546,3546,3536,3536,3541,43,48,4,141640,144
1549,jd1602,20151016,3536,3541,3534,3534,3503,3503,3520,-38,-21,6,211220,144
1550,jd1602,20151019,3503,3520,3434,3503,3434,3486,3482,-34,-38,12,417920,146
1551,jd1602,20151020,3486,3482,3490,3490,3490,3490,3490,8,8,2,69800,144
1552,jd1602,20151021,3490,3490,3515,3515,3428,3481,3480,-9,-10,12,417700,138
1553,jd1602,20151022,3481,3480,3490,3536,3490,3525,3522,45,42,14,493160,140
1554,jd1602,20151023,3525,3522,3540,3540,3503,3520,3520,-2,-2,14,492840,144
1555,jd1602,20151026,3520,3520,3512,3513,3479,3479,3503,-41,-17,12,420360,148
1556,jd1602,20151027,3479,3503,3466,3469,3456,3469,3464,-34,-39,8,277120,146
1557,jd1602,20151028,3469,3464,3475,3475,3475,3475,3475,11,11,2,69500,148
1558,jd1602,20151029,3475,3475,3454,3464,3454,3464,3458,-11,-17,8,276640,148
1559,jd1602,20151030,3464,3458,3460,3487,3453,3453,3463,-5,5,18,623460,160
1560,jd1602,20151102,3453,3463,3402,3456,3402,3422,3431,-41,-32,16,549040,162
1561,jd1602,20151103,3422,3431,3449,3498,3311,3457,3427,26,-4,44,1507940,140
1562,jd1602,20151104,3457,3427,3488,3501,3466,3496,3481,69,54,40,1392480,150
1563,jd1602,20151105,3496,3481,3500,3500,3499,3499,3499,18,18,10,349920,142
1564,jd1602,20151106,3499,3499,3448,3479,3447,3479,3465,-20,-34,12,415860,140
1565,jd1602,20151109,3479,3465,0,0,0,3465,3465,0,0,0,0,140
1566,jd1602,20151110,3465,3465,3442,3442,3431,3431,3436,-34,-29,4,137460,140
1567,jd1602,20151111,3431,3436,3418,3454,3418,3454,3429,18,-7,24,823120,134
1568,jd1602,20151112,3454,3429,0,0,0,3430,3430,1,1,0,0,134
1569,jd1602,20151113,3430,3430,0,0,0,3430,3430,0,0,0,0,134
1570,jd1602,20151116,3430,3430,3383,3401,3351,3377,3378,-53,-52,8,270240,136
1571,jd1602,20151117,3377,3378,3328,3329,3328,3329,3328,-49,-50,4,133140,134
1572,jd1602,20151118,3329,3328,3201,3341,3201,3340,3316,12,-12,12,397960,130
1573,jd1602,20151119,3340,3316,3427,3427,3300,3300,3394,-16,78,10,339420,136
1574,jd1602,20151120,3300,3394,3399,3400,3399,3400,3399,6,5,4,135980,138
1575,jd1602,20151123,3400,3399,3312,3355,3305,3355,3323,-44,-76,12,398840,132
1576,jd1602,20151124,3355,3323,3175,3250,3159,3195,3182,-128,-141,132,4200580,184
1577,jd1602,20151125,3195,3182,3150,3195,3150,3194,3175,12,-7,14,444580,186
1578,jd1602,20151126,3194,3175,3204,3275,3204,3240,3248,65,73,28,909640,190
1579,jd1602,20151127,3240,3248,3220,3220,3172,3172,3196,-76,-52,4,127840,190
1580,jd1602,20151130,3172,3196,3289,3289,3269,3280,3276,84,80,10,327660,190
1581,jd1602,20151201,3280,3276,3223,3325,3223,3300,3291,24,15,20,658300,192
1582,jd1602,20151202,3300,3291,0,0,0,3291,3291,0,0,0,0,192
1583,jd1602,20151203,3291,3291,3191,3250,3191,3250,3220,-41,-71,4,128820,192
1584,jd1602,20151204,3250,3220,3201,3202,3200,3202,3201,-18,-19,14,448200,190
1585,jd1602,20151207,3202,3201,3187,3209,3187,3209,3198,8,-3,12,383820,194
1586,jd1602,20151208,3209,3198,3135,3176,3135,3176,3153,-22,-45,8,252300,196
1587,jd1602,20151209,3176,3153,3144,3187,3144,3176,3168,23,15,10,316880,198
1588,jd1602,20151210,3176,3168,0,0,0,3168,3168,0,0,0,0,198
1589,jd1602,20151211,3168,3168,3166,3167,3166,3167,3166,-1,-2,6,189980,198
1590,jd1602,20151214,3167,3166,3159,3167,3077,3167,3135,1,-31,18,564380,198
1591,jd1602,20151215,3167,3135,3215,3215,3199,3199,3211,64,76,8,256880,196
1592,jd1602,20151216,3199,3211,3222,3222,3180,3213,3211,2,0,10,321180,190
1593,jd1602,20151217,3213,3211,3360,3360,3168,3243,3249,32,38,18,584840,192
1594,jd1602,20151218,3243,3249,3225,3309,3225,3270,3278,21,29,32,1049160,192
1595,jd1602,20151221,3270,3278,3280,3302,3280,3302,3294,24,16,6,197680,188
1596,jd1602,20151222,3302,3294,3310,3310,3252,3257,3290,-37,-4,12,394820,190
1597,jd1602,20151223,3257,3290,3286,3304,3281,3281,3292,-9,2,16,526720,194
1598,jd1602,20151224,3281,3292,0,0,0,3292,3292,0,0,0,0,194
1599,jd1602,20151225,3292,3292,0,0,0,3292,3292,0,0,0,0,194
1600,jd1602,20151228,3292,3292,0,0,0,3292,3292,0,0,0,0,194
1601,jd1602,20151229,3292,3292,3258,3267,3250,3250,3261,-42,-31,24,782840,188
1602,jd1602,20151230,3250,3261,3165,3165,3165,3165,3165,-96,-96,2,63300,188
1603,jd1602,20151231,3165,3165,3153,3293,3153,3293,3223,128,58,4,128920,186
1604,jd1603,20150316,4206,4206,0,0,0,4165,4165,-41,-41,0,0,0
1605,jd1603,20150317,4165,4165,0,0,0,4154,4154,-11,-11,0,0,0
1606,jd1603,20150318,4154,4154,0,0,0,4154,4154,0,0,0,0,0
1607,jd1603,20150319,4154,4154,4151,4209,4051,4174,4125,20,-29,38,1567660,4
1608,jd1603,20150320,4174,4125,4103,4103,4102,4102,4102,-23,-23,4,164100,6
1609,jd1603,20150323,4102,4102,4140,4140,4090,4106,4107,4,5,84,3449920,72
1610,jd1603,20150324,4106,4107,4092,4099,4080,4099,4090,-8,-17,30,1227140,94
1611,jd1603,20150325,4099,4090,4096,4107,4070,4071,4079,-19,-11,82,3345560,148
1612,jd1603,20150326,4071,4079,4097,4097,4063,4072,4074,-7,-5,48,1955680,158
1613,jd1603,20150327,4072,4074,4064,4071,4055,4066,4065,-8,-9,36,1463460,178
1614,jd1603,20150330,4066,4065,4054,4064,4054,4064,4061,-1,-4,8,324900,174
1615,jd1603,20150331,4064,4061,3903,4079,3903,4079,4047,18,-14,58,2347460,182
1616,jd1603,20150401,4079,4047,4071,4071,4070,4070,4070,23,23,4,162820,186
1617,jd1603,20150402,4070,4070,4051,4051,3986,4006,4012,-64,-58,66,2648200,214
1618,jd1603,20150403,4006,4012,3990,4011,3976,3976,3994,-36,-18,42,1677860,242
1619,jd1603,20150407,3976,3994,3971,3971,3912,3927,3931,-67,-63,80,3145280,272
1620,jd1603,20150408,3927,3931,3879,3956,3879,3927,3924,-4,-7,20,784940,276
1621,jd1603,20150409,3927,3924,3934,3934,3914,3914,3924,-10,0,14,549360,270
1622,jd1603,20150410,3914,3924,3940,3967,3931,3940,3938,16,14,30,1181560,262
1623,jd1603,20150413,3940,3938,3931,3931,3931,3931,3931,-7,-7,2,78620,262
1624,jd1603,20150414,3931,3931,3953,3966,3953,3966,3958,35,27,10,395820,258
1625,jd1603,20150415,3966,3958,3930,3945,3930,3936,3934,-22,-24,16,629480,254
1626,jd1603,20150416,3936,3934,3936,3973,3936,3936,3947,2,13,14,552620,252
1627,jd1603,20150417,3936,3947,0,0,0,3947,3947,0,0,0,0,252
1628,jd1603,20150420,3947,3947,3979,3979,3979,3979,3979,32,32,2,79580,252
1629,jd1603,20150421,3979,3979,3999,4099,3970,4069,4064,90,85,324,13169940,416
1630,jd1603,20150422,4069,4064,4075,4083,4040,4057,4055,-7,-9,36,1460000,428
1631,jd1603,20150423,4057,4055,4042,4079,4042,4070,4046,15,-9,58,2347220,420
1632,jd1603,20150424,4070,4046,4062,4078,4062,4065,4063,19,17,30,1218980,420
1633,jd1603,20150427,4065,4063,4021,4079,4021,4079,4064,16,1,28,1138080,412
1634,jd1603,20150428,4079,4064,4087,4099,4063,4083,4086,19,22,22,899120,398
1635,jd1603,20150429,4083,4086,4044,4069,4044,4069,4052,-17,-34,6,243140,398
1636,jd1603,20150430,4069,4052,4048,4059,4020,4050,4044,-2,-8,38,1536820,406
1637,jd1603,20150504,4050,4044,4051,4068,4038,4038,4046,-6,2,78,3156080,354
1638,jd1603,20150505,4038,4046,4040,4058,4040,4045,4047,-1,1,94,3804700,324
1639,jd1603,20150506,4045,4047,4041,4046,4033,4033,4040,-14,-7,66,2666640,324
1640,jd1603,20150507,4033,4040,3977,4044,3977,4000,4022,-40,-18,46,1850520,324
1641,jd1603,20150508,4000,4022,3992,3992,3988,3988,3988,-34,-34,12,478640,322
1642,jd1603,20150511,3988,3988,3972,3997,3972,3997,3984,9,-4,46,1833080,342
1643,jd1603,20150512,3997,3984,3982,3982,3977,3977,3979,-7,-5,4,159180,342
1644,jd1603,20150513,3977,3979,3975,3999,3975,3980,3985,1,6,24,956560,328
1645,jd1603,20150514,3980,3985,3988,4008,3973,4008,3993,23,8,16,638880,326
1646,jd1603,20150515,4008,3993,4014,4063,3873,3882,3964,-111,-29,186,7374880,290
1647,jd1603,20150518,3882,3964,3935,3981,3930,3981,3957,17,-7,44,1741480,290
1648,jd1603,20150519,3981,3957,3937,3968,3937,3940,3948,-17,-9,20,789760,290
1649,jd1603,20150520,3940,3948,3945,3945,3907,3925,3922,-23,-26,20,784580,290
1650,jd1603,20150521,3925,3922,3850,3933,3850,3933,3914,11,-8,12,469720,288
1651,jd1603,20150522,3933,3914,3921,3935,3915,3929,3925,15,11,12,471100,288
1652,jd1603,20150525,3929,3925,3893,3899,3890,3890,3892,-35,-33,14,544980,288
1653,jd1603,20150526,3890,3892,0,0,0,3900,3900,8,8,0,0,288
1654,jd1603,20150527,3900,3900,3926,3926,3926,3926,3926,26,26,2,78520,288
1655,jd1603,20150528,3926,3926,3908,3908,3908,3908,3908,-18,-18,2,78160,288
1656,jd1603,20150529,3908,3908,0,0,0,3908,3908,0,0,0,0,288
1657,jd1603,20150601,3908,3908,3950,3950,3912,3921,3935,13,27,22,865700,290
1658,jd1603,20150602,3921,3935,3915,3928,3914,3928,3917,-7,-18,8,313420,292
1659,jd1603,20150603,3928,3917,3957,3957,3928,3928,3940,11,23,38,1497520,292
1660,jd1603,20150604,3928,3940,3906,3911,3905,3911,3907,-29,-33,6,234440,292
1661,jd1603,20150605,3911,3907,4076,4076,3900,3935,3950,28,43,12,474060,296
1662,jd1603,20150608,3935,3950,3935,3935,3865,3933,3923,-17,-27,38,1490780,300
1663,jd1603,20150609,3933,3923,3892,3950,3892,3937,3931,14,8,22,865020,304
1664,jd1603,20150610,3937,3931,3935,3935,3935,3935,3935,4,4,4,157400,306
1665,jd1603,20150611,3935,3935,3935,3948,3933,3941,3941,6,6,26,1024900,314
1666,jd1603,20150612,3941,3941,3930,3933,3915,3917,3921,-24,-20,26,1019460,318
1667,jd1603,20150615,3917,3921,3907,3916,3888,3916,3905,-5,-16,14,546820,318
1668,jd1603,20150616,3916,3905,3943,3945,3933,3933,3941,28,36,18,709420,320
1669,jd1603,20150617,3933,3941,3940,3960,3930,3940,3948,-1,7,30,1184600,316
1670,jd1603,20150618,3940,3948,3916,3958,3916,3929,3945,-19,-3,44,1735800,308
1671,jd1603,20150619,3929,3945,3956,3965,3956,3965,3960,20,15,10,396080,308
1672,jd1603,20150623,3965,3960,3980,3980,3948,3948,3956,-12,-4,8,316480,308
1673,jd1603,20150624,3948,3956,0,0,0,3956,3956,0,0,0,0,308
1674,jd1603,20150625,3956,3956,3999,3999,3968,3972,3987,16,31,46,1834260,308
1675,jd1603,20150626,3972,3987,3999,3999,3968,3969,3972,-18,-15,24,953500,314
1676,jd1603,20150629,3969,3972,3975,4000,3960,3961,3973,-11,1,30,1192060,312
1677,jd1603,20150630,3961,3973,3939,3964,3939,3958,3951,-15,-22,12,474120,314
1678,jd1603,20150701,3958,3951,4063,4063,3950,3972,3986,21,35,28,1116100,306
1679,jd1603,20150702,3972,3986,0,0,0,3974,3974,-12,-12,0,0,306
1680,jd1603,20150703,3974,3974,4011,4011,3987,3987,4002,13,28,24,960540,306
1681,jd1603,20150706,3987,4002,4013,4013,3975,3994,3988,-8,-14,20,797780,304
1682,jd1603,20150707,3994,3988,3981,3981,3973,3973,3975,-15,-13,6,238540,302
1683,jd1603,20150708,3973,3975,3863,3886,3777,3813,3814,-162,-161,48,1830960,314
1684,jd1603,20150709,3813,3814,3880,3948,3624,3878,3849,64,35,106,4080600,308
1685,jd1603,20150710,3878,3849,3865,3947,3865,3947,3930,98,81,30,1179040,298
1686,jd1603,20150713,3947,3930,3905,3905,3905,3905,3905,-25,-25,2,78100,298
1687,jd1603,20150714,3905,3905,3931,3958,3913,3956,3941,51,36,36,1419040,290
1688,jd1603,20150715,3956,3941,3925,3949,3925,3949,3937,8,-4,4,157480,292
1689,jd1603,20150716,3949,3937,3930,3930,3928,3928,3929,-9,-8,6,235760,290
1690,jd1603,20150717,3928,3929,3939,3941,3920,3941,3935,12,6,14,550920,290
1691,jd1603,20150720,3941,3935,3950,3978,3950,3959,3968,24,33,36,1428680,296
1692,jd1603,20150721,3959,3968,3997,3998,3944,3988,3981,20,13,38,1513020,276
1693,jd1603,20150722,3988,3981,4167,4167,3975,3990,4017,9,36,14,562380,272
1694,jd1603,20150723,3990,4017,3950,4030,3950,4030,4010,13,-7,62,2486680,250
1695,jd1603,20150724,4030,4010,4016,4028,4016,4016,4021,6,11,14,562960,244
1696,jd1603,20150727,4016,4021,3975,4009,3961,3988,3986,-33,-35,10,398680,246
1697,jd1603,20150728,3988,3986,3979,4018,3979,4018,4008,32,22,10,400860,244
1698,jd1603,20150729,4018,4008,4001,4065,4000,4000,4012,-8,4,12,481460,236
1699,jd1603,20150730,4000,4012,3941,4012,3941,4008,3985,-4,-27,10,398540,238
1700,jd1603,20150731,4008,3985,3963,4000,3963,4000,3975,15,-10,6,238520,238
1701,jd1603,20150803,4000,3975,4006,4007,4006,4007,4006,32,31,12,480740,236
1702,jd1603,20150804,4007,4006,3945,3970,3945,3970,3963,-36,-43,8,317100,236
1703,jd1603,20150805,3970,3963,3920,4015,3905,3989,3989,26,26,72,2872180,240
1704,jd1603,20150806,3989,3989,0,0,0,3989,3989,0,0,0,0,240
1705,jd1603,20150807,3989,3989,3865,3969,3865,3968,3949,-21,-40,30,1184780,234
1706,jd1603,20150810,3968,3949,3981,4003,3975,3994,3991,45,42,16,638620,232
1707,jd1603,20150811,3994,3991,4005,4009,3961,3989,3992,-2,1,30,1197880,240
1708,jd1603,20150812,3989,3992,3989,4000,3989,4000,3995,8,3,10,399540,244
1709,jd1603,20150813,4000,3995,4000,4002,4000,4002,4001,7,6,6,240060,242
1710,jd1603,20150814,4002,4001,4018,4018,3910,4008,3988,7,-13,34,1355980,246
1711,jd1603,20150817,4008,3988,3971,3999,3966,3999,3983,11,-5,20,796600,246
1712,jd1603,20150818,3999,3983,3999,4000,3996,3999,3998,16,15,14,559780,246
1713,jd1603,20150819,3999,3998,3910,4002,3910,4002,3976,4,-22,14,556660,252
1714,jd1603,20150820,4002,3976,3998,3998,3998,3998,3998,22,22,2,79960,250
1715,jd1603,20150821,3998,3998,3999,4000,3956,3982,3990,-16,-8,26,1037540,246
1716,jd1603,20150824,3982,3990,3970,4098,3950,3973,3979,-17,-11,140,5570880,244
1717,jd1603,20150825,3973,3979,3990,3991,3939,3939,3955,-40,-24,62,2452620,212
1718,jd1603,20150826,3939,3955,3929,3930,3890,3890,3909,-65,-46,30,1172940,212
1719,jd1603,20150827,3890,3909,3913,3915,3851,3851,3898,-58,-11,8,311840,216
1720,jd1603,20150828,3851,3898,3910,3910,3832,3879,3880,-19,-18,48,1862780,214
1721,jd1603,20150831,3879,3880,3850,3889,3850,3889,3878,9,-2,24,930820,232
1722,jd1603,20150901,3889,3878,3861,3866,3840,3840,3854,-38,-24,16,616700,224
1723,jd1603,20150902,3840,3854,3833,3953,3833,3854,3863,0,9,44,1699880,242
1724,jd1603,20150907,3854,3863,3855,3872,3855,3866,3867,3,4,10,386720,246
1725,jd1603,20150908,3866,3867,3870,3871,3870,3871,3870,4,3,4,154820,246
1726,jd1603,20150909,3871,3870,3930,3930,3870,3870,3911,0,41,30,1173320,256
1727,jd1603,20150910,3870,3911,3880,3891,3880,3891,3885,-20,-26,4,155420,256
1728,jd1603,20150911,3891,3885,3851,3885,3840,3843,3851,-42,-34,28,1078380,250
1729,jd1603,20150914,3843,3851,3847,3866,3800,3800,3821,-51,-30,40,1528700,254
1730,jd1603,20150915,3800,3821,3836,3836,3790,3790,3819,-31,-2,16,611060,254
1731,jd1603,20150916,3790,3819,3742,3799,3741,3771,3763,-48,-56,40,1505300,234
1732,jd1603,20150917,3771,3763,3751,3751,3750,3750,3750,-13,-13,4,150020,236
1733,jd1603,20150918,3750,3750,3769,3769,3731,3731,3756,-19,6,6,225380,238
1734,jd1603,20150921,3731,3756,3767,3767,3767,3767,3767,11,11,2,75340,240
1735,jd1603,20150922,3767,3767,3704,3723,3697,3698,3713,-69,-54,24,891200,234
1736,jd1603,20150923,3698,3713,3707,3707,3697,3697,3702,-16,-11,4,148080,232
1737,jd1603,20150924,3697,3702,0,0,0,3641,3641,-61,-61,0,0,232
1738,jd1603,20150925,3641,3641,3703,3703,3671,3675,3680,34,39,8,294420,232
1739,jd1603,20150928,3675,3680,3661,3703,3661,3701,3681,21,1,16,589000,226
1740,jd1603,20150929,3701,3681,3665,3665,3641,3641,3647,-40,-34,8,291760,220
1741,jd1603,20150930,3641,3647,3641,3641,3591,3591,3617,-56,-30,8,289360,220
1742,jd1603,20151008,3591,3617,3544,3545,3539,3544,3544,-73,-73,30,1063300,242
1743,jd1603,20151009,3544,3544,3543,3559,3494,3559,3539,15,-5,20,707860,244
1744,jd1603,20151012,3559,3539,3482,3509,3402,3506,3481,-33,-58,30,1044480,250
1745,jd1603,20151013,3506,3481,3509,3509,3450,3479,3478,-2,-3,20,695680,250
1746,jd1603,20151014,3479,3478,3480,3487,3471,3487,3481,9,3,36,1253340,264
1747,jd1603,20151015,3487,3481,0,0,0,3489,3489,8,8,0,0,264
1748,jd1603,20151016,3489,3489,3501,3516,3494,3501,3502,12,13,14,490400,268
1749,jd1603,20151019,3501,3502,3488,3496,3461,3496,3485,-6,-17,8,278820,272
1750,jd1603,20151020,3496,3485,0,0,0,3485,3485,0,0,0,0,272
1751,jd1603,20151021,3485,3485,0,0,0,3485,3485,0,0,0,0,272
1752,jd1603,20151022,3485,3485,3478,3496,3456,3489,3472,4,-13,34,1180680,260
1753,jd1603,20151023,3489,3472,3479,3479,3459,3477,3472,5,0,10,347260,262
1754,jd1603,20151026,3477,3472,3493,3494,3462,3479,3484,7,12,18,627260,258
1755,jd1603,20151027,3479,3484,3465,3465,3432,3441,3444,-43,-40,16,551100,256
1756,jd1603,20151028,3441,3444,3431,3433,3431,3433,3432,-11,-12,8,274580,256
1757,jd1603,20151029,3433,3432,3433,3433,3384,3384,3415,-48,-17,6,204940,260
1758,jd1603,20151030,3384,3415,3401,3408,3383,3404,3400,-11,-15,40,1360160,266
1759,jd1603,20151102,3404,3400,3370,3370,3318,3343,3335,-57,-65,78,2601660,294
1760,jd1603,20151103,3343,3335,3360,3444,3342,3405,3394,70,59,64,2172460,268
1761,jd1603,20151104,3405,3394,3443,3448,3443,3447,3446,53,52,8,275720,268
1762,jd1603,20151105,3447,3446,3429,3473,3429,3463,3448,17,2,12,413780,274
1763,jd1603,20151106,3463,3448,3464,3464,3398,3434,3419,-14,-29,22,752260,276
1764,jd1603,20151109,3434,3419,3410,3433,3409,3433,3414,14,-5,12,409780,280
1765,jd1603,20151110,3433,3414,3419,3419,3407,3416,3415,2,1,8,273220,286
1766,jd1603,20151111,3416,3415,3397,3411,3346,3384,3381,-31,-34,44,1487680,294
1767,jd1603,20151112,3384,3381,3375,3392,3344,3378,3362,-3,-19,102,3429800,338
1768,jd1603,20151113,3378,3362,3381,3387,3379,3380,3383,18,21,26,879640,326
1769,jd1603,20151116,3380,3383,3305,3361,3304,3312,3314,-71,-69,90,2982840,390
1770,jd1603,20151117,3312,3314,3306,3306,3252,3253,3280,-61,-34,48,1574840,402
1771,jd1603,20151118,3253,3280,3286,3302,3243,3256,3271,-24,-9,84,2748160,428
1772,jd1603,20151119,3256,3271,3275,3329,3212,3212,3307,-59,36,112,3704720,490
1773,jd1603,20151120,3212,3307,3205,3332,3205,3262,3284,-45,-23,68,2233280,502
1774,jd1603,20151123,3262,3284,3201,3225,3199,3200,3206,-84,-78,12,384820,502
1775,jd1603,20151124,3200,3206,3205,3205,3125,3187,3174,-19,-32,58,1841000,508
1776,jd1603,20151125,3187,3174,3172,3295,3134,3181,3167,7,-7,68,2153680,500
1777,jd1603,20151126,3181,3167,3199,3279,3190,3223,3247,56,80,80,2598120,512
1778,jd1603,20151127,3223,3247,3230,3230,3207,3225,3224,-22,-23,18,580340,514
1779,jd1603,20151130,3225,3224,3223,3260,3223,3260,3254,36,30,16,520700,504
1780,jd1603,20151201,3260,3254,3268,3268,3239,3240,3251,-14,-3,16,520280,510
1781,jd1603,20151202,3240,3251,3264,3265,3239,3239,3253,-12,2,26,846020,508
1782,jd1603,20151203,3239,3253,3222,3240,3221,3221,3230,-32,-23,8,258460,512
1783,jd1603,20151204,3221,3230,0,0,0,3230,3230,0,0,0,0,512
1784,jd1603,20151207,3230,3230,3226,3226,3224,3224,3224,-6,-6,10,322480,518
1785,jd1603,20151208,3224,3224,3156,3200,3156,3186,3181,-38,-43,34,1081760,502
1786,jd1603,20151209,3186,3181,3181,3217,3151,3159,3162,-22,-19,60,1897760,498
1787,jd1603,20151210,3159,3162,3169,3169,3150,3151,3156,-11,-6,30,946820,500
1788,jd1603,20151211,3151,3156,3154,3179,3145,3170,3160,14,4,30,948200,498
1789,jd1603,20151214,3170,3160,3158,3158,3129,3141,3139,-19,-21,46,1444200,500
1790,jd1603,20151215,3141,3139,3175,3196,3157,3166,3175,27,36,38,1206660,506
1791,jd1603,20151216,3166,3175,3165,3188,3165,3176,3176,1,1,20,635320,508
1792,jd1603,20151217,3176,3176,3181,3182,3178,3178,3180,2,4,6,190820,510
1793,jd1603,20151218,3178,3180,3188,3202,3188,3202,3195,22,15,4,127800,512
1794,jd1603,20151221,3202,3195,3199,3236,3199,3229,3220,34,25,28,901640,516
1795,jd1603,20151222,3229,3220,3252,3252,3183,3219,3209,-1,-11,44,1412120,522
1796,jd1603,20151223,3219,3209,3219,3219,3219,3219,3219,10,10,8,257520,524
1797,jd1603,20151224,3219,3219,3220,3220,3195,3204,3201,-15,-18,44,1408760,526
1798,jd1603,20151225,3204,3201,3208,3209,3186,3186,3196,-15,-5,52,1662380,526
1799,jd1603,20151228,3186,3196,3141,3160,3138,3160,3147,-36,-49,28,881360,532
1800,jd1603,20151229,3160,3147,3180,3199,3148,3182,3172,35,25,42,1332240,528
1801,jd1603,20151230,3182,3172,3171,3171,3151,3160,3157,-12,-15,64,2021040,544
1802,jd1603,20151231,3160,3157,3137,3179,3102,3104,3155,-53,-2,62,1956460,584
1803,jd1604,20150416,4058,4058,3913,3913,3913,3913,3913,-145,-145,2,78260,2
1804,jd1604,20150417,3913,3913,0,0,0,3927,3927,14,14,0,0,2
1805,jd1604,20150420,3927,3927,0,0,0,3941,3941,14,14,0,0,2
1806,jd1604,20150421,3941,3941,4073,4098,4042,4098,4080,157,139,56,2285300,50
1807,jd1604,20150422,4098,4080,4079,4090,4060,4090,4071,10,-9,18,732940,52
1808,jd1604,20150423,4090,4071,0,0,0,4071,4071,0,0,0,0,52
1809,jd1604,20150424,4071,4071,4070,4079,4070,4079,4072,8,1,8,325780,46
1810,jd1604,20150427,4079,4072,0,0,0,4072,4072,0,0,0,0,46
1811,jd1604,20150428,4072,4072,4098,4099,4079,4079,4095,7,23,14,573400,42
1812,jd1604,20150429,4079,4095,0,0,0,4074,4074,-21,-21,0,0,42
1813,jd1604,20150430,4074,4074,4048,4055,4048,4055,4051,-19,-23,4,162060,44
1814,jd1604,20150504,4055,4051,4049,4049,4037,4037,4044,-14,-7,12,485320,42
1815,jd1604,20150505,4037,4044,4043,4044,4043,4044,4043,0,-1,4,161740,42
1816,jd1604,20150506,4044,4043,4030,4030,4029,4029,4029,-14,-14,4,161180,42
1817,jd1604,20150507,4029,4029,4035,4035,4000,4000,4016,-29,-13,12,481940,38
1818,jd1604,20150508,4000,4016,3834,4009,3834,3941,3946,-75,-70,8,315680,38
1819,jd1604,20150511,3941,3946,3988,3995,3950,3995,3980,49,34,10,398060,46
1820,jd1604,20150512,3995,3980,3990,3990,3970,3970,3982,-10,2,10,398280,42
1821,jd1604,20150513,3970,3982,4008,4009,3990,3990,4002,8,20,6,240140,44
1822,jd1604,20150514,3990,4002,4007,4007,4007,4007,4007,5,5,4,160280,42
1823,jd1604,20150515,4007,4007,0,0,0,4007,4007,0,0,0,0,42
1824,jd1604,20150518,4007,4007,3964,3999,3964,3999,3975,-8,-32,6,238540,40
1825,jd1604,20150519,3999,3975,3965,3965,3965,3965,3965,-10,-10,2,79300,40
1826,jd1604,20150520,3965,3965,3886,3925,3886,3925,3905,-40,-60,4,156220,40
1827,jd1604,20150521,3925,3905,0,0,0,3916,3916,11,11,0,0,40
1828,jd1604,20150522,3916,3916,3923,3923,3923,3923,3923,7,7,2,78460,40
1829,jd1604,20150525,3923,3923,0,0,0,3915,3915,-8,-8,0,0,40
1830,jd1604,20150526,3915,3915,0,0,0,3915,3915,0,0,0,0,40
1831,jd1604,20150527,3915,3915,0,0,0,3941,3941,26,26,0,0,40
1832,jd1604,20150528,3941,3941,0,0,0,3941,3941,0,0,0,0,40
1833,jd1604,20150529,3941,3941,0,0,0,3941,3941,0,0,0,0,40
1834,jd1604,20150601,3941,3941,0,0,0,3941,3941,0,0,0,0,40
1835,jd1604,20150602,3941,3941,0,0,0,3941,3941,0,0,0,0,40
1836,jd1604,20150603,3941,3941,0,0,0,3941,3941,0,0,0,0,40
1837,jd1604,20150604,3941,3941,3956,3956,3956,3956,3956,15,15,2,79120,40
1838,jd1604,20150605,3956,3956,0,0,0,3956,3956,0,0,0,0,40
1839,jd1604,20150608,3956,3956,3971,3971,3950,3950,3960,-6,4,4,158420,40
1840,jd1604,20150609,3950,3960,0,0,0,3963,3963,3,3,0,0,40
1841,jd1604,20150610,3963,3963,3979,3979,3979,3979,3979,16,16,2,79580,38
1842,jd1604,20150611,3979,3979,3988,3988,3971,3986,3981,7,2,6,238900,40
1843,jd1604,20150612,3986,3981,3926,3926,3926,3926,3926,-55,-55,4,157040,44
1844,jd1604,20150615,3926,3926,3930,3939,3913,3913,3923,-13,-3,8,313900,44
1845,jd1604,20150616,3913,3923,3971,3971,3971,3971,3971,48,48,4,158840,42
1846,jd1604,20150617,3971,3971,0,0,0,3954,3954,-17,-17,0,0,42
1847,jd1604,20150618,3954,3954,0,0,0,3954,3954,0,0,0,0,42
1848,jd1604,20150619,3954,3954,0,0,0,3969,3969,15,15,0,0,42
1849,jd1604,20150623,3969,3969,0,0,0,3969,3969,0,0,0,0,42
1850,jd1604,20150624,3969,3969,0,0,0,3969,3969,0,0,0,0,42
1851,jd1604,20150625,3969,3969,4007,4007,4007,4007,4007,38,38,2,80140,42
1852,jd1604,20150626,4007,4007,3985,3985,3983,3983,3984,-24,-23,4,159360,42
1853,jd1604,20150629,3983,3984,0,0,0,3985,3985,1,1,0,0,42
1854,jd1604,20150630,3985,3985,3937,3975,3937,3975,3956,-10,-29,4,158240,44
1855,jd1604,20150701,3975,3956,3991,4002,3991,4002,3996,46,40,4,159860,40
1856,jd1604,20150702,4002,3996,0,0,0,3996,3996,0,0,0,0,40
1857,jd1604,20150703,3996,3996,3971,3971,3970,3970,3970,-26,-26,6,238240,40
1858,jd1604,20150706,3970,3970,0,0,0,3981,3981,11,11,0,0,40
1859,jd1604,20150707,3981,3981,3993,4006,3898,4006,3976,25,-5,10,397600,40
1860,jd1604,20150708,4006,3976,3778,3900,3778,3791,3819,-185,-157,18,687500,38
1861,jd1604,20150709,3791,3819,0,0,0,3819,3819,0,0,0,0,38
1862,jd1604,20150710,3819,3819,3905,3905,3905,3905,3905,86,86,2,78100,38
1863,jd1604,20150713,3905,3905,3998,4002,3960,3960,3988,55,83,14,558420,36
1864,jd1604,20150714,3960,3988,0,0,0,3988,3988,0,0,0,0,36
1865,jd1604,20150715,3988,3988,0,0,0,3988,3988,0,0,0,0,36
1866,jd1604,20150716,3988,3988,0,0,0,3988,3988,0,0,0,0,36
1867,jd1604,20150717,3988,3988,0,0,0,3988,3988,0,0,0,0,36
1868,jd1604,20150720,3988,3988,3991,3994,3991,3993,3992,5,4,8,319380,36
1869,jd1604,20150721,3993,3992,4035,4035,4026,4026,4030,34,38,4,161220,36
1870,jd1604,20150722,4026,4030,0,0,0,4030,4030,0,0,0,0,36
1871,jd1604,20150723,4030,4030,3995,4053,3995,4053,4024,23,-6,4,160960,36
1872,jd1604,20150724,4053,4024,0,0,0,4024,4024,0,0,0,0,36
1873,jd1604,20150727,4024,4024,0,0,0,4012,4012,-12,-12,0,0,36
1874,jd1604,20150728,4012,4012,0,0,0,4012,4012,0,0,0,0,36
1875,jd1604,20150729,4012,4012,3982,3982,3982,3982,3982,-30,-30,2,79640,36
1876,jd1604,20150730,3982,3982,3974,3974,3974,3974,3974,-8,-8,2,79480,36
1877,jd1604,20150731,3974,3974,3935,3935,3935,3935,3935,-39,-39,2,78700,36
1878,jd1604,20150803,3935,3935,0,0,0,3951,3951,16,16,0,0,36
1879,jd1604,20150804,3951,3951,0,0,0,3951,3951,0,0,0,0,36
1880,jd1604,20150805,3951,3951,3931,3931,3931,3931,3931,-20,-20,2,78620,36
1881,jd1604,20150806,3931,3931,3911,3911,3911,3911,3911,-20,-20,2,78220,36
1882,jd1604,20150807,3911,3911,3863,3864,3863,3864,3863,-47,-48,4,154540,36
1883,jd1604,20150810,3864,3863,3968,3968,3939,3939,3953,76,90,4,158140,34
1884,jd1604,20150811,3939,3953,0,0,0,3953,3953,0,0,0,0,34
1885,jd1604,20150812,3953,3953,0,0,0,3953,3953,0,0,0,0,34
1886,jd1604,20150813,3953,3953,0,0,0,3953,3953,0,0,0,0,34
1887,jd1604,20150814,3953,3953,3931,4000,3930,4000,3965,47,12,20,793020,34
1888,jd1604,20150817,4000,3965,4000,4000,3903,3966,3961,1,-4,8,316920,34
1889,jd1604,20150818,3966,3961,0,0,0,3961,3961,0,0,0,0,34
1890,jd1604,20150819,3961,3961,3933,3934,3933,3934,3933,-27,-28,4,157340,34
1891,jd1604,20150820,3934,3933,3920,3969,3920,3969,3952,36,19,6,237160,38
1892,jd1604,20150821,3969,3952,3913,3916,3913,3916,3914,-36,-38,4,156580,38
1893,jd1604,20150824,3916,3914,3907,3907,3855,3855,3881,-59,-33,4,155240,40
1894,jd1604,20150825,3855,3881,3899,3899,3830,3830,3864,-51,-17,4,154580,40
1895,jd1604,20150826,3830,3864,3865,3865,3836,3836,3855,-28,-9,6,231320,40
1896,jd1604,20150827,3836,3855,3865,3865,3865,3865,3865,10,10,2,77300,38
1897,jd1604,20150828,3865,3865,0,0,0,3865,3865,0,0,0,0,38
1898,jd1604,20150831,3865,3865,0,0,0,3860,3860,-5,-5,0,0,38
1899,jd1604,20150901,3860,3860,0,0,0,3830,3830,-30,-30,0,0,38
1900,jd1604,20150902,3830,3830,0,0,0,3820,3820,-10,-10,0,0,38
1901,jd1604,20150907,3820,3820,0,0,0,3820,3820,0,0,0,0,38
1902,jd1604,20150908,3820,3820,0,0,0,3820,3820,0,0,0,0,38
1903,jd1604,20150909,3820,3820,3804,3804,3804,3804,3804,-16,-16,2,76080,38
1904,jd1604,20150910,3804,3804,0,0,0,3804,3804,0,0,0,0,38
1905,jd1604,20150911,3804,3804,0,0,0,3804,3804,0,0,0,0,38
1906,jd1604,20150914,3804,3804,3819,3819,3766,3766,3792,-38,-12,4,151700,40
1907,jd1604,20150915,3766,3792,3725,3725,3719,3719,3722,-73,-70,4,148880,36
1908,jd1604,20150916,3719,3722,3688,3688,3671,3671,3682,-51,-40,6,220940,36
1909,jd1604,20150917,3671,3682,3680,3680,3680,3680,3680,-2,-2,2,73600,38
1910,jd1604,20150918,3680,3680,3699,3709,3699,3709,3702,29,22,6,222160,36
1911,jd1604,20150921,3709,3702,0,0,0,3712,3712,10,10,0,0,36
1912,jd1604,20150922,3712,3712,3661,3661,3661,3661,3661,-51,-51,2,73220,36
1913,jd1604,20150923,3661,3661,3634,3634,3634,3634,3634,-27,-27,2,72680,38
1914,jd1604,20150924,3634,3634,3664,3664,3643,3654,3654,20,20,14,511680,34
1915,jd1604,20150925,3654,3654,0,0,0,3654,3654,0,0,0,0,34
1916,jd1604,20150928,3654,3654,3660,3668,3660,3668,3662,14,8,6,219760,36
1917,jd1604,20150929,3668,3662,0,0,0,3662,3662,0,0,0,0,36
1918,jd1604,20150930,3662,3662,3610,3610,3550,3550,3582,-112,-80,12,429840,36
1919,jd1604,20151008,3550,3582,3544,3544,3525,3529,3531,-53,-51,10,353120,36
1920,jd1604,20151009,3529,3531,0,0,0,3531,3531,0,0,0,0,36
1921,jd1604,20151012,3531,3531,3414,3450,3414,3443,3438,-88,-93,42,1444240,64
1922,jd1604,20151013,3443,3438,3385,3478,3385,3460,3436,22,-2,14,481160,70
1923,jd1604,20151014,3460,3436,3404,3488,3404,3478,3473,42,37,50,1736840,88
1924,jd1604,20151015,3478,3473,3506,3508,3475,3475,3493,2,20,26,908260,88
1925,jd1604,20151016,3475,3493,3490,3490,3471,3487,3482,-6,-11,6,208960,88
1926,jd1604,20151019,3487,3482,3432,3432,3432,3432,3432,-50,-50,2,68640,88
1927,jd1604,20151020,3432,3432,3501,3502,3466,3499,3492,67,60,8,279360,88
1928,jd1604,20151021,3499,3492,3524,3524,3458,3496,3498,4,6,18,629780,86
1929,jd1604,20151022,3496,3498,3488,3488,3441,3465,3459,-33,-39,48,1660520,74
1930,jd1604,20151023,3465,3459,3451,3464,3451,3464,3457,5,-2,10,345720,74
1931,jd1604,20151026,3464,3457,3443,3464,3443,3451,3456,-6,-1,14,483900,78
1932,jd1604,20151027,3451,3456,3527,3618,3388,3450,3477,-6,21,30,1043340,88
1933,jd1604,20151028,3450,3477,3427,3468,3425,3425,3444,-52,-33,28,964520,90
1934,jd1604,20151029,3425,3444,3420,3420,3420,3420,3420,-24,-24,2,68400,88
1935,jd1604,20151030,3420,3420,3427,3428,3412,3412,3424,-8,4,10,342420,82
1936,jd1604,20151102,3412,3424,3405,3405,3392,3392,3398,-32,-26,8,271840,78
1937,jd1604,20151103,3392,3398,3396,3454,3396,3443,3433,45,35,16,549320,72
1938,jd1604,20151104,3443,3433,3466,3469,3466,3467,3467,34,34,10,346760,74
1939,jd1604,20151105,3467,3467,3449,3478,3449,3478,3463,11,-4,4,138540,72
1940,jd1604,20151106,3478,3463,3436,3436,3436,3436,3436,-27,-27,2,68720,72
1941,jd1604,20151109,3436,3436,3438,3449,3429,3449,3438,13,2,6,206320,72
1942,jd1604,20151110,3449,3438,3406,3406,3406,3406,3406,-32,-32,2,68120,74
1943,jd1604,20151111,3406,3406,3413,3413,3413,3413,3413,7,7,2,68260,76
1944,jd1604,20151112,3413,3413,3403,3438,3403,3438,3413,25,0,8,273040,74
1945,jd1604,20151113,3438,3413,3419,3419,3419,3419,3419,6,6,2,68380,74
1946,jd1604,20151116,3419,3419,3400,3400,3351,3351,3372,-68,-47,32,1079340,80
1947,jd1604,20151117,3351,3372,3355,3355,3306,3306,3327,-66,-45,18,598860,76
1948,jd1604,20151118,3306,3327,3300,3300,3268,3268,3281,-59,-46,14,459360,76
1949,jd1604,20151119,3268,3281,3300,3301,3214,3214,3259,-67,-22,24,782160,84
1950,jd1604,20151120,3214,3259,3231,3276,3231,3276,3253,17,-6,4,130140,82
1951,jd1604,20151123,3276,3253,3227,3235,3189,3189,3218,-64,-35,20,643640,80
1952,jd1604,20151124,3189,3218,3194,3194,3176,3176,3185,-42,-33,4,127400,78
1953,jd1604,20151125,3176,3185,3173,3223,3166,3223,3186,38,1,22,701060,68
1954,jd1604,20151126,3223,3186,3221,3273,3221,3256,3256,70,70,14,455940,62
1955,jd1604,20151127,3256,3256,3206,3208,3206,3208,3206,-48,-50,10,320680,60
1956,jd1604,20151130,3208,3206,3239,3268,3231,3268,3247,62,41,12,389680,62
1957,jd1604,20151201,3268,3247,3252,3292,3242,3242,3276,-5,29,42,1376060,82
1958,jd1604,20151202,3242,3276,3242,3242,3242,3242,3242,-34,-34,2,64840,82
1959,jd1604,20151203,3242,3242,3227,3227,3227,3227,3227,-15,-15,2,64540,82
1960,jd1604,20151204,3227,3227,3250,3250,3250,3250,3250,23,23,2,65000,82
1961,jd1604,20151207,3250,3250,0,0,0,3250,3250,0,0,0,0,82
1962,jd1604,20151208,3250,3250,3210,3211,3182,3211,3193,-39,-57,20,638640,82
1963,jd1604,20151209,3211,3193,3178,3178,3178,3178,3178,-15,-15,4,127120,84
1964,jd1604,20151210,3178,3178,3125,3191,3125,3175,3160,-3,-18,18,568840,80
1965,jd1604,20151211,3175,3160,0,0,0,3160,3160,0,0,0,0,80
1966,jd1604,20151214,3160,3160,3158,3158,3151,3151,3152,-9,-8,10,315240,82
1967,jd1604,20151215,3151,3152,3221,3221,3155,3174,3193,22,41,36,1149760,94
1968,jd1604,20151216,3174,3193,3172,3175,3172,3175,3173,-18,-20,6,190400,94
1969,jd1604,20151217,3175,3173,0,0,0,3173,3173,0,0,0,0,94
1970,jd1604,20151218,3173,3173,0,0,0,3175,3175,2,2,0,0,94
1971,jd1604,20151221,3175,3175,3209,3232,3209,3232,3217,57,42,8,257420,96
1972,jd1604,20151222,3232,3217,0,0,0,3217,3217,0,0,0,0,96
1973,jd1604,20151223,3217,3217,3217,3266,3197,3207,3220,-10,3,34,1095060,100
1974,jd1604,20151224,3207,3220,3210,3218,3210,3218,3214,-2,-6,4,128560,98
1975,jd1604,20151225,3218,3214,3214,3214,3186,3186,3200,-28,-14,4,128000,98
1976,jd1604,20151228,3186,3200,0,0,0,3164,3164,-36,-36,0,0,98
1977,jd1604,20151229,3164,3164,3216,3216,3075,3198,3165,34,1,48,1519620,108
1978,jd1604,20151230,3198,3165,0,0,0,3165,3165,0,0,0,0,108
1979,jd1604,20151231,3165,3165,3170,3170,3170,3170,3170,5,5,4,126800,110
1980,jd1605,20150518,4028,4028,4026,4028,3997,3998,4010,-30,-18,396,15882460,338
1981,jd1605,20150519,3998,4010,4002,4005,3964,3964,3981,-46,-29,158,6290940,438
1982,jd1605,20150520,3964,3981,3964,3965,3933,3940,3952,-41,-29,208,8221440,534
1983,jd1605,20150521,3940,3952,3948,3961,3943,3950,3950,-2,-2,82,3239500,580
1984,jd1605,20150522,3950,3950,3944,3960,3922,3951,3944,1,-6,202,7968520,586
1985,jd1605,20150525,3951,3944,3930,3954,3910,3927,3924,-17,-20,220,8633860,750
1986,jd1605,20150526,3927,3924,3930,3950,3926,3937,3939,13,15,110,4333200,758
1987,jd1605,20150527,3937,3939,3929,3969,3928,3966,3946,27,7,124,4894200,734
1988,jd1605,20150528,3966,3946,3980,3980,3952,3963,3963,17,17,56,2219340,726
1989,jd1605,20150529,3963,3963,3964,3964,3952,3954,3956,-9,-7,126,4985560,664
1990,jd1605,20150601,3954,3956,3960,4015,3960,3983,3996,27,40,292,11668460,682
1991,jd1605,20150602,3983,3996,3978,3994,3978,3982,3984,-14,-12,28,1115780,692
1992,jd1605,20150603,3982,3984,4000,4008,3976,3986,3991,2,7,126,5029700,700
1993,jd1605,20150604,3986,3991,3970,3995,3967,3995,3982,4,-9,228,9079700,780
1994,jd1605,20150605,3995,3982,3995,4010,3981,3998,3998,16,16,264,10555580,736
1995,jd1605,20150608,3998,3998,4000,4006,3976,3990,3998,-8,0,62,2478800,746
1996,jd1605,20150609,3990,3998,4005,4020,4001,4013,4010,15,12,158,6336020,680
1997,jd1605,20150610,4013,4010,4026,4029,4000,4007,4016,-3,6,98,3936400,724
1998,jd1605,20150611,4007,4016,4016,4016,4005,4005,4008,-11,-8,30,1202600,728
1999,jd1605,20150612,4005,4008,4005,4018,3966,3993,3993,-15,-15,262,10462020,818
2000,jd1605,20150615,3993,3993,3995,3995,3977,3989,3987,-4,-6,170,6777940,794
2001,jd1605,20150616,3989,3987,4006,4006,3976,3989,3995,2,8,88,3516160,824
2002,jd1605,20150617,3989,3995,4005,4008,3987,3994,3996,-1,1,172,6874020,882
2003,jd1605,20150618,3994,3996,4002,4026,3980,4020,4015,24,19,216,8673320,998
2004,jd1605,20150619,4020,4015,4011,4049,4011,4034,4037,19,22,154,6217020,1046
2005,jd1605,20150623,4034,4037,4049,4068,4037,4060,4051,23,14,138,5591740,1060
2006,jd1605,20150624,4060,4051,4048,4068,4030,4051,4053,0,2,200,8107520,1176
2007,jd1605,20150625,4051,4053,4065,4106,4065,4104,4096,51,43,212,8684560,1118
2008,jd1605,20150626,4104,4096,4115,4116,4089,4096,4097,0,1,108,4425780,1106
2009,jd1605,20150629,4096,4097,4090,4196,4088,4105,4107,8,10,288,11830920,1178
2010,jd1605,20150630,4105,4107,4111,4111,4065,4100,4086,-7,-21,282,11523300,1182
2011,jd1605,20150701,4100,4086,4106,4155,4103,4125,4124,39,38,350,14434880,1230
2012,jd1605,20150702,4125,4124,4106,4124,4103,4118,4114,-6,-10,84,3456240,1248
2013,jd1605,20150703,4118,4114,4129,4167,4120,4165,4153,51,39,152,6313180,1294
2014,jd1605,20150706,4165,4153,4180,4180,4146,4172,4161,19,8,208,8655940,1328
2015,jd1605,20150707,4172,4161,4169,4180,4158,4169,4171,8,10,294,12263140,1374
2016,jd1605,20150708,4169,4171,4126,4126,3963,3970,4024,-201,-147,1800,72432780,1588
2017,jd1605,20150709,3970,4024,3997,4172,3997,4135,4115,111,91,1380,56790220,1260
2018,jd1605,20150710,4135,4115,4169,4178,4136,4154,4161,39,46,590,24554680,1330
2019,jd1605,20150713,4154,4161,4180,4197,4150,4159,4162,-2,1,334,13901180,1348
2020,jd1605,20150714,4159,4162,4160,4222,4160,4189,4184,27,22,556,23267000,1312
2021,jd1605,20150715,4189,4184,4170,4184,4168,4184,4175,0,-9,166,6930960,1298
2022,jd1605,20150716,4184,4175,4170,4192,4169,4181,4180,6,5,370,15469640,1256
2023,jd1605,20150717,4181,4180,4181,4185,4168,4181,4172,1,-8,266,11098720,1356
2024,jd1605,20150720,4181,4172,4180,4230,4176,4230,4204,58,32,378,15893400,1548
2025,jd1605,20150721,4230,4204,4225,4297,4225,4287,4276,83,72,972,41568900,2124
2026,jd1605,20150722,4287,4276,4298,4298,4270,4284,4280,8,4,684,29275620,2366
2027,jd1605,20150723,4284,4280,4293,4298,4267,4298,4286,18,6,536,22976660,2498
2028,jd1605,20150724,4298,4286,4302,4330,4268,4282,4285,-4,-1,880,37708560,2966
2029,jd1605,20150727,4282,4285,4273,4273,4200,4210,4228,-75,-57,1056,44657820,3332
2030,jd1605,20150728,4210,4228,4203,4256,4190,4228,4234,0,6,1306,55298220,3436
2031,jd1605,20150729,4228,4234,4235,4235,4160,4166,4180,-68,-54,1314,54925840,3794
2032,jd1605,20150730,4166,4180,4164,4194,4158,4180,4174,0,-6,806,33643460,3770
2033,jd1605,20150731,4180,4174,4190,4216,4186,4215,4198,41,24,840,35271160,4086
2034,jd1605,20150803,4215,4198,4224,4229,4185,4191,4211,-7,13,1932,81360440,4070
2035,jd1605,20150804,4191,4211,4198,4220,4185,4202,4202,-9,-9,572,24038820,4172
2036,jd1605,20150805,4202,4202,4186,4198,4119,4120,4151,-82,-51,778,32297720,4374
2037,jd1605,20150806,4120,4151,4140,4146,4076,4080,4117,-71,-34,818,33680320,4712
2038,jd1605,20150807,4080,4117,4080,4091,3997,4017,4033,-100,-84,1762,71062040,5214
2039,jd1605,20150810,4017,4033,4027,4040,3997,4000,4010,-33,-23,1346,53984140,5430
2040,jd1605,20150811,4000,4010,4027,4050,4002,4012,4029,2,19,1188,47865740,5700
2041,jd1605,20150812,4012,4029,4005,4029,4005,4016,4020,-13,-9,544,21869320,5696
2042,jd1605,20150813,4016,4020,4020,4046,3957,4025,4016,5,-4,1052,42249460,5928
2043,jd1605,20150814,4025,4016,4039,4072,4023,4026,4044,10,28,1402,56709540,6102
2044,jd1605,20150817,4026,4044,4012,4038,4006,4012,4018,-32,-26,564,22666660,6338
2045,jd1605,20150818,4012,4018,4018,4020,4001,4001,4011,-17,-7,430,17247560,6444
2046,jd1605,20150819,4001,4011,3994,4025,3960,4013,3990,2,-21,928,37035240,6636
2047,jd1605,20150820,4013,3990,4000,4020,3970,3970,3990,-20,0,1448,57778340,7256
2048,jd1605,20150821,3970,3990,3989,3992,3951,3951,3976,-39,-14,1232,48984940,7726
2049,jd1605,20150824,3951,3976,3915,3945,3865,3880,3895,-96,-81,3060,119202740,7788
2050,jd1605,20150825,3880,3895,3958,3958,3806,3844,3871,-51,-24,2300,89048400,8338
2051,jd1605,20150826,3844,3871,3868,3868,3785,3794,3823,-77,-48,2742,104839640,9588
2052,jd1605,20150827,3794,3823,3801,3819,3785,3802,3805,-21,-18,2036,77480500,10336
2053,jd1605,20150828,3802,3805,3830,3853,3778,3785,3816,-20,11,3902,148903320,10738
2054,jd1605,20150831,3785,3816,3785,3810,3751,3787,3783,-29,-33,3424,129531840,11128
2055,jd1605,20150901,3787,3783,3783,3798,3776,3791,3787,8,4,1830,69317020,11370
2056,jd1605,20150902,3791,3787,3785,3793,3759,3790,3776,3,-11,2654,100237680,11996
2057,jd1605,20150907,3790,3776,3815,3820,3785,3793,3796,17,20,2768,105082740,12746
2058,jd1605,20150908,3793,3796,3794,3806,3788,3800,3793,4,-3,3062,116165600,13014
2059,jd1605,20150909,3800,3793,3820,3830,3786,3788,3807,-5,14,5026,191388100,13798
2060,jd1605,20150910,3788,3807,3786,3793,3772,3772,3781,-35,-26,5528,209052800,15678
2061,jd1605,20150911,3772,3781,3773,3790,3762,3779,3774,-2,-7,4714,177937780,16640
2062,jd1605,20150914,3779,3774,3750,3779,3717,3720,3741,-54,-33,8198,306765360,20140
2063,jd1605,20150915,3720,3741,3716,3728,3670,3676,3699,-65,-42,11118,411317560,22798
2064,jd1605,20150916,3676,3699,3673,3683,3658,3676,3669,-23,-30,8210,301263440,23010
2065,jd1605,20150917,3676,3669,3671,3686,3645,3646,3660,-23,-9,7816,286130260,25632
2066,jd1605,20150918,3646,3660,3643,3661,3628,3656,3647,-4,-13,9620,350887260,25834
2067,jd1605,20150921,3656,3647,3658,3663,3641,3649,3649,2,2,4958,180964460,27020
2068,jd1605,20150922,3649,3649,3655,3656,3602,3608,3616,-41,-33,9760,352949680,29458
2069,jd1605,20150923,3608,3616,3602,3622,3591,3612,3608,-4,-8,8044,290295560,28990
2070,jd1605,20150924,3612,3608,3609,3612,3591,3594,3600,-14,-8,7196,259121620,30414
2071,jd1605,20150925,3594,3600,3600,3633,3592,3593,3609,-7,9,13018,469862420,32794
2072,jd1605,20150928,3593,3609,3593,3609,3569,3601,3598,-8,-11,8278,297876100,32952
2073,jd1605,20150929,3601,3598,3598,3599,3553,3563,3571,-35,-27,11898,424938340,33002
2074,jd1605,20150930,3563,3571,3555,3568,3532,3536,3548,-35,-23,8356,296480120,35800
2075,jd1605,20151008,3536,3548,3550,3550,3525,3527,3537,-21,-11,11104,392784440,39110
2076,jd1605,20151009,3527,3537,3530,3536,3503,3516,3520,-21,-17,15926,560624340,41786
2077,jd1605,20151012,3516,3520,3501,3503,3469,3486,3485,-34,-35,16296,568023300,44892
2078,jd1605,20151013,3486,3485,3486,3486,3469,3477,3474,-8,-11,10392,361087720,46932
2079,jd1605,20151014,3477,3474,3479,3500,3475,3492,3489,18,15,14930,520984520,46538
2080,jd1605,20151015,3492,3489,3495,3528,3493,3518,3513,29,24,14826,520962860,46668
2081,jd1605,20151016,3518,3513,3517,3543,3510,3519,3524,6,11,15196,535641060,45518
2082,jd1605,20151019,3519,3524,3526,3528,3501,3504,3512,-20,-12,10934,384072960,45342
2083,jd1605,20151020,3504,3512,3502,3520,3502,3518,3513,6,1,7158,251515620,43998
2084,jd1605,20151021,3518,3513,3529,3529,3502,3507,3516,-6,3,11156,392276260,45096
2085,jd1605,20151022,3507,3516,3512,3527,3510,3519,3518,3,2,6996,246165400,45240
2086,jd1605,20151023,3519,3518,3520,3524,3493,3508,3503,-10,-15,13700,480029820,44614
2087,jd1605,20151026,3508,3503,3500,3510,3493,3498,3499,-5,-4,6386,223447980,45276
2088,jd1605,20151027,3498,3499,3496,3496,3429,3457,3450,-42,-49,21248,733226720,50310
2089,jd1605,20151028,3457,3450,3453,3460,3433,3444,3444,-6,-6,8774,302252420,52198
2090,jd1605,20151029,3444,3444,3440,3443,3415,3420,3428,-24,-16,11638,399066300,56106
2091,jd1605,20151030,3420,3428,3415,3455,3415,3427,3432,-1,4,9002,309036320,55192
2092,jd1605,20151102,3427,3432,3427,3443,3405,3436,3425,4,-7,8626,295516940,55554
2093,jd1605,20151103,3436,3425,3441,3500,3430,3490,3470,65,45,27344,948968120,52248
2094,jd1605,20151104,3490,3470,3488,3508,3481,3498,3492,28,22,14482,505837280,54242
2095,jd1605,20151105,3498,3492,3505,3510,3483,3493,3494,1,2,12750,445536120,54622
2096,jd1605,20151106,3493,3494,3502,3504,3453,3464,3469,-30,-25,20102,697371160,55818
2097,jd1605,20151109,3464,3469,3452,3481,3452,3458,3464,-11,-5,14318,496100560,57182
2098,jd1605,20151110,3458,3464,3454,3465,3436,3438,3450,-26,-14,14036,484273600,58500
2099,jd1605,20151111,3438,3450,3440,3450,3427,3447,3441,-3,-9,10432,359017120,58440
2100,jd1605,20151112,3447,3441,3440,3461,3430,3458,3447,17,6,13142,453064320,59206
2101,jd1605,20151113,3458,3447,3460,3462,3440,3450,3449,3,2,8690,299753200,59296
2102,jd1605,20151116,3450,3449,3446,3448,3332,3334,3370,-115,-79,52124,1756765100,69984
2103,jd1605,20151117,3334,3370,3330,3348,3288,3314,3314,-56,-56,33464,1109269900,70672
2104,jd1605,20151118,3314,3314,3314,3325,3264,3268,3287,-46,-27,33068,1087245280,77134
2105,jd1605,20151119,3268,3287,3265,3279,3201,3226,3239,-61,-48,37982,1230433800,77010
2106,jd1605,20151120,3226,3239,3235,3283,3204,3247,3239,8,0,44450,1440124260,75942
2107,jd1605,20151123,3247,3239,3241,3266,3128,3156,3194,-83,-45,45692,1459802360,78686
2108,jd1605,20151124,3156,3194,3152,3210,3143,3191,3182,-3,-12,35822,1140140800,78252
2109,jd1605,20151125,3191,3182,3218,3248,3155,3217,3191,35,9,54546,1740794980,80094
2110,jd1605,20151126,3217,3191,3226,3312,3205,3230,3248,39,57,81224,2638617640,79210
2111,jd1605,20151127,3230,3248,3235,3248,3201,3215,3222,-33,-26,48652,1567977880,85384
2112,jd1605,20151130,3215,3222,3202,3307,3150,3296,3253,74,31,115722,3765114680,91296
2113,jd1605,20151201,3296,3253,3300,3338,3270,3271,3303,18,50,120982,3996341960,94262
2114,jd1605,20151202,3271,3303,3285,3336,3285,3330,3316,27,13,91566,3037213820,98856
2115,jd1605,20151203,3330,3316,3324,3325,3280,3287,3296,-29,-20,72958,2405017060,95910
2116,jd1605,20151204,3287,3296,3284,3295,3250,3270,3267,-26,-29,69666,2276246240,99776
2117,jd1605,20151207,3270,3267,3273,3298,3257,3268,3277,1,10,67472,2211248320,106152
2118,jd1605,20151208,3268,3277,3255,3257,3184,3192,3207,-85,-70,101352,3250762700,116774
2119,jd1605,20151209,3192,3207,3200,3220,3173,3176,3194,-31,-13,73264,2340317440,127028
2120,jd1605,20151210,3176,3194,3171,3210,3162,3183,3186,-11,-8,64294,2048848180,125144
2121,jd1605,20151211,3183,3186,3195,3205,3176,3193,3191,7,5,63156,2015852500,121046
2122,jd1605,20151214,3193,3191,3183,3185,3141,3169,3160,-22,-31,94282,2980134360,131822
2123,jd1605,20151215,3169,3160,3172,3219,3170,3175,3193,15,33,92128,2941970020,133634
2124,jd1605,20151216,3175,3193,3170,3205,3161,3192,3187,-1,-6,71346,2273851400,133556
2125,jd1605,20151217,3192,3187,3200,3211,3172,3176,3193,-11,6,78658,2512134200,137416
2126,jd1605,20151218,3176,3193,3181,3219,3181,3211,3204,18,11,93146,2984727800,141172
2127,jd1605,20151221,3211,3204,3221,3296,3221,3290,3262,86,58,124910,4075423600,134080
2128,jd1605,20151222,3290,3262,3290,3320,3268,3287,3295,25,33,109646,3613475460,131764
2129,jd1605,20151223,3287,3295,3295,3296,3251,3272,3267,-23,-28,67740,2213495220,130586
2130,jd1605,20151224,3272,3267,3267,3300,3262,3282,3280,15,13,68864,2259300800,135652
2131,jd1605,20151225,3282,3280,3282,3296,3249,3263,3268,-17,-12,77698,2539476040,143398
2132,jd1605,20151228,3263,3268,3254,3255,3184,3188,3207,-80,-61,129944,4168218000,155990
2133,jd1605,20151229,3188,3207,3184,3216,3181,3201,3200,-6,-7,81966,2623543780,154256
2134,jd1605,20151230,3201,3200,3209,3248,3195,3209,3220,9,20,129450,4168489880,155922
2135,jd1605,20151231,3209,3220,3212,3228,3202,3209,3215,-11,-5,76340,2454871460,157210
2136,jd1606,20150615,3977,3977,0,0,0,3977,3977,0,0,0,0,0
2137,jd1606,20150616,3977,3977,0,0,0,3977,3977,0,0,0,0,0
2138,jd1606,20150617,3977,3977,0,0,0,3977,3977,0,0,0,0,0
2139,jd1606,20150618,3977,3977,4150,4150,3901,4035,4027,58,50,10,402740,2
2140,jd1606,20150619,4035,4027,0,0,0,4027,4027,0,0,0,0,2
2141,jd1606,20150623,4027,4027,0,0,0,4050,4050,23,23,0,0,2
2142,jd1606,20150624,4050,4050,0,0,0,4050,4050,0,0,0,0,2
2143,jd1606,20150625,4050,4050,4107,4107,4107,4107,4107,57,57,2,82140,0
2144,jd1606,20150626,4107,4107,0,0,0,4107,4107,0,0,0,0,0
2145,jd1606,20150629,4107,4107,0,0,0,4107,4107,0,0,0,0,0
2146,jd1606,20150630,4107,4107,0,0,0,4087,4087,-20,-20,0,0,0
2147,jd1606,20150701,4087,4087,0,0,0,4125,4125,38,38,0,0,0
2148,jd1606,20150702,4125,4125,0,0,0,4125,4125,0,0,0,0,0
2149,jd1606,20150703,4125,4125,0,0,0,4125,4125,0,0,0,0,0
2150,jd1606,20150706,4125,4125,4146,4168,4145,4168,4156,43,31,8,332540,0
2151,jd1606,20150707,4168,4156,0,0,0,4165,4165,9,9,0,0,0
2152,jd1606,20150708,4165,4165,4002,4002,3957,3957,3972,-208,-193,12,476640,8
2153,jd1606,20150709,3957,3972,4025,4150,4025,4150,4087,178,115,4,163500,10
2154,jd1606,20150710,4150,4087,0,0,0,4087,4087,0,0,0,0,10
2155,jd1606,20150713,4087,4087,4055,4055,4055,4055,4055,-32,-32,2,81100,10
2156,jd1606,20150714,4055,4055,4161,4161,4161,4161,4161,106,106,2,83220,10
2157,jd1606,20150715,4161,4161,0,0,0,4159,4159,-2,-2,0,0,10
2158,jd1606,20150716,4159,4159,0,0,0,4159,4159,0,0,0,0,10
2159,jd1606,20150717,4159,4159,0,0,0,4158,4158,-1,-1,0,0,10
2160,jd1606,20150720,4158,4158,4154,4154,4123,4124,4133,-34,-25,6,248020,10
2161,jd1606,20150721,4124,4133,0,0,0,4219,4219,86,86,0,0,10
2162,jd1606,20150722,4219,4219,0,0,0,4222,4222,3,3,0,0,10
2163,jd1606,20150723,4222,4222,0,0,0,4225,4225,3,3,0,0,10
2164,jd1606,20150724,4225,4225,0,0,0,4225,4225,0,0,0,0,10
2165,jd1606,20150727,4225,4225,0,0,0,4222,4222,-3,-3,0,0,10
2166,jd1606,20150728,4222,4222,0,0,0,4222,4222,0,0,0,0,10
2167,jd1606,20150729,4222,4222,0,0,0,4193,4193,-29,-29,0,0,10
2168,jd1606,20150730,4193,4193,4176,4176,4176,4176,4176,-17,-17,2,83520,12
2169,jd1606,20150731,4176,4176,0,0,0,4176,4176,0,0,0,0,12
2170,jd1606,20150803,4176,4176,0,0,0,4176,4176,0,0,0,0,12
2171,jd1606,20150804,4176,4176,0,0,0,4176,4176,0,0,0,0,12
2172,jd1606,20150805,4176,4176,4075,4075,4075,4075,4075,-101,-101,2,81500,10
2173,jd1606,20150806,4075,4075,0,0,0,4075,4075,0,0,0,0,10
2174,jd1606,20150807,4075,4075,0,0,0,4075,4075,0,0,0,0,10
2175,jd1606,20150810,4075,4075,0,0,0,4075,4075,0,0,0,0,10
2176,jd1606,20150811,4075,4075,0,0,0,4075,4075,0,0,0,0,10
2177,jd1606,20150812,4075,4075,0,0,0,4075,4075,0,0,0,0,10
2178,jd1606,20150813,4075,4075,4024,4024,4024,4024,4024,-51,-51,2,80480,12
2179,jd1606,20150814,4024,4024,0,0,0,4024,4024,0,0,0,0,12
2180,jd1606,20150817,4024,4024,0,0,0,4024,4024,0,0,0,0,12
2181,jd1606,20150818,4024,4024,0,0,0,4013,4013,-11,-11,0,0,12
2182,jd1606,20150819,4013,4013,4005,4005,4005,4005,4005,-8,-8,4,160200,12
2183,jd1606,20150820,4005,4005,0,0,0,4005,4005,0,0,0,0,12
2184,jd1606,20150821,4005,4005,0,0,0,4005,4005,0,0,0,0,12
2185,jd1606,20150824,4005,4005,3956,3958,3956,3958,3957,-47,-48,4,158280,12
2186,jd1606,20150825,3958,3957,0,0,0,3957,3957,0,0,0,0,12
2187,jd1606,20150826,3957,3957,3900,3900,3900,3900,3900,-57,-57,2,78000,12
2188,jd1606,20150827,3900,3900,0,0,0,3900,3900,0,0,0,0,12
2189,jd1606,20150828,3900,3900,3941,3941,3890,3890,3915,-10,15,4,156620,12
2190,jd1606,20150831,3890,3915,0,0,0,3915,3915,0,0,0,0,12
2191,jd1606,20150901,3915,3915,0,0,0,3915,3915,0,0,0,0,12
2192,jd1606,20150902,3915,3915,0,0,0,3915,3915,0,0,0,0,12
2193,jd1606,20150907,3915,3915,0,0,0,3915,3915,0,0,0,0,12
2194,jd1606,20150908,3915,3915,0,0,0,3915,3915,0,0,0,0,12
2195,jd1606,20150909,3915,3915,0,0,0,3915,3915,0,0,0,0,12
2196,jd1606,20150910,3915,3915,0,0,0,3915,3915,0,0,0,0,12
2197,jd1606,20150911,3915,3915,0,0,0,3915,3915,0,0,0,0,12
2198,jd1606,20150914,3915,3915,0,0,0,3915,3915,0,0,0,0,12
2199,jd1606,20150915,3915,3915,0,0,0,3891,3891,-24,-24,0,0,12
2200,jd1606,20150916,3891,3891,3721,3721,3721,3721,3721,-170,-170,2,74420,14
2201,jd1606,20150917,3721,3721,0,0,0,3721,3721,0,0,0,0,14
2202,jd1606,20150918,3721,3721,0,0,0,3721,3721,0,0,0,0,14
2203,jd1606,20150921,3721,3721,0,0,0,3721,3721,0,0,0,0,14
2204,jd1606,20150922,3721,3721,3615,3615,3615,3615,3615,-106,-106,2,72300,14
2205,jd1606,20150923,3615,3615,0,0,0,3615,3615,0,0,0,0,14
2206,jd1606,20150924,3615,3615,0,0,0,3616,3616,1,1,0,0,14
2207,jd1606,20150925,3616,3616,0,0,0,3616,3616,0,0,0,0,14
2208,jd1606,20150928,3616,3616,0,0,0,3616,3616,0,0,0,0,14
2209,jd1606,20150929,3616,3616,0,0,0,3548,3548,-68,-68,0,0,14
2210,jd1606,20150930,3548,3548,0,0,0,3548,3548,0,0,0,0,14
2211,jd1606,20151008,3548,3548,3600,3600,3600,3600,3600,52,52,2,72000,14
2212,jd1606,20151009,3600,3600,0,0,0,3600,3600,0,0,0,0,14
2213,jd1606,20151012,3600,3600,0,0,0,3590,3590,-10,-10,0,0,14
2214,jd1606,20151013,3590,3590,3500,3500,3500,3500,3500,-90,-90,2,70000,16
2215,jd1606,20151014,3500,3500,0,0,0,3500,3500,0,0,0,0,16
2216,jd1606,20151015,3500,3500,0,0,0,3510,3510,10,10,0,0,16
2217,jd1606,20151016,3510,3510,0,0,0,3510,3510,0,0,0,0,16
2218,jd1606,20151019,3510,3510,0,0,0,3510,3510,0,0,0,0,16
2219,jd1606,20151020,3510,3510,0,0,0,3510,3510,0,0,0,0,16
2220,jd1606,20151021,3510,3510,0,0,0,3510,3510,0,0,0,0,16
2221,jd1606,20151022,3510,3510,0,0,0,3510,3510,0,0,0,0,16
2222,jd1606,20151023,3510,3510,3460,3460,3460,3460,3460,-50,-50,2,69200,18
2223,jd1606,20151026,3460,3460,3458,3565,3458,3565,3503,105,43,6,210220,18
2224,jd1606,20151027,3565,3503,3459,3533,3459,3533,3484,30,-19,6,209040,22
2225,jd1606,20151028,3533,3484,3449,3450,3449,3450,3449,-34,-35,4,137980,20
2226,jd1606,20151029,3450,3449,0,0,0,3449,3449,0,0,0,0,20
2227,jd1606,20151030,3449,3449,3440,3440,3440,3440,3440,-9,-9,2,68800,22
2228,jd1606,20151102,3440,3440,0,0,0,3440,3440,0,0,0,0,22
2229,jd1606,20151103,3440,3440,0,0,0,3440,3440,0,0,0,0,22
2230,jd1606,20151104,3440,3440,3461,3486,3443,3486,3463,46,23,6,207800,24
2231,jd1606,20151105,3486,3463,0,0,0,3463,3463,0,0,0,0,24
2232,jd1606,20151106,3463,3463,0,0,0,3463,3463,0,0,0,0,24
2233,jd1606,20151109,3463,3463,0,0,0,3423,3423,-40,-40,0,0,24
2234,jd1606,20151110,3423,3423,3426,3431,3424,3431,3426,8,3,12,411160,20
2235,jd1606,20151111,3431,3426,3420,3430,3420,3422,3424,-4,-2,6,205440,20
2236,jd1606,20151112,3422,3424,3436,3450,3436,3450,3443,26,19,4,137720,22
2237,jd1606,20151113,3450,3443,3451,3452,3451,3452,3451,9,8,4,138060,22
2238,jd1606,20151116,3452,3451,3409,3442,3362,3362,3387,-89,-64,20,677520,22
2239,jd1606,20151117,3362,3387,3332,3332,3332,3332,3332,-55,-55,4,133280,20
2240,jd1606,20151118,3332,3332,0,0,0,3332,3332,0,0,0,0,20
2241,jd1606,20151119,3332,3332,3226,3226,3223,3223,3224,-109,-108,10,322420,24
2242,jd1606,20151120,3223,3224,3223,3344,3223,3306,3278,82,54,10,327840,24
2243,jd1606,20151123,3306,3278,3299,3300,3211,3215,3248,-63,-30,22,714740,36
2244,jd1606,20151124,3215,3248,3164,3164,3164,3164,3164,-84,-84,2,63280,34
2245,jd1606,20151125,3164,3164,3282,3282,3150,3199,3210,35,46,6,192620,36
2246,jd1606,20151126,3199,3210,3252,3354,3230,3307,3305,97,95,46,1520560,50
2247,jd1606,20151127,3307,3305,3266,3300,3242,3275,3272,-30,-33,24,785460,64
2248,jd1606,20151130,3275,3272,3356,3356,3277,3320,3307,48,35,10,330760,68
2249,jd1606,20151201,3320,3307,3293,3293,3246,3246,3267,-61,-40,10,326740,72
2250,jd1606,20151202,3246,3267,3273,3324,3273,3273,3287,6,20,10,328720,70
2251,jd1606,20151203,3273,3287,3258,3287,3258,3271,3272,-16,-15,6,196320,72
2252,jd1606,20151204,3271,3272,3271,3271,3271,3271,3271,-1,-1,2,65420,72
2253,jd1606,20151207,3271,3271,3248,3275,3226,3234,3238,-37,-33,16,518140,72
2254,jd1606,20151208,3234,3238,3211,3211,3187,3201,3200,-37,-38,46,1472160,74
2255,jd1606,20151209,3201,3200,3202,3204,3188,3188,3194,-12,-6,10,319440,80
2256,jd1606,20151210,3188,3194,3203,3203,3177,3178,3186,-16,-8,6,191160,82
2257,jd1606,20151211,3178,3186,3176,3206,3176,3206,3199,20,13,10,319940,86
2258,jd1606,20151214,3206,3199,0,0,0,3199,3199,0,0,0,0,86
2259,jd1606,20151215,3199,3199,3178,3194,3178,3194,3182,-5,-17,8,254560,82
2260,jd1606,20151216,3194,3182,0,0,0,3182,3182,0,0,0,0,82
2261,jd1606,20151217,3182,3182,3197,3198,3195,3195,3196,13,14,10,319640,90
2262,jd1606,20151218,3195,3196,3201,3207,3196,3207,3201,11,5,10,320120,90
2263,jd1606,20151221,3207,3201,3299,3299,3211,3278,3253,77,52,28,911100,92
2264,jd1606,20151222,3278,3253,0,0,0,3253,3253,0,0,0,0,92
2265,jd1606,20151223,3253,3253,3233,3233,3233,3233,3233,-20,-20,2,64660,92
2266,jd1606,20151224,3233,3233,3258,3258,3258,3258,3258,25,25,4,130320,92
2267,jd1606,20151225,3258,3258,0,0,0,3258,3258,0,0,0,0,92
2268,jd1606,20151228,3258,3258,3226,3226,3191,3218,3213,-40,-45,14,449900,104
2269,jd1606,20151229,3218,3213,3218,3218,3210,3210,3214,-3,1,4,128560,100
2270,jd1606,20151230,3210,3214,3238,3238,3211,3215,3217,1,3,14,450400,100
2271,jd1606,20151231,3215,3217,3245,3245,3205,3238,3229,21,12,30,968800,114
2272,jd1609,20150917,3699,3699,3994,3994,3925,3994,3993,295,294,2184,87214240,1936
2273,jd1609,20150918,3994,3993,4003,4059,3993,4051,4025,58,32,2490,100235780,3138
2274,jd1609,20150921,4051,4025,4035,4051,4029,4040,4039,15,14,624,25207860,3396
2275,jd1609,20150922,4040,4039,4056,4056,3992,4018,4009,-21,-30,1562,62633740,3894
2276,jd1609,20150923,4018,4009,4002,4020,3956,4001,3988,-8,-21,2792,111352560,4816
2277,jd1609,20150924,4001,3988,3991,3998,3961,3970,3979,-18,-9,1340,53329860,5290
2278,jd1609,20150925,3970,3979,3980,4013,3941,3945,3974,-34,-5,3182,126474240,6210
2279,jd1609,20150928,3945,3974,3949,3968,3883,3890,3916,-84,-58,5014,196355080,8834
2280,jd1609,20150929,3890,3916,3883,3883,3770,3816,3835,-100,-81,4654,178526640,10910
2281,jd1609,20150930,3816,3835,3816,3825,3800,3816,3808,-19,-27,2824,107557460,12044
2282,jd1609,20151008,3816,3808,3809,3836,3798,3803,3813,-5,5,3416,130285240,12328
2283,jd1609,20151009,3803,3813,3800,3804,3776,3795,3792,-18,-21,3858,146296260,11910
2284,jd1609,20151012,3795,3792,3782,3790,3770,3780,3778,-12,-14,3206,121136480,12608
2285,jd1609,20151013,3780,3778,3770,3779,3765,3779,3773,1,-5,1094,41278320,12938
2286,jd1609,20151014,3779,3773,3788,3818,3779,3818,3803,45,30,2772,105422260,13656
2287,jd1609,20151015,3818,3803,3816,3993,3814,3878,3865,75,62,8022,310083180,14034
2288,jd1609,20151016,3878,3865,3879,3937,3871,3882,3894,17,29,5236,203928880,14664
2289,jd1609,20151019,3882,3894,3885,3893,3873,3876,3881,-18,-13,1634,63423820,14626
2290,jd1609,20151020,3876,3881,3877,3888,3873,3884,3881,3,0,1142,44325560,14916
2291,jd1609,20151021,3884,3881,3884,3896,3869,3874,3882,-7,1,1154,44798620,15156
2292,jd1609,20151022,3874,3882,3880,3887,3872,3886,3883,4,1,1042,40464220,14892
2293,jd1609,20151023,3886,3883,3882,3887,3837,3861,3858,-22,-25,1986,76630620,14934
2294,jd1609,20151026,3861,3858,3856,3865,3850,3854,3855,-4,-3,918,35396040,14936
2295,jd1609,20151027,3854,3855,3853,3853,3778,3813,3806,-42,-49,5874,223564920,15404
2296,jd1609,20151028,3813,3806,3811,3818,3801,3813,3809,7,3,1148,43736200,15530
2297,jd1609,20151029,3813,3809,3810,3817,3803,3811,3811,2,2,1878,71579180,16502
2298,jd1609,20151030,3811,3811,3812,3863,3809,3836,3839,25,28,5264,202122740,16064
2299,jd1609,20151102,3836,3839,3830,3845,3820,3838,3832,-1,-7,1878,71969340,16066
2300,jd1609,20151103,3838,3832,3840,3867,3830,3853,3847,21,15,4806,184934480,16628
2301,jd1609,20151104,3853,3847,3857,3873,3840,3863,3859,16,12,2370,91472440,16948
2302,jd1609,20151105,3863,3859,3870,3872,3856,3860,3862,1,3,1252,48364200,16790
2303,jd1609,20151106,3860,3862,3860,3868,3844,3863,3853,1,-9,1956,75380520,16604
2304,jd1609,20151109,3863,3853,3815,3885,3815,3855,3863,2,10,1902,73477500,16064
2305,jd1609,20151110,3855,3863,3851,3865,3837,3838,3851,-25,-12,1698,65393460,15894
2306,jd1609,20151111,3838,3851,3843,3851,3831,3847,3843,-4,-8,960,36895560,15874
2307,jd1609,20151112,3847,3843,3845,3861,3838,3858,3850,15,7,1326,51051800,15538
2308,jd1609,20151113,3858,3850,3862,3868,3850,3857,3857,7,7,858,33100720,15306
2309,jd1609,20151116,3857,3857,3860,3860,3806,3812,3821,-45,-36,3324,127011140,15904
2310,jd1609,20151117,3812,3821,3810,3813,3772,3790,3787,-31,-34,4700,178003240,17214
2311,jd1609,20151118,3790,3787,3787,3797,3760,3767,3775,-20,-12,3772,142407760,18384
2312,jd1609,20151119,3767,3775,3769,3778,3750,3765,3765,-10,-10,3346,125989820,18696
2313,jd1609,20151120,3765,3765,3778,3815,3764,3797,3789,32,24,5768,218599380,16986
2314,jd1609,20151123,3797,3789,3800,3805,3756,3770,3779,-19,-10,3548,134106880,16698
2315,jd1609,20151124,3770,3779,3770,3780,3751,3772,3764,-7,-15,2762,103974480,17124
2316,jd1609,20151125,3772,3764,3775,3789,3685,3687,3724,-77,-40,7874,293244640,18808
2317,jd1609,20151126,3687,3724,3685,3744,3650,3694,3687,-30,-37,13598,501462620,19640
2318,jd1609,20151127,3694,3687,3688,3708,3669,3675,3684,-12,-3,3840,141502500,20552
2319,jd1609,20151130,3675,3684,3672,3720,3648,3716,3697,32,13,6026,222818740,19310
2320,jd1609,20151201,3716,3697,3723,3748,3706,3713,3724,16,27,5384,200548980,19424
2321,jd1609,20151202,3713,3724,3713,3750,3713,3749,3733,25,9,3440,128443860,19048
2322,jd1609,20151203,3749,3733,3745,3745,3723,3738,3733,5,0,2224,83036640,18840
2323,jd1609,20151204,3738,3733,3734,3737,3707,3722,3719,-11,-14,2202,81905720,18824
2324,jd1609,20151207,3722,3719,3707,3729,3705,3725,3717,6,-2,2754,102377840,18330
2325,jd1609,20151208,3725,3717,3717,3717,3683,3690,3694,-27,-23,3840,141885200,18652
2326,jd1609,20151209,3690,3694,3694,3703,3683,3686,3691,-8,-3,2316,85492520,18686
2327,jd1609,20151210,3686,3691,3685,3690,3669,3679,3677,-12,-14,3264,120041160,20238
2328,jd1609,20151211,3679,3677,3680,3698,3675,3692,3687,15,10,2314,85334140,20248
2329,jd1609,20151214,3692,3687,3688,3688,3660,3672,3669,-15,-18,3734,137003160,20362
2330,jd1609,20151215,3672,3669,3675,3699,3670,3680,3684,11,15,2836,104496960,20216
2331,jd1609,20151216,3680,3684,3681,3695,3671,3690,3686,6,2,1992,73438820,20296
2332,jd1609,20151217,3690,3686,3693,3697,3680,3684,3687,-2,1,3064,112996640,20312
2333,jd1609,20151218,3684,3687,3687,3708,3683,3706,3697,19,10,2266,83795860,20318
2334,jd1609,20151221,3706,3697,3710,3775,3710,3774,3745,77,48,5060,189538700,19178
2335,jd1609,20151222,3774,3745,3770,3792,3765,3778,3781,33,36,3958,149668900,18410
2336,jd1609,20151223,3778,3781,3782,3782,3750,3767,3764,-14,-17,1816,68360240,18452
2337,jd1609,20151224,3767,3764,3777,3791,3760,3790,3775,26,11,4202,158643400,18864
2338,jd1609,20151225,3790,3775,3791,3795,3760,3768,3776,-7,1,1832,69177340,19180
2339,jd1609,20151228,3768,3776,3750,3760,3683,3688,3708,-88,-68,6842,253754020,21528
2340,jd1609,20151229,3688,3708,3700,3703,3680,3686,3692,-22,-16,3910,144360880,22132
2341,jd1609,20151230,3686,3692,3700,3736,3664,3689,3700,-3,8,9452,349729320,23848
2342,jd1609,20151231,3689,3700,3688,3699,3683,3689,3690,-11,-10,3276,120900680,24652
2343,jd1610,20151022,3881,3881,0,0,0,3790,3790,-91,-91,0,0,0
2344,jd1610,20151023,3790,3790,0,0,0,3766,3766,-24,-24,0,0,0
2345,jd1610,20151026,3766,3766,0,0,0,3764,3764,-2,-2,0,0,0
2346,jd1610,20151027,3764,3764,0,0,0,3734,3734,-30,-30,0,0,0
2347,jd1610,20151028,3734,3734,0,0,0,3730,3730,-4,-4,0,0,0
2348,jd1610,20151029,3730,3730,3500,3567,3500,3567,3533,-163,-197,20,706780,20
2349,jd1610,20151030,3567,3533,3557,3571,3557,3571,3560,38,27,24,854420,38
2350,jd1610,20151102,3571,3560,3570,3570,3550,3569,3566,9,6,14,499300,42
2351,jd1610,20151103,3569,3566,0,0,0,3566,3566,0,0,0,0,42
2352,jd1610,20151104,3566,3566,3566,3566,3566,3566,3566,0,0,2,71320,40
2353,jd1610,20151105,3566,3566,3576,3576,3576,3576,3576,10,10,2,71520,40
2354,jd1610,20151106,3576,3576,0,0,0,3568,3568,-8,-8,0,0,40
2355,jd1610,20151109,3568,3568,0,0,0,3568,3568,0,0,0,0,40
2356,jd1610,20151110,3568,3568,3570,3570,3570,3570,3570,2,2,2,71400,40
2357,jd1610,20151111,3570,3570,0,0,0,3570,3570,0,0,0,0,40
2358,jd1610,20151112,3570,3570,0,0,0,3570,3570,0,0,0,0,40
2359,jd1610,20151113,3570,3570,0,0,0,3570,3570,0,0,0,0,40
2360,jd1610,20151116,3570,3570,0,0,0,3542,3542,-28,-28,0,0,40
2361,jd1610,20151117,3542,3542,3485,3485,3485,3485,3485,-57,-57,2,69700,42
2362,jd1610,20151118,3485,3485,3345,3474,3345,3457,3436,-28,-49,24,824720,60
2363,jd1610,20151119,3457,3436,0,0,0,3403,3403,-33,-33,0,0,60
2364,jd1610,20151120,3403,3403,3387,3425,3386,3425,3398,22,-5,10,339800,58
2365,jd1610,20151123,3425,3398,0,0,0,3346,3346,-52,-52,0,0,58
2366,jd1610,20151124,3346,3346,3467,3483,3378,3432,3428,86,82,18,617120,62
2367,jd1610,20151125,3432,3428,3350,3399,3290,3321,3320,-107,-108,44,1460900,78
2368,jd1610,20151126,3321,3320,3297,3350,3290,3325,3316,5,-4,26,862280,92
2369,jd1610,20151127,3325,3316,3341,3345,3306,3330,3329,14,13,32,1065400,100
2370,jd1610,20151130,3330,3329,3321,3336,3312,3336,3319,7,-10,30,995780,114
2371,jd1610,20151201,3336,3319,3302,3313,3291,3311,3303,-8,-16,26,858860,128
2372,jd1610,20151202,3311,3303,3321,3357,3305,3330,3318,27,15,30,995480,146
2373,jd1610,20151203,3330,3318,3307,3340,3307,3339,3322,21,4,20,664520,160
2374,jd1610,20151204,3339,3322,3335,3341,3330,3341,3334,19,12,16,533460,160
2375,jd1610,20151207,3341,3334,3337,3356,3337,3340,3344,6,10,20,668940,162
2376,jd1610,20151208,3340,3344,3332,3332,3292,3310,3306,-34,-38,88,2909600,216
2377,jd1610,20151209,3310,3306,3309,3339,3308,3310,3317,4,11,24,796260,218
2378,jd1610,20151210,3310,3317,3300,3301,3271,3300,3295,-17,-22,48,1581820,244
2379,jd1610,20151211,3300,3295,3325,3325,3307,3315,3317,20,22,16,530760,242
2380,jd1610,20151214,3315,3317,3234,3305,3234,3300,3282,-17,-35,60,1969440,256
2381,jd1610,20151215,3300,3282,3378,3378,3279,3309,3318,27,36,18,597360,262
2382,jd1610,20151216,3309,3318,3301,3310,3301,3303,3304,-15,-14,6,198280,268
2383,jd1610,20151217,3303,3304,3302,3309,3297,3300,3301,-4,-3,24,792260,264
2384,jd1610,20151218,3300,3301,3318,3319,3307,3310,3314,9,13,16,530320,268
2385,jd1610,20151221,3310,3314,3321,3358,3321,3357,3335,43,21,64,2134780,274
2386,jd1610,20151222,3357,3335,3376,3387,3343,3366,3368,31,33,56,1886580,278
2387,jd1610,20151223,3366,3368,3343,3356,3340,3355,3344,-13,-24,64,2140480,318
2388,jd1610,20151224,3355,3344,3275,3360,3275,3359,3343,15,-1,34,1136660,316
2389,jd1610,20151225,3359,3343,3343,3367,3333,3349,3349,6,6,34,1138800,318
2390,jd1610,20151228,3349,3349,3338,3342,3288,3300,3312,-49,-37,52,1722520,314
2391,jd1610,20151229,3300,3312,3340,3340,3303,3308,3324,-4,12,50,1662140,314
2392,jd1610,20151230,3308,3324,3315,3315,3315,3315,3315,-9,-9,8,265200,320
2393,jd1610,20151231,3315,3315,3318,3333,3310,3311,3322,-4,7,28,930260,328
2394,jd1611,20151116,3848,3848,0,0,0,3541,3541,-307,-307,0,0,0
2395,jd1611,20151117,3541,3541,0,0,0,3456,3456,-85,-85,0,0,0
2396,jd1611,20151118,3456,3456,0,0,0,3456,3456,0,0,0,0,0
2397,jd1611,20151119,3456,3456,0,0,0,3456,3456,0,0,0,0,0
2398,jd1611,20151120,3456,3456,0,0,0,3456,3456,0,0,0,0,0
2399,jd1611,20151123,3456,3456,0,0,0,3456,3456,0,0,0,0,0
2400,jd1611,20151124,3456,3456,0,0,0,3432,3432,-24,-24,0,0,0
2401,jd1611,20151125,3432,3432,0,0,0,3432,3432,0,0,0,0,0
2402,jd1611,20151126,3432,3432,0,0,0,3344,3344,-88,-88,0,0,0
2403,jd1611,20151127,3344,3344,0,0,0,3300,3300,-44,-44,0,0,0
2404,jd1611,20151130,3300,3300,3424,3424,3257,3257,3361,-43,61,18,605000,12
2405,jd1611,20151201,3257,3361,0,0,0,3333,3333,-28,-28,0,0,12
2406,jd1611,20151202,3333,3333,0,0,0,3333,3333,0,0,0,0,12
2407,jd1611,20151203,3333,3333,0,0,0,3333,3333,0,0,0,0,12
2408,jd1611,20151204,3333,3333,0,0,0,3333,3333,0,0,0,0,12
2409,jd1611,20151207,3333,3333,3259,3459,3259,3264,3300,-69,-33,10,330000,18
2410,jd1611,20151208,3264,3300,3411,3411,3411,3411,3411,111,111,2,68220,16
2411,jd1611,20151209,3411,3411,3241,3274,3241,3274,3253,-137,-158,12,390400,16
2412,jd1611,20151210,3274,3253,0,0,0,3253,3253,0,0,0,0,16
2413,jd1611,20151211,3253,3253,0,0,0,3253,3253,0,0,0,0,16
2414,jd1611,20151214,3253,3253,0,0,0,3253,3253,0,0,0,0,16
2415,jd1611,20151215,3253,3253,0,0,0,3253,3253,0,0,0,0,16
2416,jd1611,20151216,3253,3253,0,0,0,3253,3253,0,0,0,0,16
2417,jd1611,20151217,3253,3253,3264,3264,3264,3264,3264,11,11,2,65280,16
2418,jd1611,20151218,3264,3264,0,0,0,3264,3264,0,0,0,0,16
2419,jd1611,20151221,3264,3264,3267,3363,3267,3313,3314,49,50,6,198860,16
2420,jd1611,20151222,3313,3314,0,0,0,3314,3314,0,0,0,0,16
2421,jd1611,20151223,3314,3314,0,0,0,3314,3314,0,0,0,0,16
2422,jd1611,20151224,3314,3314,0,0,0,3314,3314,0,0,0,0,16
2423,jd1611,20151225,3314,3314,3399,3399,3399,3399,3399,85,85,2,67980,14
2424,jd1611,20151228,3399,3399,3387,3387,3387,3387,3387,-12,-12,8,270960,22
2425,jd1611,20151229,3387,3387,3360,3360,3360,3360,3360,-27,-27,2,67200,22
2426,jd1611,20151230,3360,3360,0,0,0,3360,3360,0,0,0,0,22
2427,jd1611,20151231,3360,3360,3334,3407,3333,3333,3354,-27,-6,12,402560,22
2428,jd1612,20151215,3682,3682,0,0,0,3722,3722,40,40,0,0,0
2429,jd1612,20151216,3722,3722,0,0,0,3707,3707,-15,-15,0,0,0
2430,jd1612,20151217,3707,3707,0,0,0,3719,3719,12,12,0,0,0
2431,jd1612,20151218,3719,3719,0,0,0,3733,3733,14,14,0,0,0
2432,jd1612,20151221,3733,3733,3437,3437,3437,3437,3437,-296,-296,2,68740,2
2433,jd1612,20151222,3437,3437,0,0,0,3437,3437,0,0,0,0,2
2434,jd1612,20151223,3437,3437,0,0,0,3437,3437,0,0,0,0,2
2435,jd1612,20151224,3437,3437,0,0,0,3437,3437,0,0,0,0,2
2436,jd1612,20151225,3437,3437,0,0,0,3437,3437,0,0,0,0,2
2437,jd1612,20151228,3437,3437,0,0,0,3437,3437,0,0,0,0,2
2438,jd1612,20151229,3437,3437,0,0,0,3437,3437,0,0,0,0,2
2439,jd1612,20151230,3437,3437,0,0,0,3428,3428,-9,-9,0,0,2
2440,jd1612,20151231,3428,3428,0,0,0,3333,3333,-95,-95,0,0,2
