   ,??,??,????,????,???,???,???,???,???,??1,??2,???,????,???
1,p1401,20140102,5828,5798,5840,5878,5452,5876,5858,78,60,2212,129596240,14788
11,p1402,20140102,5960,5960,0,0,0,6020,6020,60,60,0,0,10
42,p1403,20140102,6004,6004,0,0,0,6038,6038,34,34,0,0,8
89,p1404,20140102,6082,6082,0,0,0,6082,6082,0,0,0,0,12
157,p1405,20140102,6038,6038,6080,6150,6068,6148,6116,110,78,629522,38513776120,447612
246,p1406,20140102,6068,6068,6308,6308,6110,6170,6160,102,92,44,2710400,8
355,p1407,20140102,6082,6082,0,0,0,6126,6126,44,44,0,0,0
484,p1408,20140102,6096,6096,0,0,0,6136,6136,40,40,0,0,6
636,p1409,20140102,6112,6114,6146,6206,6142,6204,6180,90,66,103098,6373125120,128376
809,p1410,20140102,6116,6116,6208,6238,6208,6238,6222,122,106,6,373320,14
1003,p1411,20140102,6122,6122,0,0,0,6166,6166,44,44,0,0,0
1215,p1412,20140102,6166,6166,0,0,0,6176,6176,10,10,0,0,2
2,p1401,20140103,5876,5858,5840,5840,5750,5780,5786,-78,-72,3140,181728200,11678
12,p1402,20140103,6020,6020,5980,5980,5980,5980,5980,-40,-40,2,119600,12
43,p1403,20140103,6038,6038,0,0,0,6038,6038,0,0,0,0,8
90,p1404,20140103,6082,6082,6064,6064,6064,6064,6064,-18,-18,2,121280,12
158,p1405,20140103,6148,6116,6110,6118,6036,6068,6078,-48,-38,529516,32186195120,431040
247,p1406,20140103,6170,6160,6102,6176,6060,6060,6120,-100,-40,326,19956080,50
356,p1407,20140103,6126,6126,0,0,0,6126,6126,0,0,0,0,0
485,p1408,20140103,6136,6136,0,0,0,6136,6136,0,0,0,0,6
637,p1409,20140103,6204,6180,6170,6174,6104,6128,6140,-52,-40,96942,5952313680,120472
810,p1410,20140103,6238,6222,6200,6200,6200,6200,6200,-22,-22,2,124000,14
1004,p1411,20140103,6166,6166,0,0,0,6166,6166,0,0,0,0,0
1216,p1412,20140103,6176,6176,0,0,0,6164,6164,-12,-12,0,0,2
3,p1401,20140106,5780,5786,5780,5780,5780,5780,5780,-6,-6,100,5780000,11578
13,p1402,20140106,5980,5980,0,0,0,5980,5980,0,0,0,0,12
44,p1403,20140106,6038,6038,5938,5938,5938,5938,5938,-100,-100,4,237520,10
91,p1404,20140106,6064,6064,5978,6044,5978,6044,6010,-20,-54,4,240440,12
159,p1405,20140106,6068,6078,6054,6062,5958,5976,6000,-102,-78,611684,36705993880,435642
248,p1406,20140106,6060,6120,6050,6050,6000,6000,6040,-120,-80,52,3140800,2
357,p1407,20140106,6126,6126,0,0,0,6074,6074,-52,-52,0,0,0
486,p1408,20140106,6136,6136,6030,6030,6030,6030,6030,-106,-106,2,120600,4
638,p1409,20140106,6128,6140,6102,6126,6042,6060,6084,-80,-56,137882,8389008160,105540
811,p1410,20140106,6200,6200,0,0,0,6144,6144,-56,-56,0,0,14
1005,p1411,20140106,6166,6166,0,0,0,6116,6116,-50,-50,0,0,0
1217,p1412,20140106,6164,6164,0,0,0,6106,6106,-58,-58,0,0,2
4,p1401,20140107,5780,5780,0,0,0,5780,5780,0,0,0,0,11578
14,p1402,20140107,5980,5980,0,0,0,5960,5960,-20,-20,0,0,12
45,p1403,20140107,5938,5938,0,0,0,5936,5936,-2,-2,0,0,10
92,p1404,20140107,6044,6010,0,0,0,5988,5988,-22,-22,0,0,12
160,p1405,20140107,5976,6000,5992,5992,5902,5936,5944,-64,-56,530696,31551753360,421006
249,p1406,20140107,6000,6040,5898,5998,5898,5958,5966,-82,-74,20,1193320,4
358,p1407,20140107,6074,6074,0,0,0,6048,6048,-26,-26,0,0,0
487,p1408,20140107,6030,6030,0,0,0,6030,6030,0,0,0,0,4
639,p1409,20140107,6060,6084,6050,6068,5986,6012,6026,-72,-58,88884,5356544720,109164
812,p1410,20140107,6144,6144,6052,6052,6052,6052,6052,-92,-92,2,121040,12
1006,p1411,20140107,6116,6116,0,0,0,6096,6096,-20,-20,0,0,0
1218,p1412,20140107,6106,6106,0,0,0,6070,6070,-36,-36,0,0,2
5,p1401,20140108,5780,5780,0,0,0,5780,5780,0,0,0,0,11578
15,p1402,20140108,5960,5960,0,0,0,5800,5800,-160,-160,0,0,12
46,p1403,20140108,5936,5936,0,0,0,5768,5768,-168,-168,0,0,10
93,p1404,20140108,5988,5988,5796,5850,5772,5772,5804,-216,-184,16,928880,12
161,p1405,20140108,5936,5944,5920,5930,5776,5786,5830,-158,-114,899106,52425359520,438476
250,p1406,20140108,5958,5966,5932,5932,5846,5846,5866,-120,-100,232,13613040,2
359,p1407,20140108,6048,6048,0,0,0,5904,5904,-144,-144,0,0,0
488,p1408,20140108,6030,6030,5874,5874,5874,5874,5874,-156,-156,2,117480,2
640,p1409,20140108,6012,6026,6002,6012,5868,5876,5928,-150,-98,119420,7079227800,94416
813,p1410,20140108,6052,6052,5900,5900,5900,5900,5900,-152,-152,2,118000,12
1007,p1411,20140108,6096,6096,0,0,0,5904,5904,-192,-192,0,0,0
1219,p1412,20140108,6070,6070,0,0,0,5954,5954,-116,-116,0,0,2
6,p1401,20140109,5780,5780,0,0,0,5780,5780,0,0,0,0,11578
16,p1402,20140109,5800,5800,5698,5828,5698,5792,5772,-8,-28,12,692720,12
47,p1403,20140109,5768,5768,0,0,0,5768,5768,0,0,0,0,10
94,p1404,20140109,5772,5804,5876,5876,5742,5760,5826,-44,22,82,4778720,14
162,p1405,20140109,5786,5830,5800,5866,5768,5812,5812,-18,-18,686098,39888224840,419726
251,p1406,20140109,5846,5866,5888,5888,5792,5828,5816,-38,-50,86,5003000,26
360,p1407,20140109,5904,5904,0,0,0,5904,5904,0,0,0,0,0
489,p1408,20140109,5874,5874,0,0,0,5874,5874,0,0,0,0,2
641,p1409,20140109,5876,5928,5870,5942,5842,5886,5890,-42,-38,104442,6151981520,97520
814,p1410,20140109,5900,5900,5938,5938,5902,5902,5920,2,20,22,1302520,12
1008,p1411,20140109,5904,5904,0,0,0,5904,5904,0,0,0,0,0
1220,p1412,20140109,5954,5954,0,0,0,5954,5954,0,0,0,0,2
7,p1401,20140110,5780,5780,5780,5780,5780,5780,5780,0,0,78,4508400,11500
17,p1402,20140110,5792,5772,0,0,0,5820,5820,48,48,0,0,12
48,p1403,20140110,5768,5768,0,0,0,5768,5768,0,0,0,0,10
95,p1404,20140110,5760,5826,5866,5866,5866,5866,5866,40,40,2,117320,12
163,p1405,20140110,5812,5812,5832,5884,5824,5850,5852,38,40,611098,35772997680,425054
252,p1406,20140110,5828,5816,5876,5928,5852,5910,5880,94,64,26,1529080,24
361,p1407,20140110,5904,5904,5874,5874,5874,5874,5874,-30,-30,8,469920,8
490,p1408,20140110,5874,5874,0,0,0,5874,5874,0,0,0,0,2
642,p1409,20140110,5886,5890,5910,5950,5896,5918,5922,28,32,75072,4447151160,102726
815,p1410,20140110,5902,5920,5932,5948,5932,5948,5940,28,20,6,356440,12
1009,p1411,20140110,5904,5904,0,0,0,5904,5904,0,0,0,0,0
1221,p1412,20140110,5954,5954,0,0,0,5954,5954,0,0,0,0,2
8,p1401,20140113,5780,5780,0,0,0,5780,5780,0,0,0,0,11500
18,p1402,20140113,5820,5820,0,0,0,5820,5820,0,0,0,0,12
49,p1403,20140113,5768,5768,0,0,0,5768,5768,0,0,0,0,10
96,p1404,20140113,5866,5866,0,0,0,5856,5856,-10,-10,0,0,12
164,p1405,20140113,5850,5852,5862,5874,5788,5828,5816,-24,-36,623502,36274735000,424624
253,p1406,20140113,5910,5880,5892,5892,5836,5850,5856,-30,-24,36,2108600,8
362,p1407,20140113,5874,5874,0,0,0,5852,5852,-22,-22,0,0,8
491,p1408,20140113,5874,5874,0,0,0,5874,5874,0,0,0,0,2
643,p1409,20140113,5918,5922,5934,5948,5860,5900,5890,-22,-32,88304,5202311560,103678
816,p1410,20140113,5948,5940,5904,5904,5904,5904,5904,-36,-36,2,118080,12
1010,p1411,20140113,5904,5904,0,0,0,5904,5904,0,0,0,0,0
1222,p1412,20140113,5954,5954,0,0,0,5954,5954,0,0,0,0,2
9,p1401,20140114,5780,5780,0,0,0,5780,5780,0,0,0,0,11500
19,p1402,20140114,5820,5820,0,0,0,5820,5820,0,0,0,0,12
50,p1403,20140114,5768,5768,0,0,0,5768,5768,0,0,0,0,10
97,p1404,20140114,5856,5856,5730,5828,5730,5828,5778,-28,-78,12,693480,18
165,p1405,20140114,5828,5816,5806,5854,5794,5848,5828,32,12,443412,25848270200,416032
254,p1406,20140114,5850,5856,5864,5864,5834,5852,5858,-4,2,24,1406200,28
363,p1407,20140114,5852,5852,5930,5930,5930,5930,5930,78,78,2,118600,10
492,p1408,20140114,5874,5874,0,0,0,5874,5874,0,0,0,0,2
644,p1409,20140114,5900,5890,5880,5926,5870,5926,5906,36,16,79016,4667036440,110490
817,p1410,20140114,5904,5904,5932,5932,5932,5932,5932,28,28,2,118640,12
1011,p1411,20140114,5904,5904,0,0,0,5904,5904,0,0,0,0,0
1223,p1412,20140114,5954,5954,0,0,0,5954,5954,0,0,0,0,2
10,p1401,20140115,5780,5780,0,0,0,5814,5814,34,34,0,0,0
20,p1402,20140115,5820,5820,0,0,0,5820,5820,0,0,0,0,12
51,p1403,20140115,5768,5768,0,0,0,5768,5768,0,0,0,0,10
98,p1404,20140115,5828,5778,5738,5738,5738,5738,5738,-40,-40,2,114760,16
166,p1405,20140115,5848,5828,5830,5854,5770,5780,5806,-48,-22,472000,27409753440,438026
255,p1406,20140115,5852,5858,5850,5922,5810,5810,5848,-48,-10,44,2573640,16
364,p1407,20140115,5930,5930,0,0,0,5882,5882,-48,-48,0,0,10
493,p1408,20140115,5874,5874,5850,5928,5850,5928,5888,54,14,8,471120,4
645,p1409,20140115,5926,5906,5920,5930,5846,5856,5880,-50,-26,68340,4019571080,117958
818,p1410,20140115,5932,5932,5920,5920,5900,5900,5908,-32,-24,10,590960,12
1012,p1411,20140115,5904,5904,0,0,0,5882,5882,-22,-22,0,0,0
1224,p1412,20140115,5954,5954,0,0,0,5906,5906,-48,-48,0,0,2
21,p1402,20140116,5820,5820,0,0,0,5820,5820,0,0,0,0,12
52,p1403,20140116,5768,5768,0,0,0,5770,5770,2,2,0,0,10
99,p1404,20140116,5738,5738,5832,5838,5812,5820,5830,82,92,82,4781160,66
167,p1405,20140116,5780,5806,5818,5866,5818,5836,5844,30,38,433222,25323098520,430386
256,p1406,20140116,5810,5848,5848,5878,5848,5862,5864,14,16,10,586520,18
365,p1407,20140116,5882,5882,5900,5900,5900,5900,5900,18,18,2,118000,12
494,p1408,20140116,5928,5888,0,0,0,5888,5888,0,0,0,0,4
646,p1409,20140116,5856,5880,5894,5942,5894,5920,5924,40,44,68812,4076554160,124906
819,p1410,20140116,5900,5908,0,0,0,5926,5926,18,18,0,0,12
1013,p1411,20140116,5882,5882,0,0,0,5884,5884,2,2,0,0,0
1225,p1412,20140116,5906,5906,0,0,0,5930,5930,24,24,0,0,2
1447,p1501,20140116,5906,5906,5982,5982,5918,5940,5948,34,42,1012,60202120,844
22,p1402,20140117,5820,5820,0,0,0,5820,5820,0,0,0,0,12
53,p1403,20140117,5770,5770,0,0,0,5770,5770,0,0,0,0,10
100,p1404,20140117,5820,5830,5802,5828,5800,5802,5806,-28,-24,48,2787320,18
168,p1405,20140117,5836,5844,5830,5846,5798,5824,5818,-20,-26,332438,19343766800,421018
257,p1406,20140117,5862,5864,5848,5848,5832,5832,5842,-32,-22,10,584240,12
366,p1407,20140117,5900,5900,0,0,0,5900,5900,0,0,0,0,12
495,p1408,20140117,5888,5888,0,0,0,5888,5888,0,0,0,0,4
647,p1409,20140117,5920,5924,5944,5944,5894,5916,5910,-8,-14,64802,3830251920,130412
820,p1410,20140117,5926,5926,5930,5930,5930,5930,5930,4,4,4,237200,12
1014,p1411,20140117,5884,5884,0,0,0,5884,5884,0,0,0,0,0
1226,p1412,20140117,5930,5930,0,0,0,5932,5932,2,2,0,0,2
1448,p1501,20140117,5940,5948,5940,5946,5918,5944,5932,-4,-16,538,31922040,1266
23,p1402,20140120,5820,5820,5912,5960,5912,5960,5936,140,116,4,237440,10
54,p1403,20140120,5770,5770,0,0,0,5796,5796,26,26,0,0,10
101,p1404,20140120,5802,5806,0,0,0,5858,5858,52,52,0,0,18
169,p1405,20140120,5824,5818,5806,5936,5764,5922,5884,104,66,750760,44182094240,433540
258,p1406,20140120,5832,5842,5834,5944,5834,5932,5912,90,70,62,3665680,24
367,p1407,20140120,5900,5900,5946,5946,5946,5946,5946,46,46,2,118920,12
496,p1408,20140120,5888,5888,0,0,0,5948,5948,60,60,0,0,4
648,p1409,20140120,5916,5910,5902,6052,5860,6050,5998,140,88,193946,11633360760,172794
821,p1410,20140120,5930,5930,6000,6000,6000,6000,6000,70,70,2,120000,12
1015,p1411,20140120,5884,5884,0,0,0,6018,6018,134,134,0,0,0
1227,p1412,20140120,5932,5932,0,0,0,5998,5998,66,66,0,0,2
1449,p1501,20140120,5944,5932,5908,6058,5904,6058,6006,126,74,3684,221295360,4358
24,p1402,20140121,5960,5936,5884,5884,5884,5884,5884,-52,-52,2,117680,10
55,p1403,20140121,5796,5796,5856,5856,5856,5856,5856,60,60,4,234240,6
102,p1404,20140121,5858,5858,0,0,0,5858,5858,0,0,0,0,18
170,p1405,20140121,5922,5884,5910,5936,5876,5888,5902,4,18,387396,22868704560,414140
259,p1406,20140121,5932,5912,5924,5930,5908,5908,5920,-4,8,12,710480,14
368,p1407,20140121,5946,5946,5900,5900,5900,5900,5900,-46,-46,2,118000,10
497,p1408,20140121,5948,5948,5948,5998,5948,5998,5972,50,24,4,238920,2
649,p1409,20140121,6050,5998,6050,6052,5986,5996,6016,-2,18,107900,6492375200,175564
822,p1410,20140121,6000,6000,0,0,0,6018,6018,18,18,0,0,12
1016,p1411,20140121,6018,6018,0,0,0,6018,6018,0,0,0,0,0
1228,p1412,20140121,5998,5998,0,0,0,5998,5998,0,0,0,0,2
1450,p1501,20140121,6058,6006,6048,6054,6008,6018,6032,12,26,2182,131624600,5232
25,p1402,20140122,5884,5884,5896,5932,5896,5932,5914,48,30,4,236560,8
56,p1403,20140122,5856,5856,0,0,0,5856,5856,0,0,0,0,6
103,p1404,20140122,5858,5858,0,0,0,5858,5858,0,0,0,0,18
171,p1405,20140122,5888,5902,5880,5920,5858,5866,5890,-36,-12,394544,23243338680,385100
260,p1406,20140122,5908,5920,5908,5930,5890,5890,5908,-30,-12,44,2600000,10
369,p1407,20140122,5900,5900,0,0,0,5890,5890,-10,-10,0,0,10
498,p1408,20140122,5998,5972,0,0,0,5972,5972,0,0,0,0,2
650,p1409,20140122,5996,6016,6006,6024,5976,5976,6000,-40,-16,106380,6383741880,177312
823,p1410,20140122,6018,6018,6010,6010,6010,6010,6010,-8,-8,2,120200,12
1017,p1411,20140122,6018,6018,0,0,0,6018,6018,0,0,0,0,0
1229,p1412,20140122,5998,5998,0,0,0,5998,5998,0,0,0,0,2
1451,p1501,20140122,6018,6032,6020,6040,5998,5998,6014,-34,-18,1932,116194840,5364
26,p1402,20140123,5932,5914,0,0,0,5914,5914,0,0,0,0,8
57,p1403,20140123,5856,5856,0,0,0,5856,5856,0,0,0,0,6
104,p1404,20140123,5858,5858,0,0,0,5858,5858,0,0,0,0,18
172,p1405,20140123,5866,5890,5854,5874,5816,5846,5846,-44,-44,531724,31094940600,405696
261,p1406,20140123,5890,5908,0,0,0,5908,5908,0,0,0,0,10
370,p1407,20140123,5890,5890,0,0,0,5848,5848,-42,-42,0,0,10
499,p1408,20140123,5972,5972,0,0,0,5972,5972,0,0,0,0,2
651,p1409,20140123,5976,6000,5966,5998,5934,5960,5962,-40,-38,110552,6591479560,183150
824,p1410,20140123,6010,6010,5980,5980,5980,5980,5980,-30,-30,12,717600,12
1018,p1411,20140123,6018,6018,0,0,0,6006,6006,-12,-12,0,0,0
1230,p1412,20140123,5998,5998,0,0,0,5996,5996,-2,-2,0,0,2
1452,p1501,20140123,5998,6014,5986,6002,5956,5978,5978,-36,-36,1032,61713320,5490
27,p1402,20140124,5914,5914,5910,5910,5910,5910,5910,-4,-4,2,118200,6
58,p1403,20140124,5856,5856,0,0,0,5856,5856,0,0,0,0,6
105,p1404,20140124,5858,5858,0,0,0,5858,5858,0,0,0,0,18
173,p1405,20140124,5846,5846,5860,5884,5830,5842,5854,-4,8,316818,18551846440,386054
262,p1406,20140124,5908,5908,5880,5950,5860,5880,5880,-28,-28,68,3999400,6
371,p1407,20140124,5848,5848,5858,5862,5850,5862,5856,14,8,20,1171560,4
500,p1408,20140124,5972,5972,0,0,0,5948,5948,-24,-24,0,0,2
652,p1409,20140124,5960,5962,5966,5994,5952,5952,5968,-10,6,83148,4963149000,179866
825,p1410,20140124,5980,5980,5970,6012,5970,6012,5990,32,10,4,239640,12
1019,p1411,20140124,6006,6006,0,0,0,6016,6016,10,10,0,0,0
1231,p1412,20140124,5996,5996,0,0,0,5990,5990,-6,-6,0,0,2
1453,p1501,20140124,5978,5978,5996,6006,5968,5970,5984,-8,6,990,59260160,6050
28,p1402,20140127,5910,5910,0,0,0,5910,5910,0,0,0,0,6
59,p1403,20140127,5856,5856,0,0,0,5836,5836,-20,-20,0,0,6
106,p1404,20140127,5858,5858,5778,5778,5778,5778,5778,-80,-80,2,115560,16
174,p1405,20140127,5842,5854,5840,5846,5752,5774,5784,-80,-70,355894,20586124520,380416
263,p1406,20140127,5880,5880,5850,5878,5820,5820,5858,-60,-22,24,1406120,20
372,p1407,20140127,5862,5856,5818,5820,5804,5804,5812,-52,-44,12,697640,6
501,p1408,20140127,5948,5948,0,0,0,5878,5878,-70,-70,0,0,2
653,p1409,20140127,5952,5968,5930,5954,5872,5886,5898,-82,-70,80892,4772155560,177464
826,p1410,20140127,6012,5990,0,0,0,5920,5920,-70,-70,0,0,12
1020,p1411,20140127,6016,6016,0,0,0,5950,5950,-66,-66,0,0,0
1232,p1412,20140127,5990,5990,0,0,0,5922,5922,-68,-68,0,0,2
1454,p1501,20140127,5970,5984,5956,5960,5890,5898,5914,-86,-70,554,32765200,5958
29,p1402,20140128,5910,5910,5674,5920,5674,5880,5826,-30,-84,10,582720,2
60,p1403,20140128,5836,5836,5678,5678,5678,5678,5678,-158,-158,4,227120,6
107,p1404,20140128,5778,5778,5690,5690,5690,5690,5690,-88,-88,2,113800,14
175,p1405,20140128,5774,5784,5744,5750,5660,5660,5704,-124,-80,330686,18868844520,384116
264,p1406,20140128,5820,5858,5752,5798,5752,5778,5776,-80,-82,6,346560,20
373,p1407,20140128,5804,5812,0,0,0,5732,5732,-80,-80,0,0,6
502,p1408,20140128,5878,5878,0,0,0,5756,5756,-122,-122,0,0,2
654,p1409,20140128,5886,5898,5850,5862,5756,5756,5810,-142,-88,88776,5158449560,178640
827,p1410,20140128,5920,5920,0,0,0,5836,5836,-84,-84,0,0,12
1021,p1411,20140128,5950,5950,0,0,0,5862,5862,-88,-88,0,0,0
1233,p1412,20140128,5922,5922,0,0,0,5796,5796,-126,-126,0,0,2
1455,p1501,20140128,5898,5914,5866,5870,5780,5780,5826,-134,-88,484,28199680,5988
30,p1402,20140129,5880,5826,5732,5732,5732,5732,5732,-94,-94,2,114640,2
61,p1403,20140129,5678,5678,0,0,0,5678,5678,0,0,0,0,6
108,p1404,20140129,5690,5690,5724,5724,5724,5724,5724,34,34,4,228960,14
176,p1405,20140129,5660,5704,5694,5726,5662,5672,5700,-32,-4,245736,14007668720,355280
265,p1406,20140129,5778,5776,5712,5712,5712,5712,5712,-64,-64,2,114240,20
374,p1407,20140129,5732,5732,0,0,0,5732,5732,0,0,0,0,6
503,p1408,20140129,5756,5756,0,0,0,5756,5756,0,0,0,0,2
655,p1409,20140129,5756,5810,5828,5832,5768,5772,5804,-38,-6,71132,4129541800,181982
828,p1410,20140129,5836,5836,5854,5854,5854,5854,5854,18,18,2,117080,14
1022,p1411,20140129,5862,5862,0,0,0,5824,5824,-38,-38,0,0,0
1234,p1412,20140129,5796,5796,5848,5854,5846,5846,5848,50,52,10,584960,10
1456,p1501,20140129,5780,5826,5832,5844,5800,5800,5816,-26,-10,2232,129842320,6174
31,p1402,20140130,5732,5732,0,0,0,5750,5750,18,18,0,0,2
62,p1403,20140130,5678,5678,5724,5724,5652,5696,5688,18,10,22,1251520,4
109,p1404,20140130,5724,5724,0,0,0,5700,5700,-24,-24,0,0,14
177,p1405,20140130,5672,5700,5662,5704,5630,5672,5660,-28,-40,209596,11865568720,343572
266,p1406,20140130,5712,5712,5682,5726,5682,5692,5700,-20,-12,6,342000,20
375,p1407,20140130,5732,5732,0,0,0,5732,5732,0,0,0,0,6
504,p1408,20140130,5756,5756,0,0,0,5756,5756,0,0,0,0,2
656,p1409,20140130,5772,5804,5760,5790,5734,5762,5758,-42,-46,53226,3064943720,179498
829,p1410,20140130,5854,5854,0,0,0,5832,5832,-22,-22,0,0,14
1023,p1411,20140130,5824,5824,0,0,0,5824,5824,0,0,0,0,0
1235,p1412,20140130,5846,5848,0,0,0,5836,5836,-12,-12,0,0,10
1457,p1501,20140130,5800,5816,5778,5802,5756,5774,5778,-42,-38,1046,60452320,6350
32,p1402,20140207,5750,5750,5406,5406,5406,5406,5406,-344,-344,2,108120,0
63,p1403,20140207,5696,5688,0,0,0,5688,5688,0,0,0,0,4
110,p1404,20140207,5700,5700,5764,5764,5764,5764,5764,64,64,4,230560,14
178,p1405,20140207,5672,5660,5780,5860,5780,5804,5814,144,154,272372,15838631880,326446
267,p1406,20140207,5692,5700,5852,5852,5852,5852,5852,152,152,2,117040,18
376,p1407,20140207,5732,5732,0,0,0,5802,5802,70,70,0,0,6
505,p1408,20140207,5756,5756,0,0,0,5822,5822,66,66,0,0,2
657,p1409,20140207,5762,5758,5900,5944,5890,5908,5910,150,152,85722,5067589920,179600
830,p1410,20140207,5832,5832,0,0,0,5884,5884,52,52,0,0,14
1024,p1411,20140207,5824,5824,0,0,0,5876,5876,52,52,0,0,0
1236,p1412,20140207,5836,5836,0,0,0,5888,5888,52,52,0,0,10
1458,p1501,20140207,5774,5778,5830,5960,5830,5926,5932,148,154,710,42119160,6404
33,p1402,20140210,5406,5406,0,0,0,5406,5406,0,0,0,0,0
64,p1403,20140210,5688,5688,0,0,0,5688,5688,0,0,0,0,4
111,p1404,20140210,5764,5764,5978,5978,5780,5780,5878,16,114,4,235160,14
179,p1405,20140210,5804,5814,5790,5892,5790,5876,5862,62,48,338430,19843871440,383540
268,p1406,20140210,5852,5852,5886,5914,5880,5880,5896,28,44,26,1533040,0
377,p1407,20140210,5802,5802,0,0,0,5872,5872,70,70,0,0,6
506,p1408,20140210,5822,5822,5888,5888,5888,5888,5888,66,66,2,117760,4
658,p1409,20140210,5908,5910,5910,5982,5900,5968,5952,58,42,88222,5252474920,194590
831,p1410,20140210,5884,5884,5912,5912,5904,5906,5906,22,22,6,354440,14
1025,p1411,20140210,5876,5876,0,0,0,5922,5922,46,46,0,0,0
1237,p1412,20140210,5888,5888,0,0,0,5922,5922,34,34,0,0,10
1459,p1501,20140210,5926,5932,5928,5992,5928,5988,5962,56,30,2720,162194560,8054
34,p1402,20140211,5406,5406,0,0,0,5406,5406,0,0,0,0,0
65,p1403,20140211,5688,5688,0,0,0,5688,5688,0,0,0,0,4
112,p1404,20140211,5780,5878,0,0,0,5878,5878,0,0,0,0,14
180,p1405,20140211,5876,5862,5886,5886,5828,5838,5852,-24,-10,285780,16727505920,383022
269,p1406,20140211,5880,5896,0,0,0,5896,5896,0,0,0,0,0
378,p1407,20140211,5872,5872,0,0,0,5862,5862,-10,-10,0,0,6
507,p1408,20140211,5888,5888,0,0,0,5888,5888,0,0,0,0,4
659,p1409,20140211,5968,5952,5972,5974,5920,5928,5942,-24,-10,79906,4748046360,203160
832,p1410,20140211,5906,5906,6022,6022,6022,6022,6022,116,116,2,120440,14
1026,p1411,20140211,5922,5922,0,0,0,5922,5922,0,0,0,0,0
1238,p1412,20140211,5922,5922,0,0,0,5922,5922,0,0,0,0,10
1460,p1501,20140211,5988,5962,5980,5980,5926,5930,5950,-32,-12,4662,277406880,10660
35,p1402,20140212,5406,5406,0,0,0,5406,5406,0,0,0,0,0
66,p1403,20140212,5688,5688,0,0,0,5688,5688,0,0,0,0,4
113,p1404,20140212,5878,5878,0,0,0,5878,5878,0,0,0,0,14
181,p1405,20140212,5838,5852,5868,5888,5848,5886,5866,34,14,236692,13887432240,400780
270,p1406,20140212,5896,5896,5878,5878,5878,5878,5878,-18,-18,10,587800,10
379,p1407,20140212,5862,5862,5880,5892,5880,5892,5886,30,24,6,353200,0
508,p1408,20140212,5888,5888,5974,5974,5888,5888,5930,0,42,4,237240,4
660,p1409,20140212,5928,5942,5960,5976,5936,5972,5954,30,12,60496,3602711760,206354
833,p1410,20140212,6022,6022,0,0,0,6022,6022,0,0,0,0,14
1027,p1411,20140212,5922,5922,0,0,0,5946,5946,24,24,0,0,0
1239,p1412,20140212,5922,5922,0,0,0,5958,5958,36,36,0,0,10
1461,p1501,20140212,5930,5950,5950,5976,5944,5972,5954,22,4,4274,254524880,12092
36,p1402,20140213,5406,5406,0,0,0,5406,5406,0,0,0,0,0
67,p1403,20140213,5688,5688,0,0,0,5688,5688,0,0,0,0,4
114,p1404,20140213,5878,5878,0,0,0,5878,5878,0,0,0,0,14
182,p1405,20140213,5886,5866,5906,5972,5892,5932,5932,66,66,446058,26460927480,419446
271,p1406,20140213,5878,5878,5964,6032,5964,6032,5998,154,120,12,719760,16
380,p1407,20140213,5892,5886,0,0,0,5924,5924,38,38,0,0,0
509,p1408,20140213,5888,5930,6052,6052,5990,5990,6020,60,90,4,240840,2
661,p1409,20140213,5972,5954,5984,6060,5982,6032,6024,78,70,163080,9824251000,235842
834,p1410,20140213,6022,6022,0,0,0,6022,6022,0,0,0,0,14
1028,p1411,20140213,5946,5946,0,0,0,5994,5994,48,48,0,0,0
1240,p1412,20140213,5958,5958,0,0,0,6066,6066,108,108,0,0,10
1462,p1501,20140213,5972,5954,5984,6052,5984,6016,6020,62,66,6258,376833240,15042
37,p1402,20140214,5406,5406,0,0,0,5406,5406,0,0,0,0,0
68,p1403,20140214,5688,5688,0,0,0,5914,5914,226,226,0,0,4
115,p1404,20140214,5878,5878,0,0,0,5878,5878,0,0,0,0,14
183,p1405,20140214,5932,5932,5976,6020,5962,6018,5990,86,58,327622,19626160080,421224
272,p1406,20140214,6032,5998,6012,6044,5990,6044,6016,46,18,28,1684480,14
381,p1407,20140214,5924,5924,0,0,0,5988,5988,64,64,0,0,0
510,p1408,20140214,5990,6020,6088,6128,6012,6128,6050,108,30,12,726160,6
662,p1409,20140214,6032,6024,6080,6132,6066,6130,6102,106,78,173812,10608994160,262528
835,p1410,20140214,6022,6022,0,0,0,6120,6120,98,98,0,0,14
1029,p1411,20140214,5994,5994,0,0,0,6104,6104,110,110,0,0,0
1241,p1412,20140214,6066,6066,0,0,0,6086,6086,20,20,0,0,10
1463,p1501,20140214,6016,6020,6030,6136,6030,6110,6086,90,66,5742,349467200,18358
38,p1402,20140217,5406,5406,0,0,0,5406,5406,0,0,0,0,0
69,p1403,20140217,5914,5914,0,0,0,5914,5914,0,0,0,0,4
116,p1404,20140217,5878,5878,0,0,0,5878,5878,0,0,0,0,14
184,p1405,20140217,6018,5990,5976,6020,5950,6010,5984,20,-6,318374,19055676600,394246
273,p1406,20140217,6044,6016,6008,6008,6008,6008,6008,-8,-8,4,240320,10
382,p1407,20140217,5988,5988,0,0,0,5988,5988,0,0,0,0,0
511,p1408,20140217,6128,6050,6068,6068,6068,6068,6068,18,18,2,121360,4
663,p1409,20140217,6130,6102,6092,6136,6070,6126,6102,24,0,166980,10192103480,279528
836,p1410,20140217,6120,6120,0,0,0,6120,6120,0,0,0,0,14
1030,p1411,20140217,6104,6104,0,0,0,6104,6104,0,0,0,0,0
1242,p1412,20140217,6086,6086,0,0,0,6144,6144,58,58,0,0,10
1464,p1501,20140217,6110,6086,6076,6104,6058,6100,6080,14,-6,4442,270119840,19936
39,p1402,20140218,5406,5406,0,0,0,5406,5406,0,0,0,0,0
70,p1403,20140218,5914,5914,6150,6150,6150,6150,6150,236,236,2,123000,4
117,p1404,20140218,5878,5878,5912,5912,5912,5912,5912,34,34,2,118240,12
185,p1405,20140218,6010,5984,6028,6066,5996,6000,6036,16,52,495242,29894850520,387498
274,p1406,20140218,6008,6008,6052,6062,6052,6062,6056,54,48,4,242280,10
383,p1407,20140218,5988,5988,0,0,0,5988,5988,0,0,0,0,0
512,p1408,20140218,6068,6068,0,0,0,6068,6068,0,0,0,0,4
664,p1409,20140218,6126,6102,6148,6184,6114,6124,6154,22,52,232374,14301752960,301550
837,p1410,20140218,6120,6120,6128,6128,6128,6128,6128,8,8,2,122560,14
1031,p1411,20140218,6104,6104,0,0,0,6104,6104,0,0,0,0,0
1243,p1412,20140218,6144,6144,0,0,0,6152,6152,8,8,0,0,10
1465,p1501,20140218,6100,6080,6118,6152,6078,6080,6114,0,34,5946,363576200,22450
40,p1402,20140219,5406,5406,0,0,0,5406,5406,0,0,0,0,0
71,p1403,20140219,6150,6150,0,0,0,6150,6150,0,0,0,0,4
118,p1404,20140219,5912,5912,0,0,0,5912,5912,0,0,0,0,12
186,p1405,20140219,6000,6036,6120,6168,6074,6078,6120,42,84,518876,31755217280,409616
275,p1406,20140219,6062,6056,6188,6188,6130,6130,6176,74,120,28,1729400,20
384,p1407,20140219,5988,5988,0,0,0,5988,5988,0,0,0,0,0
513,p1408,20140219,6068,6068,0,0,0,6122,6122,54,54,0,0,4
665,p1409,20140219,6124,6154,6234,6292,6204,6210,6248,56,94,228664,14288672480,309512
838,p1410,20140219,6128,6128,6158,6312,6158,6240,6256,112,128,16,1000960,18
1032,p1411,20140219,6104,6104,0,0,0,6180,6180,76,76,0,0,0
1244,p1412,20140219,6152,6152,0,0,0,6210,6210,58,58,0,0,10
1466,p1501,20140219,6080,6114,6180,6244,6166,6170,6198,56,84,6892,427258600,23920
41,p1402,20140220,5406,5406,0,0,0,5406,5406,0,0,0,0,0
72,p1403,20140220,6150,6150,0,0,0,6150,6150,0,0,0,0,4
119,p1404,20140220,5912,5912,0,0,0,5912,5912,0,0,0,0,12
187,p1405,20140220,6078,6120,6092,6102,6024,6100,6062,-20,-58,429242,26028807800,402336
276,p1406,20140220,6130,6176,6140,6140,6128,6128,6134,-48,-42,4,245360,20
385,p1407,20140220,5988,5988,0,0,0,6078,6078,90,90,0,0,0
514,p1408,20140220,6122,6122,6124,6124,6124,6124,6124,2,2,2,122480,4
666,p1409,20140220,6210,6248,6210,6236,6150,6230,6196,-18,-52,233272,14454446960,323438
839,p1410,20140220,6240,6256,0,0,0,6256,6256,0,0,0,0,18
1033,p1411,20140220,6180,6180,0,0,0,6202,6202,22,22,0,0,0
1245,p1412,20140220,6210,6210,0,0,0,6250,6250,40,40,0,0,10
1467,p1501,20140220,6170,6198,6150,6186,6120,6180,6152,-18,-46,4202,258584720,25296
73,p1403,20140221,6150,6150,0,0,0,6150,6150,0,0,0,0,4
120,p1404,20140221,5912,5912,0,0,0,5912,5912,0,0,0,0,12
188,p1405,20140221,6100,6062,6140,6140,6052,6074,6088,12,26,372234,22661608240,396594
277,p1406,20140221,6128,6134,6222,6222,6090,6092,6148,-42,14,26,1598600,20
386,p1407,20140221,6078,6078,0,0,0,6078,6078,0,0,0,0,0
515,p1408,20140221,6124,6124,0,0,0,6124,6124,0,0,0,0,4
667,p1409,20140221,6230,6196,6262,6266,6180,6200,6214,4,18,251526,15633960160,334796
840,p1410,20140221,6256,6256,6256,6256,6204,6228,6228,-28,-28,6,373760,14
1034,p1411,20140221,6202,6202,0,0,0,6202,6202,0,0,0,0,0
1246,p1412,20140221,6250,6250,0,0,0,6224,6224,-26,-26,0,0,10
1468,p1501,20140221,6180,6152,6216,6218,6146,6162,6170,10,18,4694,289670920,26230
1682,p1502,20140221,6198,6198,0,0,0,6198,6198,0,0,0,0,0
74,p1403,20140224,6150,6150,6104,6104,6104,6104,6104,-46,-46,2,122080,2
121,p1404,20140224,5912,5912,0,0,0,5868,5868,-44,-44,0,0,12
189,p1405,20140224,6074,6088,6120,6170,6074,6164,6124,76,36,565260,34617387760,406608
278,p1406,20140224,6092,6148,6236,6236,6158,6210,6200,62,52,6,372080,20
387,p1407,20140224,6078,6078,0,0,0,6168,6168,90,90,0,0,0
516,p1408,20140224,6124,6124,6200,6248,6128,6222,6184,98,60,44,2721160,2
668,p1409,20140224,6200,6214,6248,6270,6190,6260,6236,46,22,402970,25132970240,404374
841,p1410,20140224,6228,6228,0,0,0,6238,6238,10,10,0,0,14
1035,p1411,20140224,6202,6202,0,0,0,6228,6228,26,26,0,0,0
1247,p1412,20140224,6224,6224,0,0,0,6264,6264,40,40,0,0,10
1469,p1501,20140224,6162,6170,6218,6290,6156,6232,6202,62,32,6926,429650200,27896
1683,p1502,20140224,6198,6198,0,0,0,6198,6198,0,0,0,0,0
75,p1403,20140225,6104,6104,0,0,0,6104,6104,0,0,0,0,2
122,p1404,20140225,5868,5868,6102,6102,6050,6058,6080,190,212,40,2432160,12
190,p1405,20140225,6164,6124,6120,6140,6096,6112,6114,-12,-10,285066,17432615760,387422
279,p1406,20140225,6210,6200,6198,6198,6156,6178,6174,-22,-26,16,988120,22
388,p1407,20140225,6168,6168,0,0,0,6144,6144,-24,-24,0,0,0
517,p1408,20140225,6222,6184,6222,6222,6170,6170,6196,-14,12,4,247840,2
669,p1409,20140225,6260,6236,6208,6238,6188,6208,6212,-28,-24,298548,18546212200,396218
842,p1410,20140225,6238,6238,0,0,0,6214,6214,-24,-24,0,0,14
1036,p1411,20140225,6228,6228,0,0,0,6228,6228,0,0,0,0,0
1248,p1412,20140225,6264,6264,0,0,0,6264,6264,0,0,0,0,10
1470,p1501,20140225,6232,6202,6202,6202,6160,6174,6182,-28,-20,4328,267574800,29336
1684,p1502,20140225,6198,6198,0,0,0,6198,6198,0,0,0,0,0
76,p1403,20140226,6104,6104,0,0,0,6104,6104,0,0,0,0,2
123,p1404,20140226,6058,6080,0,0,0,6080,6080,0,0,0,0,12
191,p1405,20140226,6112,6114,6096,6130,6040,6126,6082,12,-32,326510,19863413960,396444
280,p1406,20140226,6178,6174,6106,6186,6088,6138,6140,-36,-34,160,9824440,36
389,p1407,20140226,6144,6144,0,0,0,6144,6144,0,0,0,0,0
518,p1408,20140226,6170,6196,0,0,0,6162,6162,-34,-34,0,0,2
670,p1409,20140226,6208,6212,6200,6242,6126,6240,6182,28,-30,499570,30888840480,448286
843,p1410,20140226,6214,6214,0,0,0,6184,6184,-30,-30,0,0,14
1037,p1411,20140226,6228,6228,0,0,0,6228,6228,0,0,0,0,0
1249,p1412,20140226,6264,6264,0,0,0,6234,6234,-30,-30,0,0,10
1471,p1501,20140226,6174,6182,6156,6178,6096,6178,6144,-4,-38,7712,473876480,32878
1685,p1502,20140226,6198,6198,0,0,0,6198,6198,0,0,0,0,0
77,p1403,20140227,6104,6104,5936,6348,5886,6100,6066,-4,-38,8,485400,0
124,p1404,20140227,6080,6080,0,0,0,6080,6080,0,0,0,0,12
192,p1405,20140227,6126,6082,6160,6194,6136,6152,6160,70,78,303426,18696257320,339874
281,p1406,20140227,6138,6140,6170,6210,6170,6180,6196,40,56,22,1363200,26
390,p1407,20140227,6144,6144,0,0,0,6200,6200,56,56,0,0,0
519,p1408,20140227,6162,6162,6174,6174,6174,6174,6174,12,12,2,123480,4
671,p1409,20140227,6240,6182,6300,6310,6256,6266,6284,84,102,577728,36306981280,449036
844,p1410,20140227,6184,6184,0,0,0,6286,6286,102,102,0,0,14
1038,p1411,20140227,6228,6228,0,0,0,6236,6236,8,8,0,0,0
1250,p1412,20140227,6234,6234,0,0,0,6280,6280,46,46,0,0,10
1472,p1501,20140227,6178,6144,6298,6298,6206,6212,6230,68,86,11942,743993640,33820
1686,p1502,20140227,6198,6198,0,0,0,6198,6198,0,0,0,0,0
78,p1403,20140228,6100,6066,0,0,0,6066,6066,0,0,0,0,0
125,p1404,20140228,6080,6080,0,0,0,6080,6080,0,0,0,0,12
193,p1405,20140228,6152,6160,6110,6120,6056,6102,6082,-58,-78,192182,11692039600,323826
282,p1406,20140228,6180,6196,6108,6152,6100,6100,6104,-96,-92,126,7692720,126
391,p1407,20140228,6200,6200,0,0,0,6190,6190,-10,-10,0,0,0
520,p1408,20140228,6174,6174,6152,6152,6152,6152,6152,-22,-22,2,123040,2
672,p1409,20140228,6266,6284,6240,6240,6156,6212,6192,-72,-92,427112,26447486080,436168
845,p1410,20140228,6286,6286,0,0,0,6248,6248,-38,-38,0,0,14
1039,p1411,20140228,6236,6236,0,0,0,6236,6236,0,0,0,0,0
1251,p1412,20140228,6280,6280,0,0,0,6264,6264,-16,-16,0,0,10
1473,p1501,20140228,6212,6230,6194,6194,6118,6158,6144,-72,-86,8038,493888320,35280
1687,p1502,20140228,6198,6198,0,0,0,6198,6198,0,0,0,0,0
79,p1403,20140303,6066,6066,0,0,0,6066,6066,0,0,0,0,0
126,p1404,20140303,6080,6080,0,0,0,6080,6080,0,0,0,0,12
194,p1405,20140303,6102,6082,6190,6194,6146,6172,6168,90,86,138844,8565260280,318850
283,p1406,20140303,6100,6104,6112,6206,6112,6164,6174,60,70,80,4939680,116
392,p1407,20140303,6190,6190,0,0,0,6190,6190,0,0,0,0,0
521,p1408,20140303,6152,6152,0,0,0,6198,6198,46,46,0,0,2
673,p1409,20140303,6212,6192,6268,6322,6260,6298,6292,106,100,505736,31822760720,448264
846,p1410,20140303,6248,6248,0,0,0,6272,6272,24,24,0,0,14
1040,p1411,20140303,6236,6236,0,0,0,6268,6268,32,32,0,0,0
1252,p1412,20140303,6264,6264,0,0,0,6264,6264,0,0,0,0,10
1474,p1501,20140303,6158,6144,6200,6266,6200,6250,6238,106,94,6934,432581200,35492
1688,p1502,20140303,6198,6198,0,0,0,6198,6198,0,0,0,0,0
80,p1403,20140304,6066,6066,0,0,0,6066,6066,0,0,0,0,0
127,p1404,20140304,6080,6080,0,0,0,6080,6080,0,0,0,0,12
195,p1405,20140304,6172,6168,6170,6192,6128,6132,6156,-36,-12,137732,8481211200,307988
284,p1406,20140304,6164,6174,6174,6174,6174,6174,6174,0,0,12,740880,116
393,p1407,20140304,6190,6190,0,0,0,6190,6190,0,0,0,0,0
522,p1408,20140304,6198,6198,0,0,0,6198,6198,0,0,0,0,2
674,p1409,20140304,6298,6292,6276,6316,6238,6244,6278,-48,-14,484566,30422465800,443546
847,p1410,20140304,6272,6272,0,0,0,6272,6272,0,0,0,0,14
1041,p1411,20140304,6268,6268,0,0,0,6256,6256,-12,-12,0,0,0
1253,p1412,20140304,6264,6264,0,0,0,6264,6264,0,0,0,0,10
1475,p1501,20140304,6250,6238,6238,6270,6204,6210,6242,-28,4,8350,521289640,35802
1689,p1502,20140304,6198,6198,0,0,0,6198,6198,0,0,0,0,0
81,p1403,20140305,6066,6066,0,0,0,6066,6066,0,0,0,0,0
128,p1404,20140305,6080,6080,0,0,0,6080,6080,0,0,0,0,12
196,p1405,20140305,6132,6156,6196,6260,6176,6254,6214,98,58,207412,12892121480,304940
285,p1406,20140305,6174,6174,0,0,0,6232,6232,58,58,0,0,116
394,p1407,20140305,6190,6190,0,0,0,6242,6242,52,52,0,0,0
523,p1408,20140305,6198,6198,6368,6368,6290,6342,6348,144,150,186,11808080,8
675,p1409,20140305,6244,6278,6322,6380,6290,6372,6330,94,52,569874,36084022520,446584
848,p1410,20140305,6272,6272,0,0,0,6272,6272,0,0,0,0,14
1042,p1411,20140305,6256,6256,0,0,0,6310,6310,54,54,0,0,0
1254,p1412,20140305,6264,6264,6354,6354,6354,6354,6354,90,90,2,127080,10
1476,p1501,20140305,6210,6242,6282,6338,6260,6338,6294,96,52,13816,869786000,35956
1690,p1502,20140305,6198,6198,0,0,0,6202,6202,4,4,0,0,0
82,p1403,20140306,6066,6066,0,0,0,6066,6066,0,0,0,0,0
129,p1404,20140306,6080,6080,6026,6028,6026,6028,6026,-52,-54,4,241080,10
197,p1405,20140306,6254,6214,6236,6244,6180,6242,6218,28,4,130088,8091293840,289490
286,p1406,20140306,6232,6232,6224,6224,6224,6224,6224,-8,-8,2,124480,116
395,p1407,20140306,6242,6242,0,0,0,6242,6242,0,0,0,0,0
524,p1408,20140306,6342,6348,6328,6336,6246,6302,6306,-46,-42,26,1639920,6
676,p1409,20140306,6372,6330,6340,6358,6290,6356,6328,26,-2,508352,32176636680,449670
849,p1410,20140306,6272,6272,6324,6326,6324,6326,6324,54,52,10,632480,8
1043,p1411,20140306,6310,6310,0,0,0,6324,6324,14,14,0,0,0
1255,p1412,20140306,6354,6354,0,0,0,6354,6354,0,0,0,0,10
1477,p1501,20140306,6338,6294,6310,6330,6260,6318,6300,24,6,15166,955593400,41202
1691,p1502,20140306,6202,6202,0,0,0,6202,6202,0,0,0,0,0
83,p1403,20140307,6066,6066,0,0,0,6066,6066,0,0,0,0,0
130,p1404,20140307,6028,6026,0,0,0,6026,6026,0,0,0,0,10
198,p1405,20140307,6242,6218,6296,6330,6278,6328,6300,110,82,125876,7930619680,274732
287,p1406,20140307,6224,6224,0,0,0,6224,6224,0,0,0,0,116
396,p1407,20140307,6242,6242,0,0,0,6242,6242,0,0,0,0,0
525,p1408,20140307,6302,6306,0,0,0,6308,6308,2,2,0,0,6
677,p1409,20140307,6356,6328,6410,6448,6390,6444,6414,116,86,454166,29132213640,455246
850,p1410,20140307,6326,6324,6474,6474,6318,6404,6368,80,44,10,636960,8
1044,p1411,20140307,6324,6324,0,0,0,6390,6390,66,66,0,0,0
1256,p1412,20140307,6354,6354,0,0,0,6400,6400,46,46,0,0,10
1478,p1501,20140307,6318,6300,6378,6408,6348,6406,6368,106,68,17888,1139441320,45874
1692,p1502,20140307,6202,6202,0,0,0,6282,6282,80,80,0,0,0
84,p1403,20140310,6066,6066,0,0,0,6066,6066,0,0,0,0,0
131,p1404,20140310,6026,6026,0,0,0,6026,6026,0,0,0,0,10
199,p1405,20140310,6328,6300,6312,6314,6222,6312,6268,12,-32,152432,9556532520,270712
288,p1406,20140310,6224,6224,6296,6296,6272,6296,6290,72,66,14,880760,118
397,p1407,20140310,6242,6242,0,0,0,6322,6322,80,80,0,0,0
526,p1408,20140310,6308,6308,6418,6418,6418,6418,6418,110,110,4,256720,10
678,p1409,20140310,6444,6414,6406,6420,6314,6418,6364,4,-50,674140,42908893440,470064
851,p1410,20140310,6404,6368,6334,6334,6334,6334,6334,-34,-34,2,126680,6
1045,p1411,20140310,6390,6390,0,0,0,6390,6390,0,0,0,0,0
1257,p1412,20140310,6400,6400,6314,6314,6314,6314,6314,-86,-86,2,126280,10
1479,p1501,20140310,6406,6368,6380,6380,6278,6360,6332,-8,-36,18518,1172731520,44936
1693,p1502,20140310,6282,6282,0,0,0,6300,6300,18,18,0,0,0
85,p1403,20140311,6066,6066,0,0,0,6066,6066,0,0,0,0,0
132,p1404,20140311,6026,6026,0,0,0,6026,6026,0,0,0,0,10
200,p1405,20140311,6312,6268,6280,6430,6230,6404,6334,136,66,215190,13631692600,263994
289,p1406,20140311,6296,6290,6288,6410,6288,6410,6316,120,26,22,1389680,116
398,p1407,20140311,6322,6322,0,0,0,6322,6322,0,0,0,0,0
527,p1408,20140311,6418,6418,6384,6388,6384,6388,6386,-30,-32,4,255440,6
679,p1409,20140311,6418,6364,6344,6546,6322,6518,6448,154,84,1082688,69820258600,553772
852,p1410,20140311,6334,6334,0,0,0,6334,6334,0,0,0,0,6
1046,p1411,20140311,6390,6390,0,0,0,6408,6408,18,18,0,0,0
1258,p1412,20140311,6314,6314,6444,6444,6444,6444,6444,130,130,2,128880,10
1480,p1501,20140311,6360,6332,6310,6478,6270,6452,6390,120,58,26334,1683076920,47598
1694,p1502,20140311,6300,6300,0,0,0,6308,6308,8,8,0,0,0
86,p1403,20140312,6066,6066,0,0,0,6066,6066,0,0,0,0,0
133,p1404,20140312,6026,6026,6034,6218,6034,6218,6126,192,100,4,245040,10
201,p1405,20140312,6404,6334,6358,6372,6286,6332,6324,-2,-10,166636,10539678160,249566
290,p1406,20140312,6410,6316,6374,6390,6266,6270,6318,-46,2,58,3664760,116
399,p1407,20140312,6322,6322,0,0,0,6322,6322,0,0,0,0,0
528,p1408,20140312,6388,6386,0,0,0,6388,6388,2,2,0,0,6
680,p1409,20140312,6518,6448,6448,6482,6382,6438,6430,-10,-18,797856,51308798520,516832
853,p1410,20140312,6334,6334,6484,6484,6424,6424,6454,90,120,12,774480,6
1047,p1411,20140312,6408,6408,0,0,0,6408,6408,0,0,0,0,0
1259,p1412,20140312,6444,6444,0,0,0,6566,6566,122,122,0,0,10
1481,p1501,20140312,6452,6390,6388,6414,6330,6376,6372,-14,-18,13932,887789720,48780
1695,p1502,20140312,6308,6308,0,0,0,6308,6308,0,0,0,0,0
87,p1403,20140313,6066,6066,0,0,0,6066,6066,0,0,0,0,0
134,p1404,20140313,6218,6126,0,0,0,6126,6126,0,0,0,0,10
202,p1405,20140313,6332,6324,6300,6340,6260,6314,6302,-10,-22,105984,6681002120,237488
291,p1406,20140313,6270,6318,6238,6328,6238,6250,6262,-68,-56,14,876880,118
400,p1407,20140313,6322,6322,0,0,0,6322,6322,0,0,0,0,0
529,p1408,20140313,6388,6388,0,0,0,6388,6388,0,0,0,0,6
681,p1409,20140313,6438,6430,6392,6444,6360,6410,6406,-20,-24,548060,35115688760,505954
854,p1410,20140313,6424,6454,0,0,0,6430,6430,-24,-24,0,0,6
1048,p1411,20140313,6408,6408,0,0,0,6408,6408,0,0,0,0,0
1260,p1412,20140313,6566,6566,0,0,0,6464,6464,-102,-102,0,0,10
1482,p1501,20140313,6376,6372,6330,6380,6294,6348,6340,-24,-32,11188,709448080,48954
1696,p1502,20140313,6308,6308,0,0,0,6308,6308,0,0,0,0,0
88,p1403,20140314,6066,6066,0,0,0,6066,6066,0,0,0,0,0
135,p1404,20140314,6126,6126,0,0,0,6126,6126,0,0,0,0,10
203,p1405,20140314,6314,6302,6288,6294,6160,6178,6222,-124,-80,132388,8238618720,223536
292,p1406,20140314,6250,6262,6298,6298,6150,6170,6180,-92,-82,124,7664800,106
401,p1407,20140314,6322,6322,0,0,0,6322,6322,0,0,0,0,0
530,p1408,20140314,6388,6388,6372,6372,6372,6372,6372,-16,-16,2,127440,4
682,p1409,20140314,6410,6406,6368,6392,6252,6274,6318,-132,-88,592886,37462671440,494580
855,p1410,20140314,6430,6430,6276,6276,6276,6276,6276,-154,-154,4,251040,2
1049,p1411,20140314,6408,6408,0,0,0,6408,6408,0,0,0,0,0
1261,p1412,20140314,6464,6464,0,0,0,6464,6464,0,0,0,0,10
1483,p1501,20140314,6348,6340,6308,6328,6186,6202,6244,-138,-96,19316,1206229680,47708
1697,p1502,20140314,6308,6308,0,0,0,6308,6308,0,0,0,0,0
136,p1404,20140317,6126,6126,6046,6302,5886,6044,6064,-82,-62,20,1212960,2
204,p1405,20140317,6178,6222,6188,6188,6110,6120,6140,-102,-82,93750,5756871840,201752
293,p1406,20140317,6170,6180,6130,6130,6048,6078,6060,-102,-120,62,3758240,142
402,p1407,20140317,6322,6322,0,0,0,6322,6322,0,0,0,0,0
531,p1408,20140317,6372,6372,6274,6274,6182,6182,6234,-190,-138,16,997600,4
683,p1409,20140317,6274,6318,6248,6268,6204,6222,6236,-96,-82,507034,31620489160,484594
856,p1410,20140317,6276,6276,0,0,0,6276,6276,0,0,0,0,2
1050,p1411,20140317,6408,6408,0,0,0,6326,6326,-82,-82,0,0,0
1262,p1412,20140317,6464,6464,0,0,0,6464,6464,0,0,0,0,10
1484,p1501,20140317,6202,6244,6200,6208,6146,6168,6174,-76,-70,16706,1031683200,46538
1698,p1502,20140317,6308,6308,0,0,0,6290,6290,-18,-18,0,0,0
1896,p1503,20140317,6340,6340,0,0,0,6340,6340,0,0,0,0,0
137,p1404,20140318,6044,6064,0,0,0,6064,6064,0,0,0,0,2
205,p1405,20140318,6120,6140,6110,6172,6088,6108,6130,-32,-10,80254,4920658000,183538
294,p1406,20140318,6078,6060,6050,6106,6048,6106,6072,46,12,62,3765520,102
403,p1407,20140318,6322,6322,0,0,0,6254,6254,-68,-68,0,0,0
532,p1408,20140318,6182,6234,0,0,0,6234,6234,0,0,0,0,4
684,p1409,20140318,6222,6236,6194,6270,6186,6204,6228,-32,-8,587994,36624227440,498854
857,p1410,20140318,6276,6276,6134,6286,6134,6286,6210,10,-66,4,248400,2
1051,p1411,20140318,6326,6326,0,0,0,6260,6260,-66,-66,0,0,0
1263,p1412,20140318,6464,6464,6278,6278,6278,6278,6278,-186,-186,2,125560,12
1485,p1501,20140318,6168,6174,6130,6204,6130,6144,6170,-30,-4,12814,790718040,46970
1699,p1502,20140318,6290,6290,0,0,0,6276,6276,-14,-14,0,0,0
1897,p1503,20140318,6340,6340,0,0,0,6340,6340,0,0,0,0,0
138,p1404,20140319,6064,6064,0,0,0,6064,6064,0,0,0,0,2
206,p1405,20140319,6108,6130,6126,6186,6126,6178,6158,48,28,76530,4713410440,174280
295,p1406,20140319,6106,6072,6126,6138,6116,6124,6124,52,52,12,734880,96
404,p1407,20140319,6254,6254,6254,6296,6100,6192,6188,-62,-66,10,618840,0
533,p1408,20140319,6234,6234,0,0,0,6170,6170,-64,-64,0,0,4
685,p1409,20140319,6204,6228,6230,6286,6226,6276,6256,48,28,595298,37250066440,489152
858,p1410,20140319,6286,6210,0,0,0,6210,6210,0,0,0,0,2
1052,p1411,20140319,6260,6260,0,0,0,6260,6260,0,0,0,0,0
1264,p1412,20140319,6278,6278,6284,6284,6284,6284,6284,6,6,2,125680,10
1486,p1501,20140319,6144,6170,6180,6222,6164,6216,6190,46,20,15368,951528160,46990
1700,p1502,20140319,6276,6276,0,0,0,6276,6276,0,0,0,0,0
1898,p1503,20140319,6340,6340,0,0,0,6340,6340,0,0,0,0,0
139,p1404,20140320,6064,6064,5822,5822,5822,5822,5822,-242,-242,6,349320,8
207,p1405,20140320,6178,6158,6158,6158,6036,6048,6082,-110,-76,101086,6149919320,158262
296,p1406,20140320,6124,6124,6166,6166,6026,6026,6088,-98,-36,20,1217920,88
405,p1407,20140320,6192,6188,0,0,0,6152,6152,-36,-36,0,0,0
534,p1408,20140320,6170,6170,0,0,0,6134,6134,-36,-36,0,0,4
686,p1409,20140320,6276,6256,6248,6248,6132,6146,6184,-110,-72,589600,36463192640,456586
859,p1410,20140320,6210,6210,6196,6212,6196,6212,6204,2,-6,4,248160,2
1053,p1411,20140320,6260,6260,0,0,0,6236,6236,-24,-24,0,0,0
1265,p1412,20140320,6284,6284,0,0,0,6278,6278,-6,-6,0,0,10
1487,p1501,20140320,6216,6190,6200,6200,6092,6104,6136,-86,-54,25318,1553756400,52920
1701,p1502,20140320,6276,6276,0,0,0,6222,6222,-54,-54,0,0,0
1899,p1503,20140320,6340,6340,0,0,0,6340,6340,0,0,0,0,0
140,p1404,20140321,5822,5822,5840,5840,5752,5752,5796,-70,-26,4,231840,8
208,p1405,20140321,6048,6082,6020,6106,6016,6046,6070,-36,-12,67188,4078656200,148114
297,p1406,20140321,6026,6088,6036,6038,6016,6038,6032,-50,-56,18,1085880,96
406,p1407,20140321,6152,6152,0,0,0,6152,6152,0,0,0,0,0
535,p1408,20140321,6134,6134,0,0,0,6134,6134,0,0,0,0,4
687,p1409,20140321,6146,6184,6122,6204,6112,6140,6164,-44,-20,576008,35514462360,464444
860,p1410,20140321,6212,6204,6166,6198,6020,6178,6152,-26,-52,20,1230640,2
1054,p1411,20140321,6236,6236,0,0,0,6236,6236,0,0,0,0,0
1266,p1412,20140321,6278,6278,0,0,0,6226,6226,-52,-52,0,0,10
1488,p1501,20140321,6104,6136,6098,6158,6058,6096,6114,-40,-22,21646,1323583800,57086
1702,p1502,20140321,6222,6222,0,0,0,6200,6200,-22,-22,0,0,0
1900,p1503,20140321,6340,6340,6058,6332,6058,6332,6194,-8,-146,4,247800,2
141,p1404,20140324,5752,5796,0,0,0,5796,5796,0,0,0,0,8
209,p1405,20140324,6046,6070,6020,6090,6020,6062,6060,-8,-10,38708,2346406760,143056
298,p1406,20140324,6038,6032,6004,6030,6004,6030,6016,-2,-16,4,240680,94
407,p1407,20140324,6152,6152,0,0,0,6152,6152,0,0,0,0,0
536,p1408,20140324,6134,6134,0,0,0,6134,6134,0,0,0,0,4
688,p1409,20140324,6140,6164,6140,6186,6120,6160,6156,-4,-8,382008,23521303800,470646
861,p1410,20140324,6178,6152,0,0,0,6152,6152,0,0,0,0,2
1055,p1411,20140324,6236,6236,0,0,0,6228,6228,-8,-8,0,0,0
1267,p1412,20140324,6226,6226,0,0,0,6218,6218,-8,-8,0,0,10
1489,p1501,20140324,6096,6114,6080,6126,6080,6104,6102,-10,-12,20642,1259933960,59168
1703,p1502,20140324,6200,6200,0,0,0,6200,6200,0,0,0,0,0
1901,p1503,20140324,6332,6194,0,0,0,6182,6182,-12,-12,0,0,2
142,p1404,20140325,5796,5796,5900,5900,5900,5900,5900,104,104,6,354000,2
210,p1405,20140325,6062,6060,6040,6080,5982,6036,6022,-24,-38,49320,2970196800,137626
299,p1406,20140325,6030,6016,5996,5996,5970,5970,5982,-46,-34,4,239320,90
408,p1407,20140325,6152,6152,0,0,0,6152,6152,0,0,0,0,0
537,p1408,20140325,6134,6134,0,0,0,6134,6134,0,0,0,0,4
689,p1409,20140325,6160,6156,6122,6176,6072,6126,6114,-30,-42,573290,35060826640,459950
862,p1410,20140325,6152,6152,0,0,0,6152,6152,0,0,0,0,2
1056,p1411,20140325,6228,6228,6182,6182,6182,6182,6182,-46,-46,2,123640,2
1268,p1412,20140325,6218,6218,0,0,0,6174,6174,-44,-44,0,0,10
1490,p1501,20140325,6104,6102,6080,6120,6022,6078,6064,-24,-38,22562,1368520960,61022
1704,p1502,20140325,6200,6200,0,0,0,6194,6194,-6,-6,0,0,0
1902,p1503,20140325,6182,6182,0,0,0,6144,6144,-38,-38,0,0,2
143,p1404,20140326,5900,5900,5668,5668,5668,5668,5668,-232,-232,2,113360,2
211,p1405,20140326,6036,6022,6050,6130,6048,6096,6094,74,72,51224,3122237880,125464
300,p1406,20140326,5970,5982,6088,6094,6046,6066,6068,84,86,28,1699080,82
409,p1407,20140326,6152,6152,0,0,0,6152,6152,0,0,0,0,0
538,p1408,20140326,6134,6134,0,0,0,6134,6134,0,0,0,0,4
690,p1409,20140326,6126,6114,6138,6230,6136,6196,6196,82,82,495586,30707670240,461042
863,p1410,20140326,6152,6152,0,0,0,6152,6152,0,0,0,0,2
1057,p1411,20140326,6182,6182,0,0,0,6182,6182,0,0,0,0,2
1269,p1412,20140326,6174,6174,0,0,0,6256,6256,82,82,0,0,10
1491,p1501,20140326,6078,6064,6080,6174,6080,6150,6142,86,78,19206,1179767600,62994
1705,p1502,20140326,6194,6194,0,0,0,6194,6194,0,0,0,0,0
1903,p1503,20140326,6144,6144,6160,6180,6160,6180,6170,36,26,8,493600,2
144,p1404,20140327,5668,5668,0,0,0,5668,5668,0,0,0,0,2
212,p1405,20140327,6096,6094,6068,6138,6042,6116,6100,22,6,47822,2917215760,113460
301,p1406,20140327,6066,6068,6076,6158,6034,6086,6100,18,32,44,2684320,72
410,p1407,20140327,6152,6152,0,0,0,6152,6152,0,0,0,0,0
539,p1408,20140327,6134,6134,0,0,0,6152,6152,18,18,0,0,4
691,p1409,20140327,6196,6196,6172,6256,6140,6224,6198,28,2,575408,35668217440,472610
864,p1410,20140327,6152,6152,0,0,0,6152,6152,0,0,0,0,2
1058,p1411,20140327,6182,6182,6192,6192,6192,6192,6192,10,10,2,123840,0
1270,p1412,20140327,6256,6256,0,0,0,6266,6266,10,10,0,0,10
1492,p1501,20140327,6150,6142,6128,6210,6096,6178,6152,36,10,26350,1621426960,64550
1706,p1502,20140327,6194,6194,0,0,0,6194,6194,0,0,0,0,0
1904,p1503,20140327,6180,6170,0,0,0,6180,6180,10,10,0,0,2
145,p1404,20140328,5668,5668,0,0,0,5668,5668,0,0,0,0,2
213,p1405,20140328,6116,6100,6078,6114,6062,6078,6090,-22,-10,53898,3282777200,101236
302,p1406,20140328,6086,6100,6118,6118,6080,6080,6088,-20,-12,8,487160,66
411,p1407,20140328,6152,6152,0,0,0,6152,6152,0,0,0,0,0
540,p1408,20140328,6152,6152,6186,6218,6128,6150,6180,-2,28,28,1730640,2
692,p1409,20140328,6224,6198,6184,6222,6162,6182,6194,-16,-4,486642,30146777720,478282
865,p1410,20140328,6152,6152,0,0,0,6152,6152,0,0,0,0,2
1059,p1411,20140328,6192,6192,0,0,0,6192,6192,0,0,0,0,0
1271,p1412,20140328,6266,6266,0,0,0,6262,6262,-4,-4,0,0,10
1493,p1501,20140328,6178,6152,6148,6180,6122,6144,6152,-8,0,24508,1508197320,68564
1707,p1502,20140328,6194,6194,6150,6250,6150,6220,6204,26,10,14,868760,2
1905,p1503,20140328,6180,6180,0,0,0,6188,6188,8,8,0,0,2
146,p1404,20140331,5668,5668,5894,5894,5894,5894,5894,226,226,2,117880,0
214,p1405,20140331,6078,6090,6066,6106,6042,6056,6068,-34,-22,41298,2506511520,94714
303,p1406,20140331,6080,6088,6080,6080,6080,6080,6080,-8,-8,2,121600,66
412,p1407,20140331,6152,6152,0,0,0,6152,6152,0,0,0,0,0
541,p1408,20140331,6150,6180,6152,6212,6080,6202,6154,22,-26,10,615560,2
693,p1409,20140331,6182,6194,6162,6216,6148,6170,6178,-24,-16,481756,29769118880,470426
866,p1410,20140331,6152,6152,6252,6252,6154,6154,6202,2,50,4,248120,2
1060,p1411,20140331,6192,6192,0,0,0,6192,6192,0,0,0,0,0
1272,p1412,20140331,6262,6262,0,0,0,6312,6312,50,50,0,0,10
1494,p1501,20140331,6144,6152,6100,6172,6100,6132,6140,-20,-12,29014,1781745640,67414
1708,p1502,20140331,6220,6204,0,0,0,6192,6192,-12,-12,0,0,2
1906,p1503,20140331,6188,6188,0,0,0,6176,6176,-12,-12,0,0,2
147,p1404,20140401,5894,5894,0,0,0,5894,5894,0,0,0,0,0
215,p1405,20140401,6056,6068,6030,6084,6014,6064,6050,-4,-18,34092,2062974040,87022
304,p1406,20140401,6080,6080,5918,6062,5918,6060,6022,-20,-58,10,602240,60
413,p1407,20140401,6152,6152,0,0,0,6152,6152,0,0,0,0,0
542,p1408,20140401,6202,6154,0,0,0,6154,6154,0,0,0,0,2
694,p1409,20140401,6170,6178,6180,6210,6124,6194,6168,16,-10,550946,33982956680,487686
867,p1410,20140401,6154,6202,6280,6280,6280,6280,6280,78,78,2,125600,4
1061,p1411,20140401,6192,6192,0,0,0,6192,6192,0,0,0,0,0
1273,p1412,20140401,6312,6312,0,0,0,6390,6390,78,78,0,0,10
1495,p1501,20140401,6132,6140,6160,6170,6088,6156,6128,16,-12,32834,2012285280,67538
1709,p1502,20140401,6192,6192,0,0,0,6180,6180,-12,-12,0,0,2
1907,p1503,20140401,6176,6176,0,0,0,6164,6164,-12,-12,0,0,2
148,p1404,20140402,5894,5894,0,0,0,5894,5894,0,0,0,0,0
216,p1405,20140402,6064,6050,6100,6190,6100,6114,6146,64,96,44808,2754736040,77960
305,p1406,20140402,6060,6022,6190,6190,6090,6146,6140,124,118,10,614120,58
414,p1407,20140402,6152,6152,0,0,0,6152,6152,0,0,0,0,0
543,p1408,20140402,6154,6154,6376,6376,6292,6292,6334,138,180,4,253360,2
695,p1409,20140402,6194,6168,6266,6370,6252,6294,6318,126,150,627970,39683962680,490656
868,p1410,20140402,6280,6280,6280,6280,6280,6280,6280,0,0,4,251200,2
1062,p1411,20140402,6192,6192,0,0,0,6242,6242,50,50,0,0,0
1274,p1412,20140402,6390,6390,0,0,0,6390,6390,0,0,0,0,10
1496,p1501,20140402,6156,6128,6198,6324,6198,6252,6270,124,142,41458,2600055920,69108
1710,p1502,20140402,6180,6180,0,0,0,6322,6322,142,142,0,0,2
1908,p1503,20140402,6164,6164,0,0,0,6306,6306,142,142,0,0,2
149,p1404,20140403,5894,5894,0,0,0,5894,5894,0,0,0,0,0
217,p1405,20140403,6114,6146,6078,6088,6034,6038,6058,-108,-88,27412,1660969800,76158
306,p1406,20140403,6146,6140,0,0,0,6140,6140,0,0,0,0,58
415,p1407,20140403,6152,6152,0,0,0,6152,6152,0,0,0,0,0
544,p1408,20140403,6292,6334,0,0,0,6242,6242,-92,-92,0,0,2
696,p1409,20140403,6294,6318,6230,6246,6178,6182,6212,-136,-106,450296,27972972840,481324
869,p1410,20140403,6280,6280,6280,6280,6158,6158,6238,-122,-42,6,374360,2
1063,p1411,20140403,6242,6242,0,0,0,6242,6242,0,0,0,0,0
1275,p1412,20140403,6390,6390,0,0,0,6348,6348,-42,-42,0,0,10
1497,p1501,20140403,6252,6270,6190,6210,6146,6150,6176,-120,-94,33836,2090335400,69808
1711,p1502,20140403,6322,6322,0,0,0,6228,6228,-94,-94,0,0,2
1909,p1503,20140403,6306,6306,0,0,0,6212,6212,-94,-94,0,0,2
150,p1404,20140404,5894,5894,0,0,0,5894,5894,0,0,0,0,0
218,p1405,20140404,6038,6058,6096,6100,6062,6068,6074,10,16,27434,1666501920,67560
307,p1406,20140404,6140,6140,6140,6140,6020,6020,6080,-120,-60,4,243200,58
416,p1407,20140404,6152,6152,0,0,0,6152,6152,0,0,0,0,0
545,p1408,20140404,6242,6242,0,0,0,6242,6242,0,0,0,0,2
697,p1409,20140404,6182,6212,6246,6268,6218,6260,6248,48,36,341150,21317676560,473668
870,p1410,20140404,6158,6238,6234,6234,6234,6234,6234,-4,-4,2,124680,2
1064,p1411,20140404,6242,6242,0,0,0,6242,6242,0,0,0,0,0
1276,p1412,20140404,6348,6348,6174,6298,6174,6298,6236,-50,-112,4,249440,10
1498,p1501,20140404,6150,6176,6194,6240,6184,6236,6218,60,42,33206,2065191800,75454
1712,p1502,20140404,6228,6228,0,0,0,6270,6270,42,42,0,0,2
1910,p1503,20140404,6212,6212,0,0,0,6254,6254,42,42,0,0,2
151,p1404,20140408,5894,5894,0,0,0,5894,5894,0,0,0,0,0
219,p1405,20140408,6068,6074,6030,6062,6010,6054,6038,-20,-36,11374,686890840,63746
308,p1406,20140408,6020,6080,6042,6042,5972,5972,6006,-108,-74,4,240280,58
417,p1407,20140408,6152,6152,0,0,0,6152,6152,0,0,0,0,0
546,p1408,20140408,6242,6242,0,0,0,6240,6240,-2,-2,0,0,2
698,p1409,20140408,6260,6248,6200,6244,6188,6230,6222,-18,-26,277144,17247566800,470918
871,p1410,20140408,6234,6234,0,0,0,6234,6234,0,0,0,0,2
1065,p1411,20140408,6242,6242,0,0,0,6242,6242,0,0,0,0,0
1277,p1412,20140408,6298,6236,0,0,0,6212,6212,-24,-24,0,0,10
1499,p1501,20140408,6236,6218,6196,6222,6156,6208,6196,-10,-22,30314,1878694560,78816
1713,p1502,20140408,6270,6270,0,0,0,6248,6248,-22,-22,0,0,2
1911,p1503,20140408,6254,6254,0,0,0,6232,6232,-22,-22,0,0,2
152,p1404,20140409,5894,5894,0,0,0,5894,5894,0,0,0,0,0
220,p1405,20140409,6054,6038,6060,6082,5992,6010,6038,-28,0,25212,1522469240,55252
309,p1406,20140409,5972,6006,0,0,0,6006,6006,0,0,0,0,58
418,p1407,20140409,6152,6152,0,0,0,6152,6152,0,0,0,0,0
547,p1408,20140409,6240,6240,6160,6164,6160,6164,6162,-76,-78,4,246480,2
699,p1409,20140409,6230,6222,6260,6280,6156,6176,6216,-46,-6,598674,37215129760,480888
872,p1410,20140409,6234,6234,0,0,0,6234,6234,0,0,0,0,2
1066,p1411,20140409,6242,6242,0,0,0,6242,6242,0,0,0,0,0
1278,p1412,20140409,6212,6212,0,0,0,6208,6208,-4,-4,0,0,10
1500,p1501,20140409,6208,6196,6240,6288,6152,6168,6206,-28,10,64850,4024836280,83228
1714,p1502,20140409,6248,6248,6232,6346,6232,6346,6288,98,40,4,251560,2
1912,p1503,20140409,6232,6232,0,0,0,6232,6232,0,0,0,0,2
153,p1404,20140410,5894,5894,0,0,0,5894,5894,0,0,0,0,0
221,p1405,20140410,6010,6038,6048,6070,5968,5968,6020,-70,-18,13198,794693520,52978
310,p1406,20140410,6006,6006,5982,6044,5934,5946,5988,-60,-18,48,2875040,54
419,p1407,20140410,6152,6152,0,0,0,6152,6152,0,0,0,0,0
548,p1408,20140410,6164,6162,0,0,0,6162,6162,0,0,0,0,2
700,p1409,20140410,6176,6216,6250,6270,6144,6144,6206,-72,-10,531234,32971288800,495906
873,p1410,20140410,6234,6234,0,0,0,6234,6234,0,0,0,0,2
1067,p1411,20140410,6242,6242,0,0,0,6230,6230,-12,-12,0,0,0
1279,p1412,20140410,6208,6208,0,0,0,6200,6200,-8,-8,0,0,10
1501,p1501,20140410,6168,6206,6214,6260,6132,6132,6194,-74,-12,55316,3426920080,84512
1715,p1502,20140410,6346,6288,6228,6228,6228,6228,6228,-60,-60,2,124560,0
1913,p1503,20140410,6232,6232,0,0,0,6174,6174,-58,-58,0,0,2
154,p1404,20140411,5894,5894,0,0,0,5894,5894,0,0,0,0,0
222,p1405,20140411,5968,6020,5970,5976,5890,5912,5912,-108,-108,20482,1211105640,49300
311,p1406,20140411,5946,5988,5820,6002,5820,5958,5910,-30,-78,76,4492200,48
420,p1407,20140411,6152,6152,5966,6158,5966,6064,6060,-88,-92,92,5576720,32
549,p1408,20140411,6162,6162,5992,6122,5992,6122,6056,-40,-106,4,242280,4
701,p1409,20140411,6144,6206,6146,6160,6046,6080,6076,-126,-130,664280,40372682680,495038
874,p1410,20140411,6234,6234,0,0,0,6234,6234,0,0,0,0,2
1068,p1411,20140411,6230,6230,6246,6246,6246,6246,6246,16,16,4,249840,4
1280,p1412,20140411,6200,6200,0,0,0,6214,6214,14,14,0,0,10
1502,p1501,20140411,6132,6194,6102,6158,6050,6094,6080,-100,-114,66322,4033357320,88484
1716,p1502,20140411,6228,6228,0,0,0,6228,6228,0,0,0,0,0
1914,p1503,20140411,6174,6174,0,0,0,6062,6062,-112,-112,0,0,2
155,p1404,20140414,5894,5894,0,0,0,5894,5894,0,0,0,0,0
223,p1405,20140414,5912,5912,5922,5954,5920,5942,5934,30,22,18888,1120848840,42608
312,p1406,20140414,5958,5910,0,0,0,5910,5910,0,0,0,0,48
421,p1407,20140414,6064,6060,6064,6064,6064,6064,6064,4,4,28,1697920,4
550,p1408,20140414,6122,6056,0,0,0,6056,6056,0,0,0,0,4
702,p1409,20140414,6080,6076,6088,6136,6082,6112,6112,36,36,416928,25484337080,466824
875,p1410,20140414,6234,6234,0,0,0,6180,6180,-54,-54,0,0,2
1069,p1411,20140414,6246,6246,6070,6070,6070,6070,6070,-176,-176,4,242800,4
1281,p1412,20140414,6214,6214,0,0,0,6040,6040,-174,-174,0,0,10
1503,p1501,20140414,6094,6080,6110,6150,6096,6138,6124,58,44,44942,2752731480,92802
1717,p1502,20140414,6228,6228,0,0,0,6272,6272,44,44,0,0,0
1915,p1503,20140414,6062,6062,0,0,0,6104,6104,42,42,0,0,2
156,p1404,20140415,5894,5894,0,0,0,5894,5894,0,0,0,0,0
224,p1405,20140415,5942,5934,5938,5942,5878,5900,5908,-34,-26,15868,937616760,38444
313,p1406,20140415,5910,5910,0,0,0,5910,5910,0,0,0,0,48
422,p1407,20140415,6064,6064,0,0,0,6064,6064,0,0,0,0,4
551,p1408,20140415,6056,6056,0,0,0,6030,6030,-26,-26,0,0,4
703,p1409,20140415,6112,6112,6108,6130,6058,6086,6096,-26,-16,462390,28195394920,466132
876,p1410,20140415,6180,6180,0,0,0,6164,6164,-16,-16,0,0,2
1070,p1411,20140415,6070,6070,0,0,0,6070,6070,0,0,0,0,4
1282,p1412,20140415,6040,6040,0,0,0,6026,6026,-14,-14,0,0,10
1504,p1501,20140415,6138,6124,6140,6158,6092,6118,6126,-6,2,67326,4124611800,98876
1718,p1502,20140415,6272,6272,0,0,0,6274,6274,2,2,0,0,0
1916,p1503,20140415,6104,6104,6156,6156,6154,6154,6154,50,50,4,246200,0
225,p1405,20140416,5900,5908,5936,5968,5880,5962,5936,54,28,10152,602723440,37142
314,p1406,20140416,5910,5910,0,0,0,5932,5932,22,22,0,0,48
423,p1407,20140416,6064,6064,0,0,0,6064,6064,0,0,0,0,4
552,p1408,20140416,6030,6030,6164,6164,6132,6132,6148,102,118,40,2459200,4
704,p1409,20140416,6086,6096,6124,6214,6114,6212,6168,116,72,541596,33409379840,455240
877,p1410,20140416,6164,6164,0,0,0,6236,6236,72,72,0,0,2
1071,p1411,20140416,6070,6070,0,0,0,6140,6140,70,70,0,0,4
1283,p1412,20140416,6026,6026,0,0,0,6096,6096,70,70,0,0,10
1505,p1501,20140416,6118,6126,6160,6248,6150,6248,6208,122,82,84706,5258846560,101436
1719,p1502,20140416,6274,6274,0,0,0,6356,6356,82,82,0,0,0
1917,p1503,20140416,6154,6154,0,0,0,6154,6154,0,0,0,0,0
2094,p1504,20140416,6124,6124,6008,6292,6006,6242,6144,118,20,74,4547600,12
226,p1405,20140417,5962,5936,5986,6040,5980,6002,6008,66,72,10544,633676800,37188
315,p1406,20140417,5932,5932,0,0,0,5932,5932,0,0,0,0,48
424,p1407,20140417,6064,6064,0,0,0,6064,6064,0,0,0,0,4
553,p1408,20140417,6132,6148,0,0,0,6148,6148,0,0,0,0,4
705,p1409,20140417,6212,6168,6250,6286,6218,6238,6244,70,76,378724,23654344920,439014
878,p1410,20140417,6236,6236,0,0,0,6236,6236,0,0,0,0,2
1072,p1411,20140417,6140,6140,0,0,0,6214,6214,74,74,0,0,4
1284,p1412,20140417,6096,6096,0,0,0,6170,6170,74,74,0,0,10
1506,p1501,20140417,6248,6208,6280,6318,6244,6268,6274,60,66,69912,4386985160,110342
1720,p1502,20140417,6356,6356,0,0,0,6356,6356,0,0,0,0,0
1918,p1503,20140417,6154,6154,0,0,0,6154,6154,0,0,0,0,0
2095,p1504,20140417,6242,6144,0,0,0,6208,6208,64,64,0,0,12
227,p1405,20140418,6002,6008,5980,5980,5938,5956,5954,-52,-54,2180,129833720,36722
316,p1406,20140418,5932,5932,0,0,0,5932,5932,0,0,0,0,48
425,p1407,20140418,6064,6064,0,0,0,6064,6064,0,0,0,0,4
554,p1408,20140418,6148,6148,0,0,0,6156,6156,8,8,0,0,4
706,p1409,20140418,6238,6244,6192,6208,6164,6190,6186,-54,-58,322750,19970387400,420502
879,p1410,20140418,6236,6236,6212,6214,6212,6214,6212,-22,-24,4,248520,0
1073,p1411,20140418,6214,6214,0,0,0,6192,6192,-22,-22,0,0,4
1285,p1412,20140418,6170,6170,0,0,0,6148,6148,-22,-22,0,0,10
1507,p1501,20140418,6268,6274,6212,6242,6204,6230,6226,-44,-48,59828,3724994560,107414
1721,p1502,20140418,6356,6356,0,0,0,6308,6308,-48,-48,0,0,0
1919,p1503,20140418,6154,6154,0,0,0,6154,6154,0,0,0,0,0
2096,p1504,20140418,6208,6208,0,0,0,6162,6162,-46,-46,0,0,12
228,p1405,20140421,5956,5954,5970,5992,5912,5920,5938,-34,-16,4330,257145920,34886
317,p1406,20140421,5932,5932,5930,5930,5890,5890,5920,-42,-12,8,473600,40
426,p1407,20140421,6064,6064,6228,6228,6148,6148,6188,84,124,8,495040,6
555,p1408,20140421,6156,6156,0,0,0,6280,6280,124,124,0,0,4
707,p1409,20140421,6190,6186,6192,6246,6124,6126,6166,-60,-20,393312,24255706400,420308
880,p1410,20140421,6214,6212,6282,6282,6152,6152,6216,-60,4,4,248680,2
1074,p1411,20140421,6192,6192,0,0,0,6194,6194,2,2,0,0,4
1286,p1412,20140421,6148,6148,0,0,0,6150,6150,2,2,0,0,10
1508,p1501,20140421,6230,6226,6246,6290,6174,6180,6208,-46,-18,59324,3683418560,112946
1722,p1502,20140421,6308,6308,0,0,0,6290,6290,-18,-18,0,0,0
1920,p1503,20140421,6154,6154,0,0,0,6186,6186,32,32,0,0,0
2097,p1504,20140421,6162,6162,0,0,0,6146,6146,-16,-16,0,0,12
229,p1405,20140422,5920,5938,5924,5942,5916,5936,5930,-2,-8,4338,257249480,32266
318,p1406,20140422,5890,5920,0,0,0,5920,5920,0,0,0,0,40
427,p1407,20140422,6148,6188,0,0,0,6180,6180,-8,-8,0,0,6
556,p1408,20140422,6280,6280,0,0,0,6220,6220,-60,-60,0,0,4
708,p1409,20140422,6126,6166,6138,6204,6114,6190,6168,24,2,348408,21491904800,429672
881,p1410,20140422,6152,6216,0,0,0,6216,6216,0,0,0,0,2
1075,p1411,20140422,6194,6194,0,0,0,6196,6196,2,2,0,0,4
1287,p1412,20140422,6150,6150,0,0,0,6150,6150,0,0,0,0,10
1509,p1501,20140422,6180,6208,6192,6270,6168,6262,6232,54,24,75868,4728864000,120390
1723,p1502,20140422,6290,6290,0,0,0,6314,6314,24,24,0,0,0
1921,p1503,20140422,6186,6186,0,0,0,6246,6246,60,60,0,0,0
2098,p1504,20140422,6146,6146,0,0,0,6168,6168,22,22,0,0,12
230,p1405,20140423,5936,5930,5930,5932,5900,5930,5916,0,-14,4144,245164080,29250
319,p1406,20140423,5920,5920,0,0,0,5920,5920,0,0,0,0,40
428,p1407,20140423,6180,6180,0,0,0,6166,6166,-14,-14,0,0,6
557,p1408,20140423,6220,6220,0,0,0,6220,6220,0,0,0,0,4
709,p1409,20140423,6190,6168,6156,6182,6120,6148,6148,-20,-20,325942,20043357560,429268
882,p1410,20140423,6216,6216,0,0,0,6216,6216,0,0,0,0,2
1076,p1411,20140423,6196,6196,0,0,0,6176,6176,-20,-20,0,0,4
1288,p1412,20140423,6150,6150,0,0,0,6132,6132,-18,-18,0,0,10
1510,p1501,20140423,6262,6232,6240,6248,6192,6224,6220,-8,-12,68162,4240935280,122024
1724,p1502,20140423,6314,6314,0,0,0,6302,6302,-12,-12,0,0,0
1922,p1503,20140423,6246,6246,0,0,0,6246,6246,0,0,0,0,0
2099,p1504,20140423,6168,6168,6268,6268,6268,6268,6268,100,100,12,752160,24
231,p1405,20140424,5930,5916,5930,5932,5912,5920,5922,4,6,1494,88501720,28012
320,p1406,20140424,5920,5920,0,0,0,5920,5920,0,0,0,0,40
429,p1407,20140424,6166,6166,0,0,0,6172,6172,6,6,0,0,6
558,p1408,20140424,6220,6220,0,0,0,6204,6204,-16,-16,0,0,4
710,p1409,20140424,6148,6148,6138,6160,6116,6140,6140,-8,-8,264026,16215103240,426298
883,p1410,20140424,6216,6216,0,0,0,6216,6216,0,0,0,0,2
1077,p1411,20140424,6176,6176,0,0,0,6168,6168,-8,-8,0,0,4
1289,p1412,20140424,6132,6132,0,0,0,6126,6126,-6,-6,0,0,10
1511,p1501,20140424,6224,6220,6210,6238,6196,6224,6224,4,4,52058,3240129480,119894
1725,p1502,20140424,6302,6302,0,0,0,6302,6302,0,0,0,0,0
1923,p1503,20140424,6246,6246,0,0,0,6246,6246,0,0,0,0,0
2100,p1504,20140424,6268,6268,0,0,0,6272,6272,4,4,0,0,24
232,p1405,20140425,5920,5922,5926,5946,5904,5924,5934,2,12,2476,146943400,26920
321,p1406,20140425,5920,5920,5948,5948,5926,5926,5938,6,18,16,950360,34
430,p1407,20140425,6172,6172,0,0,0,6190,6190,18,18,0,0,6
559,p1408,20140425,6204,6204,0,0,0,6204,6204,0,0,0,0,4
711,p1409,20140425,6140,6140,6160,6210,6148,6158,6178,18,38,369186,22809892800,423738
884,p1410,20140425,6216,6216,0,0,0,6216,6216,0,0,0,0,2
1078,p1411,20140425,6168,6168,0,0,0,6206,6206,38,38,0,0,4
1290,p1412,20140425,6126,6126,0,0,0,6162,6162,36,36,0,0,10
1512,p1501,20140425,6224,6224,6238,6288,6236,6240,6262,16,38,79888,5003678840,121300
1726,p1502,20140425,6302,6302,0,0,0,6302,6302,0,0,0,0,0
1924,p1503,20140425,6246,6246,0,0,0,6246,6246,0,0,0,0,0
2101,p1504,20140425,6272,6272,0,0,0,6310,6310,38,38,0,0,24
233,p1405,20140428,5924,5934,5924,5970,5914,5940,5948,6,14,4300,255769840,23806
322,p1406,20140428,5926,5938,0,0,0,5938,5938,0,0,0,0,34
431,p1407,20140428,6190,6190,0,0,0,6204,6204,14,14,0,0,6
560,p1408,20140428,6204,6204,0,0,0,6204,6204,0,0,0,0,4
712,p1409,20140428,6158,6178,6186,6240,6176,6192,6208,14,30,389682,24191743200,420182
885,p1410,20140428,6216,6216,0,0,0,6216,6216,0,0,0,0,2
1079,p1411,20140428,6206,6206,0,0,0,6236,6236,30,30,0,0,4
1291,p1412,20140428,6162,6162,0,0,0,6190,6190,28,28,0,0,10
1513,p1501,20140428,6240,6262,6266,6306,6240,6264,6272,2,10,87774,5506470440,129286
1727,p1502,20140428,6302,6302,0,0,0,6302,6302,0,0,0,0,0
1925,p1503,20140428,6246,6246,0,0,0,6264,6264,18,18,0,0,0
2102,p1504,20140428,6310,6310,6338,6338,6338,6338,6338,28,28,12,760560,12
234,p1405,20140429,5940,5948,5934,5934,5862,5900,5896,-48,-52,3702,218310160,21752
323,p1406,20140429,5938,5938,5912,6074,5912,5930,5956,-8,18,8,476560,28
432,p1407,20140429,6204,6204,6108,6108,6108,6108,6108,-96,-96,6,366480,6
561,p1408,20140429,6204,6204,6168,6316,5982,6138,6176,-66,-28,1768,109197320,62
713,p1409,20140429,6192,6208,6150,6176,6124,6170,6154,-38,-54,421708,25954653800,428870
886,p1410,20140429,6216,6216,0,0,0,6216,6216,0,0,0,0,2
1080,p1411,20140429,6236,6236,0,0,0,6182,6182,-54,-54,0,0,4
1292,p1412,20140429,6190,6190,0,0,0,6138,6138,-52,-52,0,0,10
1514,p1501,20140429,6264,6272,6230,6254,6210,6252,6234,-20,-38,74104,4620148760,133310
1728,p1502,20140429,6302,6302,0,0,0,6302,6302,0,0,0,0,0
1926,p1503,20140429,6264,6264,6180,6324,6180,6290,6254,26,-10,134,8380760,18
2103,p1504,20140429,6338,6338,0,0,0,6328,6328,-10,-10,0,0,12
235,p1405,20140430,5900,5896,5898,5898,5876,5876,5882,-20,-14,2836,166829600,20094
324,p1406,20140430,5930,5956,5938,5938,5938,5938,5938,-18,-18,12,712560,16
433,p1407,20140430,6108,6108,6030,6030,6030,6030,6030,-78,-78,2,120600,6
562,p1408,20140430,6138,6176,0,0,0,6130,6130,-46,-46,0,0,62
714,p1409,20140430,6170,6154,6166,6170,6118,6130,6138,-24,-16,315216,19351701720,434904
887,p1410,20140430,6216,6216,0,0,0,6216,6216,0,0,0,0,2
1081,p1411,20140430,6182,6182,0,0,0,6166,6166,-16,-16,0,0,4
1293,p1412,20140430,6138,6138,0,0,0,6124,6124,-14,-14,0,0,10
1515,p1501,20140430,6252,6234,6240,6248,6212,6224,6230,-10,-4,44590,2778120480,133898
1729,p1502,20140430,6302,6302,0,0,0,6302,6302,0,0,0,0,0
1927,p1503,20140430,6290,6254,6250,6250,6250,6250,6250,-4,-4,16,1000000,2
2104,p1504,20140430,6328,6328,0,0,0,6324,6324,-4,-4,0,0,12
236,p1405,20140505,5876,5882,5850,5862,5530,5830,5836,-52,-46,4292,250554880,17320
325,p1406,20140505,5938,5938,0,0,0,5938,5938,0,0,0,0,16
434,p1407,20140505,6030,6030,6026,6026,6022,6022,6022,-8,-8,6,361400,0
563,p1408,20140505,6130,6130,6034,6034,6006,6028,6022,-102,-108,6,361360,62
715,p1409,20140505,6130,6138,6070,6074,6006,6006,6036,-132,-102,396906,23961743160,449602
888,p1410,20140505,6216,6216,6120,6120,6016,6016,6042,-200,-174,8,483360,8
1082,p1411,20140505,6166,6166,0,0,0,5994,5994,-172,-172,0,0,4
1294,p1412,20140505,6124,6124,0,0,0,5954,5954,-170,-170,0,0,10
1516,p1501,20140505,6224,6230,6150,6164,6114,6120,6136,-110,-94,64384,3951372920,138660
1730,p1502,20140505,6302,6302,0,0,0,6274,6274,-28,-28,0,0,0
1928,p1503,20140505,6250,6250,0,0,0,6206,6206,-44,-44,0,0,2
2105,p1504,20140505,6324,6324,0,0,0,6236,6236,-88,-88,0,0,12
237,p1405,20140506,5830,5836,5770,5824,5770,5824,5808,-12,-28,124,7203000,17232
326,p1406,20140506,5938,5938,5938,5938,5938,5938,5938,0,0,2,118760,14
435,p1407,20140506,6022,6022,0,0,0,6012,6012,-10,-10,0,0,0
564,p1408,20140506,6028,6022,0,0,0,6006,6006,-16,-16,0,0,62
716,p1409,20140506,6006,6036,5986,6006,5966,5988,5988,-48,-48,314340,18825723560,438000
889,p1410,20140506,6016,6042,6020,6020,5982,5982,6010,-60,-32,8,480840,2
1083,p1411,20140506,5994,5994,0,0,0,5964,5964,-30,-30,0,0,4
1295,p1412,20140506,5954,5954,0,0,0,5924,5924,-30,-30,0,0,10
1517,p1501,20140506,6120,6136,6098,6122,6084,6102,6104,-34,-32,47588,2905252280,144754
1731,p1502,20140506,6274,6274,0,0,0,6238,6238,-36,-36,0,0,0
1929,p1503,20140506,6206,6206,0,0,0,6178,6178,-28,-28,0,0,2
2106,p1504,20140506,6236,6236,0,0,0,6216,6216,-20,-20,0,0,12
238,p1405,20140507,5824,5808,5840,5856,5830,5830,5848,22,40,800,46797440,16460
327,p1406,20140507,5938,5938,0,0,0,5938,5938,0,0,0,0,14
436,p1407,20140507,6012,6012,0,0,0,6012,6012,0,0,0,0,0
565,p1408,20140507,6006,6006,5902,6018,5902,6002,5968,-4,-38,10,596840,60
717,p1409,20140507,5988,5988,5972,6024,5972,6002,6006,14,18,307938,18497116400,418630
890,p1410,20140507,5982,6010,0,0,0,6010,6010,0,0,0,0,2
1084,p1411,20140507,5964,5964,0,0,0,5980,5980,16,16,0,0,4
1296,p1412,20140507,5924,5924,0,0,0,5940,5940,16,16,0,0,10
1518,p1501,20140507,6102,6104,6084,6132,6084,6112,6112,8,8,53158,3249665040,150576
1732,p1502,20140507,6238,6238,0,0,0,6238,6238,0,0,0,0,0
1930,p1503,20140507,6178,6178,0,0,0,6178,6178,0,0,0,0,2
2107,p1504,20140507,6216,6216,0,0,0,6158,6158,-58,-58,0,0,12
239,p1405,20140508,5830,5848,5792,5818,5790,5800,5792,-48,-56,94,5444640,16384
328,p1406,20140508,5938,5938,0,0,0,5938,5938,0,0,0,0,14
437,p1407,20140508,6012,6012,0,0,0,6012,6012,0,0,0,0,0
566,p1408,20140508,6002,5968,5976,5976,5954,5954,5966,-14,-2,18,1073960,52
718,p1409,20140508,6002,6006,6008,6012,5952,5968,5970,-38,-36,283684,16938756240,412720
891,p1410,20140508,6010,6010,0,0,0,6010,6010,0,0,0,0,2
1085,p1411,20140508,5980,5980,0,0,0,5946,5946,-34,-34,0,0,4
1297,p1412,20140508,5940,5940,0,0,0,5906,5906,-34,-34,0,0,10
1519,p1501,20140508,6112,6112,6110,6120,6070,6080,6090,-32,-22,56544,3444495320,152958
1733,p1502,20140508,6238,6238,0,0,0,6224,6224,-14,-14,0,0,0
1931,p1503,20140508,6178,6178,0,0,0,6154,6154,-24,-24,0,0,2
2108,p1504,20140508,6158,6158,0,0,0,6136,6136,-22,-22,0,0,12
240,p1405,20140509,5800,5792,5800,5836,5800,5830,5828,38,36,582,33920200,15976
329,p1406,20140509,5938,5938,0,0,0,5938,5938,0,0,0,0,14
438,p1407,20140509,6012,6012,0,0,0,6012,6012,0,0,0,0,0
567,p1408,20140509,5954,5966,5952,5952,5952,5952,5952,-14,-14,4,238080,48
719,p1409,20140509,5968,5970,5996,5998,5958,5988,5978,18,8,207232,12389670680,399284
892,p1410,20140509,6010,6010,0,0,0,6010,6010,0,0,0,0,2
1086,p1411,20140509,5946,5946,0,0,0,5952,5952,6,6,0,0,4
1298,p1412,20140509,5906,5906,0,0,0,5912,5912,6,6,0,0,10
1520,p1501,20140509,6080,6090,6090,6108,6066,6080,6082,-10,-8,44278,2693550640,147684
1734,p1502,20140509,6224,6224,0,0,0,6214,6214,-10,-10,0,0,0
1932,p1503,20140509,6154,6154,0,0,0,6146,6146,-8,-8,0,0,2
2109,p1504,20140509,6136,6136,0,0,0,6136,6136,0,0,0,0,12
241,p1405,20140512,5830,5828,0,0,0,5828,5828,0,0,0,0,15976
330,p1406,20140512,5938,5938,0,0,0,5938,5938,0,0,0,0,14
439,p1407,20140512,6012,6012,0,0,0,6012,6012,0,0,0,0,0
568,p1408,20140512,5952,5952,0,0,0,5952,5952,0,0,0,0,48
720,p1409,20140512,5988,5978,5996,6002,5954,5962,5972,-16,-6,265834,15880654520,413818
893,p1410,20140512,6010,6010,0,0,0,6004,6004,-6,-6,0,0,2
1087,p1411,20140512,5952,5952,0,0,0,5948,5948,-4,-4,0,0,4
1299,p1412,20140512,5912,5912,0,0,0,5908,5908,-4,-4,0,0,10
1521,p1501,20140512,6080,6082,6092,6098,6058,6064,6074,-18,-8,41496,2520915800,147410
1735,p1502,20140512,6214,6214,0,0,0,6214,6214,0,0,0,0,0
1933,p1503,20140512,6146,6146,0,0,0,6138,6138,-8,-8,0,0,2
2110,p1504,20140512,6136,6136,0,0,0,6136,6136,0,0,0,0,12
242,p1405,20140513,5828,5828,5828,5830,5828,5830,5828,2,0,200,11659520,15780
331,p1406,20140513,5938,5938,5910,5910,5906,5906,5908,-32,-30,8,472680,6
440,p1407,20140513,6012,6012,0,0,0,6012,6012,0,0,0,0,0
569,p1408,20140513,5952,5952,5982,5982,5982,5982,5982,30,30,2,119640,48
721,p1409,20140513,5962,5972,5952,6036,5932,6030,5992,58,20,590290,35372966520,475120
894,p1410,20140513,6004,6004,0,0,0,6004,6004,0,0,0,0,2
1088,p1411,20140513,5948,5948,0,0,0,5966,5966,18,18,0,0,4
1300,p1412,20140513,5908,5908,0,0,0,5926,5926,18,18,0,0,10
1522,p1501,20140513,6064,6074,6060,6126,6040,6120,6090,46,16,74168,4517633040,152632
1736,p1502,20140513,6214,6214,0,0,0,6214,6214,0,0,0,0,0
1934,p1503,20140513,6138,6138,0,0,0,6138,6138,0,0,0,0,2
2111,p1504,20140513,6136,6136,0,0,0,6136,6136,0,0,0,0,12
243,p1405,20140514,5830,5828,5828,5828,5818,5818,5824,-10,-4,600,34948000,15180
332,p1406,20140514,5906,5908,0,0,0,5908,5908,0,0,0,0,6
441,p1407,20140514,6012,6012,0,0,0,6012,6012,0,0,0,0,0
570,p1408,20140514,5982,5982,6008,6024,5994,5994,6008,12,26,10,600880,46
722,p1409,20140514,6030,5992,6030,6052,5994,6022,6018,30,26,368846,22204129120,421170
895,p1410,20140514,6004,6004,5984,6052,5984,6052,6018,48,14,4,240720,4
1089,p1411,20140514,5966,5966,0,0,0,5978,5978,12,12,0,0,4
1301,p1412,20140514,5926,5926,0,0,0,5938,5938,12,12,0,0,10
1523,p1501,20140514,6120,6090,6104,6140,6094,6130,6118,40,28,62700,3837234680,153678
1737,p1502,20140514,6214,6214,0,0,0,6214,6214,0,0,0,0,0
1935,p1503,20140514,6138,6138,0,0,0,6138,6138,0,0,0,0,2
2112,p1504,20140514,6136,6136,0,0,0,6136,6136,0,0,0,0,12
244,p1405,20140515,5818,5824,0,0,0,5824,5824,0,0,0,0,15180
333,p1406,20140515,5908,5908,0,0,0,5908,5908,0,0,0,0,6
442,p1407,20140515,6012,6012,0,0,0,6012,6012,0,0,0,0,0
571,p1408,20140515,5994,6008,0,0,0,6008,6008,0,0,0,0,46
723,p1409,20140515,6022,6018,6026,6068,6010,6052,6046,34,28,367312,22214496200,430914
896,p1410,20140515,6052,6018,0,0,0,6018,6018,0,0,0,0,4
1090,p1411,20140515,5978,5978,0,0,0,6004,6004,26,26,0,0,4
1302,p1412,20140515,5938,5938,0,0,0,5964,5964,26,26,0,0,10
1524,p1501,20140515,6130,6118,6116,6170,6116,6156,6152,38,34,73856,4543866600,159650
1738,p1502,20140515,6214,6214,0,0,0,6214,6214,0,0,0,0,0
1936,p1503,20140515,6138,6138,0,0,0,6138,6138,0,0,0,0,2
2113,p1504,20140515,6136,6136,0,0,0,6180,6180,44,44,0,0,12
245,p1405,20140516,5824,5824,5846,5846,5760,5760,5834,-64,10,60,3485840,0
334,p1406,20140516,5908,5908,0,0,0,5908,5908,0,0,0,0,6
443,p1407,20140516,6012,6012,0,0,0,6022,6022,10,10,0,0,0
572,p1408,20140516,6008,6008,6010,6018,5998,5998,6008,-10,0,48,2884520,36
724,p1409,20140516,6052,6046,6022,6034,5966,6002,5998,-44,-48,288144,17283857000,407648
897,p1410,20140516,6018,6018,0,0,0,6018,6018,0,0,0,0,4
1091,p1411,20140516,6004,6004,0,0,0,5958,5958,-46,-46,0,0,4
1303,p1412,20140516,5964,5964,0,0,0,5918,5918,-46,-46,0,0,10
1525,p1501,20140516,6156,6152,6136,6142,6086,6114,6108,-38,-44,53566,3272058160,156142
1739,p1502,20140516,6214,6214,0,0,0,6214,6214,0,0,0,0,0
1937,p1503,20140516,6138,6138,0,0,0,6138,6138,0,0,0,0,2
2114,p1504,20140516,6180,6180,0,0,0,6180,6180,0,0,0,0,12
335,p1406,20140519,5908,5908,0,0,0,5908,5908,0,0,0,0,6
444,p1407,20140519,6022,6022,0,0,0,6022,6022,0,0,0,0,0
573,p1408,20140519,5998,6008,0,0,0,6008,6008,0,0,0,0,36
725,p1409,20140519,6002,5998,5974,5974,5940,5952,5954,-46,-44,243510,14498922560,406358
898,p1410,20140519,6018,6018,0,0,0,6018,6018,0,0,0,0,4
1092,p1411,20140519,5958,5958,0,0,0,5916,5916,-42,-42,0,0,4
1304,p1412,20140519,5918,5918,0,0,0,5876,5876,-42,-42,0,0,10
1526,p1501,20140519,6114,6108,6092,6094,6060,6078,6074,-30,-34,49528,3009320440,156756
1740,p1502,20140519,6214,6214,0,0,0,6214,6214,0,0,0,0,0
1938,p1503,20140519,6138,6138,0,0,0,6138,6138,0,0,0,0,2
2115,p1504,20140519,6180,6180,0,0,0,6146,6146,-34,-34,0,0,12
2271,p1505,20140519,6152,6152,6130,6192,6124,6174,6170,22,18,652,40235680,396
336,p1406,20140520,5908,5908,0,0,0,5908,5908,0,0,0,0,6
445,p1407,20140520,6022,6022,0,0,0,6022,6022,0,0,0,0,0
574,p1408,20140520,6008,6008,0,0,0,6008,6008,0,0,0,0,36
726,p1409,20140520,5952,5954,5922,5948,5898,5900,5924,-54,-30,296460,17562406840,404892
899,p1410,20140520,6018,6018,5948,5948,5948,5948,5948,-70,-70,2,118960,6
1093,p1411,20140520,5916,5916,0,0,0,5848,5848,-68,-68,0,0,4
1305,p1412,20140520,5876,5876,0,0,0,5808,5808,-68,-68,0,0,10
1527,p1501,20140520,6078,6074,6068,6086,6032,6032,6060,-42,-14,71612,4339881040,159386
1741,p1502,20140520,6214,6214,0,0,0,6190,6190,-24,-24,0,0,0
1939,p1503,20140520,6138,6138,0,0,0,6138,6138,0,0,0,0,2
2116,p1504,20140520,6146,6146,0,0,0,6130,6130,-16,-16,0,0,12
2272,p1505,20140520,6174,6170,6150,6184,6140,6144,6152,-26,-18,1240,76303880,1110
337,p1406,20140521,5908,5908,5954,5954,5672,5908,5860,0,-48,8,468840,0
446,p1407,20140521,6022,6022,0,0,0,5974,5974,-48,-48,0,0,0
575,p1408,20140521,6008,6008,0,0,0,5934,5934,-74,-74,0,0,36
727,p1409,20140521,5900,5924,5874,5904,5854,5878,5874,-46,-50,306720,18020960560,432612
900,p1410,20140521,5948,5948,5876,5876,5876,5876,5876,-72,-72,2,117520,4
1094,p1411,20140521,5848,5848,0,0,0,5778,5778,-70,-70,0,0,4
1306,p1412,20140521,5808,5808,0,0,0,5738,5738,-70,-70,0,0,10
1528,p1501,20140521,6032,6060,5990,6026,5990,6012,6004,-48,-56,75316,4522858120,171316
1742,p1502,20140521,6190,6190,0,0,0,6152,6152,-38,-38,0,0,0
1940,p1503,20140521,6138,6138,0,0,0,6138,6138,0,0,0,0,2
2117,p1504,20140521,6130,6130,0,0,0,6130,6130,0,0,0,0,12
2273,p1505,20140521,6144,6152,6130,6136,6102,6134,6116,-18,-36,434,26546200,1208
338,p1406,20140522,5908,5860,0,0,0,5860,5860,0,0,0,0,0
447,p1407,20140522,5974,5974,0,0,0,5974,5974,0,0,0,0,0
576,p1408,20140522,5934,5934,0,0,0,5934,5934,0,0,0,0,36
728,p1409,20140522,5878,5874,5918,5950,5902,5922,5922,48,48,274058,16234458840,431682
901,p1410,20140522,5876,5876,0,0,0,5876,5876,0,0,0,0,4
1095,p1411,20140522,5778,5778,0,0,0,5824,5824,46,46,0,0,4
1307,p1412,20140522,5738,5738,0,0,0,5784,5784,46,46,0,0,10
1529,p1501,20140522,6012,6004,6036,6078,6036,6072,6058,68,54,91878,5566806280,171656
1743,p1502,20140522,6152,6152,0,0,0,6152,6152,0,0,0,0,0
1941,p1503,20140522,6138,6138,0,0,0,6138,6138,0,0,0,0,2
2118,p1504,20140522,6130,6130,0,0,0,6130,6130,0,0,0,0,12
2274,p1505,20140522,6134,6116,6130,6186,6130,6186,6172,70,56,850,52477880,1376
339,p1406,20140523,5860,5860,6066,6066,6066,6066,6066,206,206,2,121320,2
448,p1407,20140523,5974,5974,0,0,0,6184,6184,210,210,0,0,0
577,p1408,20140523,5934,5934,0,0,0,5934,5934,0,0,0,0,36
729,p1409,20140523,5922,5922,5928,5980,5916,5952,5952,30,30,266346,15857304440,430492
902,p1410,20140523,5876,5876,0,0,0,5886,5886,10,10,0,0,4
1096,p1411,20140523,5824,5824,0,0,0,5852,5852,28,28,0,0,4
1308,p1412,20140523,5784,5784,6012,6012,6012,6012,6012,228,228,10,601200,2
1530,p1501,20140523,6072,6058,6082,6118,6062,6090,6092,32,34,78272,4769818720,177810
1744,p1502,20140523,6152,6152,0,0,0,6152,6152,0,0,0,0,0
1942,p1503,20140523,6138,6138,0,0,0,6138,6138,0,0,0,0,2
2119,p1504,20140523,6130,6130,6110,6110,6110,6110,6110,-20,-20,12,733200,0
2275,p1505,20140523,6186,6172,6182,6236,6132,6220,6218,48,46,822,51123320,1756
340,p1406,20140526,6066,6066,0,0,0,6066,6066,0,0,0,0,2
449,p1407,20140526,6184,6184,0,0,0,6184,6184,0,0,0,0,0
578,p1408,20140526,5934,5934,0,0,0,5934,5934,0,0,0,0,36
730,p1409,20140526,5952,5952,5916,5932,5886,5898,5908,-54,-44,208388,12312440440,439294
903,p1410,20140526,5886,5886,0,0,0,5886,5886,0,0,0,0,4
1097,p1411,20140526,5852,5852,0,0,0,5810,5810,-42,-42,0,0,4
1309,p1412,20140526,6012,6012,0,0,0,6012,6012,0,0,0,0,2
1531,p1501,20140526,6090,6092,6062,6078,6038,6044,6056,-48,-36,61252,3710097200,192788
1745,p1502,20140526,6152,6152,0,0,0,6152,6152,0,0,0,0,0
1943,p1503,20140526,6138,6138,0,0,0,6138,6138,0,0,0,0,2
2120,p1504,20140526,6110,6110,0,0,0,6110,6110,0,0,0,0,0
2276,p1505,20140526,6220,6218,6200,6232,6172,6194,6188,-24,-30,8392,519328240,7896
341,p1406,20140527,6066,6066,0,0,0,6064,6064,-2,-2,0,0,2
450,p1407,20140527,6184,6184,0,0,0,6184,6184,0,0,0,0,0
579,p1408,20140527,5934,5934,0,0,0,5934,5934,0,0,0,0,36
731,p1409,20140527,5898,5908,5900,5934,5880,5890,5904,-18,-4,306560,18102924200,435624
904,p1410,20140527,5886,5886,5920,5938,5844,5892,5896,6,10,22,1297120,4
1098,p1411,20140527,5810,5810,0,0,0,5818,5818,8,8,0,0,4
1310,p1412,20140527,6012,6012,0,0,0,6012,6012,0,0,0,0,2
1532,p1501,20140527,6044,6056,6036,6090,6032,6048,6058,-8,2,97694,5918480600,204694
1746,p1502,20140527,6152,6152,0,0,0,6152,6152,0,0,0,0,0
1944,p1503,20140527,6138,6138,0,0,0,6138,6138,0,0,0,0,2
2121,p1504,20140527,6110,6110,0,0,0,6110,6110,0,0,0,0,0
2277,p1505,20140527,6194,6188,6188,6222,6152,6180,6192,-8,4,7442,460894680,10868
342,p1406,20140528,6064,6064,6306,6306,5822,5822,6008,-242,-56,6,360560,0
451,p1407,20140528,6184,6184,0,0,0,6128,6128,-56,-56,0,0,0
580,p1408,20140528,5934,5934,5888,5932,5888,5932,5918,-2,-16,12,710240,34
732,p1409,20140528,5890,5904,5870,5976,5870,5960,5924,56,20,325534,19284923120,434168
905,p1410,20140528,5892,5896,0,0,0,5914,5914,18,18,0,0,4
1099,p1411,20140528,5818,5818,0,0,0,5836,5836,18,18,0,0,4
1311,p1412,20140528,6012,6012,0,0,0,6012,6012,0,0,0,0,2
1533,p1501,20140528,6048,6058,6036,6130,6026,6116,6072,58,14,141252,8579618400,244128
1747,p1502,20140528,6152,6152,0,0,0,6152,6152,0,0,0,0,0
1945,p1503,20140528,6138,6138,0,0,0,6138,6138,0,0,0,0,2
2122,p1504,20140528,6110,6110,0,0,0,6110,6110,0,0,0,0,0
2278,p1505,20140528,6180,6192,6166,6264,6164,6252,6210,60,18,5562,345467200,12350
343,p1406,20140529,5822,6008,0,0,0,6008,6008,0,0,0,0,0
452,p1407,20140529,6128,6128,0,0,0,6128,6128,0,0,0,0,0
581,p1408,20140529,5932,5918,0,0,0,5918,5918,0,0,0,0,34
733,p1409,20140529,5960,5924,5928,5952,5910,5912,5930,-12,6,209180,12405557120,415706
906,p1410,20140529,5914,5914,0,0,0,5918,5918,4,4,0,0,4
1100,p1411,20140529,5836,5836,0,0,0,5840,5840,4,4,0,0,4
1312,p1412,20140529,6012,6012,0,0,0,6012,6012,0,0,0,0,2
1534,p1501,20140529,6116,6072,6082,6102,6054,6058,6076,-14,4,121760,7398929240,250238
1748,p1502,20140529,6152,6152,0,0,0,6152,6152,0,0,0,0,0
1946,p1503,20140529,6138,6138,0,0,0,6138,6138,0,0,0,0,2
2123,p1504,20140529,6110,6110,0,0,0,6114,6114,4,4,0,0,0
2279,p1505,20140529,6252,6210,6228,6240,6194,6198,6212,-12,2,1846,114690520,11796
344,p1406,20140530,6008,6008,0,0,0,6008,6008,0,0,0,0,0
453,p1407,20140530,6128,6128,0,0,0,6128,6128,0,0,0,0,0
582,p1408,20140530,5918,5918,0,0,0,5918,5918,0,0,0,0,34
734,p1409,20140530,5912,5930,5896,5900,5862,5882,5880,-48,-50,235256,13836146560,411320
907,p1410,20140530,5918,5918,0,0,0,5870,5870,-48,-48,0,0,4
1101,p1411,20140530,5840,5840,0,0,0,5792,5792,-48,-48,0,0,4
1313,p1412,20140530,6012,6012,0,0,0,6012,6012,0,0,0,0,2
1535,p1501,20140530,6058,6076,6026,6042,5988,6006,6012,-70,-64,144650,8698394240,271232
1749,p1502,20140530,6152,6152,5976,6136,5956,6118,6048,-34,-104,12,725760,2
1947,p1503,20140530,6138,6138,0,0,0,6138,6138,0,0,0,0,2
2124,p1504,20140530,6114,6114,0,0,0,6114,6114,0,0,0,0,0
2280,p1505,20140530,6198,6212,6200,6200,6142,6156,6162,-56,-50,4438,273505320,10204
345,p1406,20140603,6008,6008,0,0,0,6008,6008,0,0,0,0,0
454,p1407,20140603,6128,6128,0,0,0,6128,6128,0,0,0,0,0
583,p1408,20140603,5918,5918,0,0,0,5898,5898,-20,-20,0,0,34
735,p1409,20140603,5882,5880,5828,5838,5782,5820,5816,-60,-64,165284,9614418920,419612
908,p1410,20140603,5870,5870,0,0,0,5808,5808,-62,-62,0,0,4
1102,p1411,20140603,5792,5792,0,0,0,5730,5730,-62,-62,0,0,4
1314,p1412,20140603,6012,6012,0,0,0,6006,6006,-6,-6,0,0,2
1536,p1501,20140603,6006,6012,5940,5960,5914,5940,5940,-72,-72,82046,4874615200,278356
1750,p1502,20140603,6118,6048,5952,5952,5952,5952,5952,-96,-96,2,119040,0
1948,p1503,20140603,6138,6138,0,0,0,6076,6076,-62,-62,0,0,2
2125,p1504,20140603,6114,6114,0,0,0,6114,6114,0,0,0,0,0
2281,p1505,20140603,6156,6162,6112,6126,6074,6118,6102,-44,-60,3566,217600440,10518
346,p1406,20140604,6008,6008,0,0,0,6008,6008,0,0,0,0,0
455,p1407,20140604,6128,6128,0,0,0,6128,6128,0,0,0,0,0
584,p1408,20140604,5898,5898,0,0,0,5892,5892,-6,-6,0,0,34
736,p1409,20140604,5820,5816,5800,5838,5794,5814,5814,-2,-2,157658,9169141440,416664
909,p1410,20140604,5808,5808,0,0,0,5808,5808,0,0,0,0,4
1103,p1411,20140604,5730,5730,0,0,0,5730,5730,0,0,0,0,4
1315,p1412,20140604,6006,6006,0,0,0,5994,5994,-12,-12,0,0,2
1537,p1501,20140604,5940,5940,5920,5956,5912,5932,5936,-8,-4,108776,6458740680,271336
1751,p1502,20140604,5952,5952,0,0,0,5952,5952,0,0,0,0,0
1949,p1503,20140604,6076,6076,0,0,0,6076,6076,0,0,0,0,2
2126,p1504,20140604,6114,6114,0,0,0,6114,6114,0,0,0,0,0
2282,p1505,20140604,6118,6102,6100,6130,6088,6108,6112,6,10,2362,144369480,10500
347,p1406,20140605,6008,6008,0,0,0,6008,6008,0,0,0,0,0
456,p1407,20140605,6128,6128,5884,5884,5884,5884,5884,-244,-244,2,117680,2
585,p1408,20140605,5892,5892,0,0,0,5892,5892,0,0,0,0,34
737,p1409,20140605,5814,5814,5876,5908,5844,5844,5876,30,62,261946,15396352040,420994
910,p1410,20140605,5808,5808,0,0,0,5808,5808,0,0,0,0,4
1104,p1411,20140605,5730,5730,0,0,0,5790,5790,60,60,0,0,4
1316,p1412,20140605,5994,5994,0,0,0,5994,5994,0,0,0,0,2
1538,p1501,20140605,5932,5936,6006,6014,5962,5962,5992,26,56,147398,8832469840,277818
1752,p1502,20140605,5952,5952,0,0,0,5952,5952,0,0,0,0,0
1950,p1503,20140605,6076,6076,0,0,0,6076,6076,0,0,0,0,2
2127,p1504,20140605,6114,6114,0,0,0,6170,6170,56,56,0,0,0
2283,p1505,20140605,6108,6112,6166,6192,6158,6158,6170,46,58,5522,340786280,11656
348,p1406,20140606,6008,6008,0,0,0,6008,6008,0,0,0,0,0
457,p1407,20140606,5884,5884,0,0,0,5884,5884,0,0,0,0,2
586,p1408,20140606,5892,5892,0,0,0,5892,5892,0,0,0,0,34
738,p1409,20140606,5844,5876,5826,5850,5804,5836,5824,-40,-52,157556,9176499480,417148
911,p1410,20140606,5808,5808,0,0,0,5808,5808,0,0,0,0,4
1105,p1411,20140606,5790,5790,0,0,0,5740,5740,-50,-50,0,0,4
1317,p1412,20140606,5994,5994,0,0,0,5994,5994,0,0,0,0,2
1539,p1501,20140606,5962,5992,5958,5966,5918,5950,5938,-42,-54,106418,6321228640,283092
1753,p1502,20140606,5952,5952,0,0,0,5952,5952,0,0,0,0,0
1951,p1503,20140606,6076,6076,0,0,0,6076,6076,0,0,0,0,2
2128,p1504,20140606,6170,6170,6178,6178,6178,6178,6178,8,8,2,123560,2
2284,p1505,20140606,6158,6170,6152,6154,6124,6152,6142,-18,-28,3692,226798000,12190
349,p1406,20140609,6008,6008,0,0,0,6008,6008,0,0,0,0,0
458,p1407,20140609,5884,5884,0,0,0,5884,5884,0,0,0,0,2
587,p1408,20140609,5892,5892,0,0,0,5892,5892,0,0,0,0,34
739,p1409,20140609,5836,5824,5844,5872,5832,5858,5856,34,32,118450,6936880720,408578
912,p1410,20140609,5808,5808,0,0,0,5808,5808,0,0,0,0,4
1106,p1411,20140609,5740,5740,0,0,0,5770,5770,30,30,0,0,4
1318,p1412,20140609,5994,5994,0,0,0,5994,5994,0,0,0,0,2
1540,p1501,20140609,5950,5938,5960,5982,5950,5962,5966,24,28,75046,4478671360,282946
1754,p1502,20140609,5952,5952,0,0,0,5952,5952,0,0,0,0,0
1952,p1503,20140609,6076,6076,0,0,0,6076,6076,0,0,0,0,2
2129,p1504,20140609,6178,6178,0,0,0,6178,6178,0,0,0,0,2
2285,p1505,20140609,6152,6142,6168,6196,6164,6166,6176,24,34,3998,246972240,14032
350,p1406,20140610,6008,6008,0,0,0,6008,6008,0,0,0,0,0
459,p1407,20140610,5884,5884,0,0,0,5884,5884,0,0,0,0,2
588,p1408,20140610,5892,5892,0,0,0,5892,5892,0,0,0,0,34
740,p1409,20140610,5858,5856,5858,5884,5830,5834,5852,-22,-4,176416,10325581400,390818
913,p1410,20140610,5808,5808,0,0,0,5808,5808,0,0,0,0,4
1107,p1411,20140610,5770,5770,0,0,0,5768,5768,-2,-2,0,0,4
1319,p1412,20140610,5994,5994,0,0,0,5994,5994,0,0,0,0,2
1541,p1501,20140610,5962,5966,5976,5984,5910,5910,5940,-56,-26,116984,6951096960,300794
1755,p1502,20140610,5952,5952,0,0,0,5952,5952,0,0,0,0,0
1953,p1503,20140610,6076,6076,0,0,0,6076,6076,0,0,0,0,2
2130,p1504,20140610,6178,6178,6088,6088,6088,6088,6088,-90,-90,2,121760,4
2286,p1505,20140610,6166,6176,6184,6188,6120,6124,6138,-52,-38,8928,548002960,15596
351,p1406,20140611,6008,6008,0,0,0,6008,6008,0,0,0,0,0
460,p1407,20140611,5884,5884,5652,5652,5650,5650,5650,-234,-234,4,226040,2
589,p1408,20140611,5892,5892,5930,5930,5806,5806,5832,-86,-60,18,1049880,28
741,p1409,20140611,5834,5852,5830,5848,5770,5780,5798,-72,-54,249138,14447390040,360230
914,p1410,20140611,5808,5808,0,0,0,5808,5808,0,0,0,0,4
1108,p1411,20140611,5768,5768,0,0,0,5716,5716,-52,-52,0,0,4
1320,p1412,20140611,5994,5994,0,0,0,5940,5940,-54,-54,0,0,2
1542,p1501,20140611,5910,5940,5910,5928,5858,5866,5886,-74,-54,130068,7657067960,300948
1756,p1502,20140611,5952,5952,0,0,0,5952,5952,0,0,0,0,0
1954,p1503,20140611,6076,6076,0,0,0,6022,6022,-54,-54,0,0,2
2131,p1504,20140611,6088,6088,0,0,0,6088,6088,0,0,0,0,4
2287,p1505,20140611,6124,6138,6102,6134,6070,6074,6092,-64,-46,5754,350621200,17032
352,p1406,20140612,6008,6008,0,0,0,6008,6008,0,0,0,0,0
461,p1407,20140612,5650,5650,5800,5800,5800,5800,5800,150,150,2,116000,0
590,p1408,20140612,5806,5832,0,0,0,5832,5832,0,0,0,0,28
742,p1409,20140612,5780,5798,5750,5776,5734,5758,5758,-40,-40,170110,9795592400,354694
915,p1410,20140612,5808,5808,0,0,0,5808,5808,0,0,0,0,4
1109,p1411,20140612,5716,5716,0,0,0,5678,5678,-38,-38,0,0,4
1321,p1412,20140612,5940,5940,0,0,0,5926,5926,-14,-14,0,0,2
1543,p1501,20140612,5866,5886,5854,5870,5828,5852,5852,-34,-34,136616,7996341000,314180
1757,p1502,20140612,5952,5952,0,0,0,5952,5952,0,0,0,0,0
1955,p1503,20140612,6022,6022,0,0,0,6022,6022,0,0,0,0,2
2132,p1504,20140612,6088,6088,0,0,0,6054,6054,-34,-34,0,0,4
2288,p1505,20140612,6074,6092,6060,6070,6040,6050,6054,-42,-38,6786,410881520,17888
353,p1406,20140613,6008,6008,0,0,0,6008,6008,0,0,0,0,0
462,p1407,20140613,5800,5800,0,0,0,5800,5800,0,0,0,0,0
591,p1408,20140613,5832,5832,5800,5904,5800,5832,5854,0,22,16,936720,24
743,p1409,20140613,5758,5758,5788,5826,5780,5816,5804,58,46,213400,12388792360,336680
916,p1410,20140613,5808,5808,0,0,0,5808,5808,0,0,0,0,4
1110,p1411,20140613,5678,5678,0,0,0,5722,5722,44,44,0,0,4
1322,p1412,20140613,5926,5926,0,0,0,5926,5926,0,0,0,0,2
1544,p1501,20140613,5852,5852,5878,5906,5862,5898,5888,46,36,179352,10563386760,346868
1758,p1502,20140613,5952,5952,0,0,0,5952,5952,0,0,0,0,0
1956,p1503,20140613,6022,6022,0,0,0,6022,6022,0,0,0,0,2
2133,p1504,20140613,6054,6054,5940,5940,5940,5940,5940,-114,-114,2,118800,2
2289,p1505,20140613,6050,6054,6064,6092,6056,6080,6078,26,24,4900,297823200,19068
354,p1406,20140616,6008,6008,0,0,0,6008,6008,0,0,0,0,0
463,p1407,20140616,5800,5800,0,0,0,5800,5800,0,0,0,0,0
592,p1408,20140616,5832,5854,5848,5848,5838,5844,5842,-10,-12,12,701120,18
744,p1409,20140616,5816,5804,5858,5892,5800,5802,5840,-2,36,200734,11724469120,311088
917,p1410,20140616,5808,5808,0,0,0,5808,5808,0,0,0,0,4
1111,p1411,20140616,5722,5722,0,0,0,5774,5774,52,52,0,0,4
1323,p1412,20140616,5926,5926,0,0,0,5926,5926,0,0,0,0,2
1545,p1501,20140616,5898,5888,5944,5966,5884,5888,5918,0,30,168192,9956808360,356334
1759,p1502,20140616,5952,5952,0,0,0,5952,5952,0,0,0,0,0
1957,p1503,20140616,6022,6022,0,0,0,6022,6022,0,0,0,0,2
2134,p1504,20140616,5940,5940,0,0,0,5956,5956,16,16,0,0,2
2290,p1505,20140616,6080,6078,6114,6150,6062,6070,6100,-8,22,14328,874088320,21666
464,p1407,20140617,5800,5800,0,0,0,5800,5800,0,0,0,0,0
593,p1408,20140617,5844,5842,5698,5838,5698,5838,5780,-4,-62,6,346880,18
745,p1409,20140617,5802,5840,5802,5812,5748,5796,5780,-44,-60,276502,15984521280,320326
918,p1410,20140617,5808,5808,0,0,0,5808,5808,0,0,0,0,4
1112,p1411,20140617,5774,5774,0,0,0,5774,5774,0,0,0,0,4
1324,p1412,20140617,5926,5926,0,0,0,5926,5926,0,0,0,0,2
1546,p1501,20140617,5888,5918,5896,5898,5832,5880,5866,-38,-52,294034,17251673080,377278
1760,p1502,20140617,5952,5952,0,0,0,5952,5952,0,0,0,0,0
1958,p1503,20140617,6022,6022,0,0,0,6022,6022,0,0,0,0,2
2135,p1504,20140617,5956,5956,0,0,0,5956,5956,0,0,0,0,2
2291,p1505,20140617,6070,6100,6082,6084,6026,6062,6050,-38,-50,6072,367449880,20866
2427,p1506,20140617,6076,6076,0,0,0,6028,6028,-48,-48,0,0,0
465,p1407,20140618,5800,5800,0,0,0,5800,5800,0,0,0,0,0
594,p1408,20140618,5838,5780,0,0,0,5780,5780,0,0,0,0,18
746,p1409,20140618,5796,5780,5790,5830,5772,5792,5800,12,20,194656,11290959840,293926
919,p1410,20140618,5808,5808,0,0,0,5808,5808,0,0,0,0,4
1113,p1411,20140618,5774,5774,0,0,0,5792,5792,18,18,0,0,4
1325,p1412,20140618,5926,5926,0,0,0,5926,5926,0,0,0,0,2
1547,p1501,20140618,5880,5866,5878,5940,5858,5900,5902,34,36,365554,21577429520,416150
1761,p1502,20140618,5952,5952,0,0,0,5952,5952,0,0,0,0,0
1959,p1503,20140618,6022,6022,0,0,0,6022,6022,0,0,0,0,2
2136,p1504,20140618,5956,5956,0,0,0,5956,5956,0,0,0,0,2
2292,p1505,20140618,6062,6050,6050,6114,6044,6080,6078,30,28,10496,637985240,24378
2428,p1506,20140618,6028,6028,0,0,0,6054,6054,26,26,0,0,0
466,p1407,20140619,5800,5800,0,0,0,5800,5800,0,0,0,0,0
595,p1408,20140619,5780,5780,0,0,0,5780,5780,0,0,0,0,18
747,p1409,20140619,5792,5800,5828,5828,5794,5796,5802,-4,2,136810,7940215920,269326
920,p1410,20140619,5808,5808,5824,5824,5774,5774,5798,-34,-10,4,231960,4
1114,p1411,20140619,5792,5792,0,0,0,5784,5784,-8,-8,0,0,4
1326,p1412,20140619,5926,5926,0,0,0,5926,5926,0,0,0,0,2
1548,p1501,20140619,5900,5902,5930,5942,5894,5900,5918,-2,16,254450,15061748200,405048
1762,p1502,20140619,5952,5952,0,0,0,5952,5952,0,0,0,0,0
1960,p1503,20140619,6022,6022,0,0,0,6022,6022,0,0,0,0,2
2137,p1504,20140619,5956,5956,0,0,0,5956,5956,0,0,0,0,2
2293,p1505,20140619,6080,6078,6116,6116,6074,6080,6094,2,16,15550,947887440,26686
2429,p1506,20140619,6054,6054,0,0,0,6068,6068,14,14,0,0,0
467,p1407,20140620,5800,5800,0,0,0,5800,5800,0,0,0,0,0
596,p1408,20140620,5780,5780,5786,5900,5786,5900,5842,120,62,4,233720,16
748,p1409,20140620,5796,5802,5804,5848,5792,5836,5822,34,20,110682,6444735440,249084
921,p1410,20140620,5774,5798,0,0,0,5798,5798,0,0,0,0,4
1115,p1411,20140620,5784,5784,0,0,0,5802,5802,18,18,0,0,4
1327,p1412,20140620,5926,5926,0,0,0,5926,5926,0,0,0,0,2
1549,p1501,20140620,5900,5918,5910,5954,5898,5938,5930,20,12,221134,13115589720,406206
1763,p1502,20140620,5952,5952,0,0,0,5964,5964,12,12,0,0,0
1961,p1503,20140620,6022,6022,0,0,0,6022,6022,0,0,0,0,2
2138,p1504,20140620,5956,5956,0,0,0,5988,5988,32,32,0,0,2
2294,p1505,20140620,6080,6094,6112,6126,6084,6110,6106,16,12,13204,806481080,30638
2430,p1506,20140620,6068,6068,0,0,0,6068,6068,0,0,0,0,0
468,p1407,20140623,5800,5800,0,0,0,5800,5800,0,0,0,0,0
597,p1408,20140623,5900,5842,5810,5910,5810,5910,5894,68,52,14,825400,2
749,p1409,20140623,5836,5822,5836,5936,5822,5932,5894,110,72,207888,12253001480,232650
922,p1410,20140623,5798,5798,0,0,0,5798,5798,0,0,0,0,4
1116,p1411,20140623,5802,5802,0,0,0,5872,5872,70,70,0,0,4
1328,p1412,20140623,5926,5926,0,0,0,5926,5926,0,0,0,0,2
1550,p1501,20140623,5938,5930,5938,6058,5936,6034,6010,104,80,427804,25718767520,413576
1764,p1502,20140623,5964,5964,6046,6098,6046,6098,6072,134,108,8,485760,8
1962,p1503,20140623,6022,6022,6026,6172,6026,6170,6056,148,34,58,3513120,56
2139,p1504,20140623,5988,5988,0,0,0,6042,6042,54,54,0,0,2
2295,p1505,20140623,6110,6106,6102,6230,6102,6210,6178,104,72,23568,1456034520,38788
2431,p1506,20140623,6068,6068,0,0,0,6118,6118,50,50,0,0,0
469,p1407,20140624,5800,5800,0,0,0,5800,5800,0,0,0,0,0
598,p1408,20140624,5910,5894,0,0,0,5894,5894,0,0,0,0,2
750,p1409,20140624,5932,5894,5916,5942,5892,5904,5916,10,22,130664,7730799960,219082
923,p1410,20140624,5798,5798,5960,5960,5932,5932,5946,134,148,4,237840,4
1117,p1411,20140624,5872,5872,0,0,0,6020,6020,148,148,0,0,4
1329,p1412,20140624,5926,5926,0,0,0,5926,5926,0,0,0,0,2
1551,p1501,20140624,6034,6010,6032,6068,6008,6028,6036,18,26,375416,22662517880,403646
1765,p1502,20140624,6098,6072,0,0,0,6072,6072,0,0,0,0,8
1963,p1503,20140624,6170,6056,0,0,0,6056,6056,0,0,0,0,56
2140,p1504,20140624,6042,6042,0,0,0,6076,6076,34,34,0,0,2
2296,p1505,20140624,6210,6178,6210,6246,6188,6208,6212,30,34,21102,1311220160,42188
2432,p1506,20140624,6118,6118,0,0,0,6126,6126,8,8,0,0,0
470,p1407,20140625,5800,5800,0,0,0,5800,5800,0,0,0,0,0
599,p1408,20140625,5894,5894,6076,6076,5890,5890,5982,-4,88,4,239320,0
751,p1409,20140625,5904,5916,5940,5946,5886,5898,5918,-18,2,119156,7053336320,210258
924,p1410,20140625,5932,5946,0,0,0,5946,5946,0,0,0,0,4
1118,p1411,20140625,6020,6020,0,0,0,6022,6022,2,2,0,0,4
1330,p1412,20140625,5926,5926,0,0,0,5926,5926,0,0,0,0,2
1552,p1501,20140625,6028,6036,6064,6118,6032,6056,6076,20,40,619422,37639967720,426054
1766,p1502,20140625,6072,6072,0,0,0,6084,6084,12,12,0,0,8
1964,p1503,20140625,6056,6056,0,0,0,6150,6150,94,94,0,0,56
2141,p1504,20140625,6076,6076,6312,6312,6178,6246,6248,170,172,20,1249800,4
2297,p1505,20140625,6208,6212,6238,6326,6230,6264,6276,52,64,55550,3486371240,47284
2433,p1506,20140625,6126,6126,0,0,0,6180,6180,54,54,0,0,0
471,p1407,20140626,5800,5800,0,0,0,5800,5800,0,0,0,0,0
600,p1408,20140626,5890,5982,0,0,0,5982,5982,0,0,0,0,0
752,p1409,20140626,5898,5918,5906,5906,5870,5898,5890,-20,-28,57528,3389096720,205030
925,p1410,20140626,5946,5946,5858,5858,5858,5858,5858,-88,-88,2,117160,2
1119,p1411,20140626,6022,6022,0,0,0,5934,5934,-88,-88,0,0,4
1331,p1412,20140626,5926,5926,5944,6104,5944,6104,6024,178,98,4,240960,4
1553,p1501,20140626,6056,6076,6052,6076,6034,6058,6056,-18,-20,254678,15424413680,446732
1767,p1502,20140626,6084,6084,0,0,0,6086,6086,2,2,0,0,8
1965,p1503,20140626,6150,6150,0,0,0,6150,6150,0,0,0,0,56
2142,p1504,20140626,6246,6248,0,0,0,6248,6248,0,0,0,0,4
2298,p1505,20140626,6264,6276,6260,6280,6248,6260,6264,-16,-12,14414,903075960,49038
2434,p1506,20140626,6180,6180,0,0,0,6186,6186,6,6,0,0,0
472,p1407,20140627,5800,5800,0,0,0,5800,5800,0,0,0,0,0
601,p1408,20140627,5982,5982,0,0,0,5982,5982,0,0,0,0,0
753,p1409,20140627,5898,5890,5880,5896,5856,5860,5872,-30,-18,55052,3232762640,196086
926,p1410,20140627,5858,5858,0,0,0,5858,5858,0,0,0,0,2
1120,p1411,20140627,5934,5934,0,0,0,5916,5916,-18,-18,0,0,4
1332,p1412,20140627,6104,6024,0,0,0,6024,6024,0,0,0,0,4
1554,p1501,20140627,6058,6056,6040,6048,5988,5994,6014,-62,-42,332588,20004157720,428846
1768,p1502,20140627,6086,6086,6090,6090,6090,6090,6090,4,4,4,243600,6
1966,p1503,20140627,6150,6150,0,0,0,6150,6150,0,0,0,0,56
2143,p1504,20140627,6248,6248,0,0,0,6230,6230,-18,-18,0,0,4
2299,p1505,20140627,6260,6264,6242,6252,6190,6198,6220,-66,-44,22284,1386160000,48390
2435,p1506,20140627,6186,6186,0,0,0,6186,6186,0,0,0,0,0
473,p1407,20140630,5800,5800,0,0,0,5800,5800,0,0,0,0,0
602,p1408,20140630,5982,5982,0,0,0,5982,5982,0,0,0,0,0
754,p1409,20140630,5860,5872,5854,5854,5802,5812,5814,-60,-58,55556,3230221240,185766
927,p1410,20140630,5858,5858,0,0,0,5858,5858,0,0,0,0,2
1121,p1411,20140630,5916,5916,0,0,0,5916,5916,0,0,0,0,4
1333,p1412,20140630,6024,6024,0,0,0,6024,6024,0,0,0,0,4
1555,p1501,20140630,5994,6014,5968,5970,5926,5930,5946,-84,-68,219662,13064347200,427054
1769,p1502,20140630,6090,6090,0,0,0,6068,6068,-22,-22,0,0,6
1967,p1503,20140630,6150,6150,6100,6100,6034,6034,6068,-116,-82,16,970960,56
2144,p1504,20140630,6230,6230,0,0,0,6170,6170,-60,-60,0,0,4
2300,p1505,20140630,6198,6220,6172,6172,6130,6136,6152,-84,-68,15980,983363240,48836
2436,p1506,20140630,6186,6186,0,0,0,6186,6186,0,0,0,0,0
474,p1407,20140701,5800,5800,0,0,0,5800,5800,0,0,0,0,0
603,p1408,20140701,5982,5982,0,0,0,5982,5982,0,0,0,0,0
755,p1409,20140701,5812,5814,5700,5730,5624,5690,5686,-124,-128,82736,4705684960,169790
928,p1410,20140701,5858,5858,0,0,0,5730,5730,-128,-128,0,0,2
1122,p1411,20140701,5916,5916,0,0,0,5786,5786,-130,-130,0,0,4
1334,p1412,20140701,6024,6024,5826,5826,5826,5826,5826,-198,-198,16,932160,20
1556,p1501,20140701,5930,5946,5796,5844,5732,5786,5800,-160,-146,410288,23800794840,442266
1770,p1502,20140701,6068,6068,0,0,0,5934,5934,-134,-134,0,0,6
1968,p1503,20140701,6034,6068,6000,6000,5906,5934,5974,-134,-94,50,2987880,32
2145,p1504,20140701,6170,6170,0,0,0,6056,6056,-114,-114,0,0,4
2301,p1505,20140701,6136,6152,5996,6038,5940,5998,5996,-154,-156,32054,1922561800,42776
2437,p1506,20140701,6186,6186,0,0,0,6166,6166,-20,-20,0,0,0
475,p1407,20140702,5800,5800,0,0,0,5800,5800,0,0,0,0,0
604,p1408,20140702,5982,5982,0,0,0,5982,5982,0,0,0,0,0
756,p1409,20140702,5690,5686,5780,5780,5702,5716,5726,30,40,52472,3004554320,164284
929,p1410,20140702,5730,5730,0,0,0,5730,5730,0,0,0,0,2
1123,p1411,20140702,5786,5786,0,0,0,5786,5786,0,0,0,0,4
1335,p1412,20140702,5826,5826,0,0,0,5826,5826,0,0,0,0,20
1557,p1501,20140702,5786,5800,5810,5840,5792,5820,5818,20,18,221272,12877585720,450340
1771,p1502,20140702,5934,5934,0,0,0,5934,5934,0,0,0,0,6
1969,p1503,20140702,5934,5974,0,0,0,5974,5974,0,0,0,0,32
2146,p1504,20140702,6056,6056,0,0,0,6056,6056,0,0,0,0,4
2302,p1505,20140702,5998,5996,6022,6044,5996,6028,6022,32,26,17862,1075806680,45354
2438,p1506,20140702,6166,6166,0,0,0,6166,6166,0,0,0,0,0
476,p1407,20140703,5800,5800,0,0,0,5800,5800,0,0,0,0,0
605,p1408,20140703,5982,5982,0,0,0,5982,5982,0,0,0,0,0
757,p1409,20140703,5716,5726,5710,5714,5688,5694,5698,-32,-28,35686,2034023320,162472
930,p1410,20140703,5730,5730,0,0,0,5730,5730,0,0,0,0,2
1124,p1411,20140703,5786,5786,0,0,0,5758,5758,-28,-28,0,0,4
1336,p1412,20140703,5826,5826,0,0,0,5826,5826,0,0,0,0,20
1558,p1501,20140703,5820,5818,5800,5820,5784,5788,5802,-30,-16,231956,13462375720,484598
1772,p1502,20140703,5934,5934,0,0,0,5934,5934,0,0,0,0,6
1970,p1503,20140703,5974,5974,5974,5974,5974,5974,5974,0,0,10,597400,22
2147,p1504,20140703,6056,6056,0,0,0,6028,6028,-28,-28,0,0,4
2303,p1505,20140703,6028,6022,6000,6028,5994,5996,6012,-26,-10,18096,1087996760,43834
2439,p1506,20140703,6166,6166,0,0,0,6166,6166,0,0,0,0,0
477,p1407,20140704,5800,5800,0,0,0,5800,5800,0,0,0,0,0
606,p1408,20140704,5982,5982,0,0,0,5982,5982,0,0,0,0,0
758,p1409,20140704,5694,5698,5706,5708,5682,5688,5692,-10,-6,27392,1559262000,155382
931,p1410,20140704,5730,5730,0,0,0,5724,5724,-6,-6,0,0,2
1125,p1411,20140704,5758,5758,0,0,0,5752,5752,-6,-6,0,0,4
1337,p1412,20140704,5826,5826,0,0,0,5826,5826,0,0,0,0,20
1559,p1501,20140704,5788,5802,5792,5814,5782,5792,5794,-10,-8,203766,11808739440,487766
1773,p1502,20140704,5934,5934,0,0,0,5934,5934,0,0,0,0,6
1971,p1503,20140704,5974,5974,5960,5960,5900,5932,5932,-42,-42,8,474560,24
2148,p1504,20140704,6028,6028,5950,6018,5950,6018,5984,-10,-44,4,239360,4
2304,p1505,20140704,5996,6012,6000,6016,5984,5992,5996,-20,-16,20048,1202152800,50720
2440,p1506,20140704,6166,6166,0,0,0,6164,6164,-2,-2,0,0,0
478,p1407,20140707,5800,5800,0,0,0,5800,5800,0,0,0,0,0
607,p1408,20140707,5982,5982,0,0,0,5982,5982,0,0,0,0,0
759,p1409,20140707,5688,5692,5690,5730,5664,5692,5698,0,6,54176,3087684200,143960
932,p1410,20140707,5724,5724,0,0,0,5724,5724,0,0,0,0,2
1126,p1411,20140707,5752,5752,0,0,0,5758,5758,6,6,0,0,4
1338,p1412,20140707,5826,5826,5854,5854,5786,5786,5826,-40,0,32,1864880,2
1560,p1501,20140707,5792,5794,5780,5830,5766,5804,5798,10,4,496900,28819212080,457252
1774,p1502,20140707,5934,5934,5830,5926,5826,5826,5844,-108,-90,12,701400,6
1972,p1503,20140707,5932,5932,0,0,0,5932,5932,0,0,0,0,24
2149,p1504,20140707,6018,5984,0,0,0,5984,5984,0,0,0,0,4
2305,p1505,20140707,5992,5996,5976,6026,5970,6000,6000,4,4,21586,1295410760,52226
2441,p1506,20140707,6164,6164,0,0,0,6038,6038,-126,-126,0,0,0
479,p1407,20140708,5800,5800,0,0,0,5800,5800,0,0,0,0,0
608,p1408,20140708,5982,5982,0,0,0,5982,5982,0,0,0,0,0
760,p1409,20140708,5692,5698,5700,5728,5674,5688,5702,-10,4,42982,2451459080,140054
933,p1410,20140708,5724,5724,0,0,0,5724,5724,0,0,0,0,2
1127,p1411,20140708,5758,5758,0,0,0,5762,5762,4,4,0,0,4
1339,p1412,20140708,5786,5826,0,0,0,5826,5826,0,0,0,0,2
1561,p1501,20140708,5804,5798,5812,5848,5788,5808,5820,10,22,474912,27643162360,466242
1775,p1502,20140708,5826,5844,0,0,0,5862,5862,18,18,0,0,6
1973,p1503,20140708,5932,5932,6026,6026,5948,5948,5986,16,54,4,239480,24
2150,p1504,20140708,5984,5984,0,0,0,5984,5984,0,0,0,0,4
2306,p1505,20140708,6000,6000,6012,6036,5986,6000,6010,0,10,29988,1802281520,53802
2442,p1506,20140708,6038,6038,0,0,0,6038,6038,0,0,0,0,0
480,p1407,20140709,5800,5800,0,0,0,5800,5800,0,0,0,0,0
609,p1408,20140709,5982,5982,0,0,0,5982,5982,0,0,0,0,0
761,p1409,20140709,5688,5702,5662,5682,5650,5668,5666,-34,-36,59800,3389452120,133278
934,p1410,20140709,5724,5724,0,0,0,5724,5724,0,0,0,0,2
1128,p1411,20140709,5762,5762,0,0,0,5726,5726,-36,-36,0,0,4
1340,p1412,20140709,5826,5826,0,0,0,5790,5790,-36,-36,0,0,2
1562,p1501,20140709,5808,5820,5788,5800,5762,5786,5784,-34,-36,497622,28791273680,440082
1776,p1502,20140709,5862,5862,5870,5870,5850,5850,5860,-12,-2,4,234400,6
1974,p1503,20140709,5948,5986,0,0,0,5970,5970,-16,-16,0,0,24
2151,p1504,20140709,5984,5984,5954,5954,5954,5954,5954,-30,-30,2,119080,4
2307,p1505,20140709,6000,6010,5966,5986,5952,5968,5970,-42,-40,21026,1255526160,51374
2443,p1506,20140709,6038,6038,0,0,0,6038,6038,0,0,0,0,0
481,p1407,20140710,5800,5800,0,0,0,5800,5800,0,0,0,0,0
610,p1408,20140710,5982,5982,0,0,0,5982,5982,0,0,0,0,0
762,p1409,20140710,5668,5666,5674,5886,5636,5746,5724,80,58,118432,6780239280,117450
935,p1410,20140710,5724,5724,0,0,0,5724,5724,0,0,0,0,2
1129,p1411,20140710,5726,5726,0,0,0,5784,5784,58,58,0,0,4
1341,p1412,20140710,5790,5790,5778,5926,5776,5878,5844,88,54,16,935080,4
1563,p1501,20140710,5786,5784,5786,5994,5732,5858,5836,74,52,1112206,64919894920,461880
1777,p1502,20140710,5850,5860,5934,6006,5810,5984,5910,124,50,4332,256074200,6
1975,p1503,20140710,5970,5970,5942,6066,5938,5978,5980,8,10,8,478480,20
2152,p1504,20140710,5954,5954,6192,6192,6008,6008,6046,54,92,56,3386840,8
2308,p1505,20140710,5968,5970,5968,6178,5926,6044,6014,74,44,47096,2832781520,53074
2444,p1506,20140710,6038,6038,0,0,0,6038,6038,0,0,0,0,0
482,p1407,20140711,5800,5800,0,0,0,5800,5800,0,0,0,0,0
611,p1408,20140711,5982,5982,0,0,0,5982,5982,0,0,0,0,0
763,p1409,20140711,5746,5724,5760,5760,5664,5678,5702,-46,-22,75982,4332790240,118340
936,p1410,20140711,5724,5724,5736,5814,5678,5764,5740,40,16,10,574120,0
1130,p1411,20140711,5784,5784,0,0,0,5800,5800,16,16,0,0,4
1342,p1412,20140711,5878,5844,5770,5860,5770,5852,5816,8,-28,86,5002320,4
1564,p1501,20140711,5858,5836,5858,5862,5794,5806,5828,-30,-8,486764,28376929320,424594
1778,p1502,20140711,5984,5910,5902,5942,5902,5932,5926,22,16,18,1067000,8
1976,p1503,20140711,5978,5980,0,0,0,5976,5976,-4,-4,0,0,20
2153,p1504,20140711,6008,6046,5966,5966,5966,5966,5966,-80,-80,2,119320,8
2309,p1505,20140711,6044,6014,6040,6044,5970,5980,6002,-34,-12,28980,1739483320,55896
2445,p1506,20140711,6038,6038,0,0,0,6038,6038,0,0,0,0,0
483,p1407,20140714,5800,5800,0,0,0,5800,5800,0,0,0,0,0
612,p1408,20140714,5982,5982,0,0,0,5982,5982,0,0,0,0,0
764,p1409,20140714,5678,5702,5632,5648,5550,5604,5592,-98,-110,57660,3225390880,113406
937,p1410,20140714,5764,5740,0,0,0,5704,5704,-36,-36,0,0,0
1131,p1411,20140714,5800,5800,0,0,0,5690,5690,-110,-110,0,0,4
1343,p1412,20140714,5852,5816,0,0,0,5746,5746,-70,-70,0,0,4
1565,p1501,20140714,5806,5828,5776,5780,5676,5712,5716,-116,-112,589750,33716669640,420984
1779,p1502,20140714,5932,5926,0,0,0,5860,5860,-66,-66,0,0,8
1977,p1503,20140714,5976,5976,0,0,0,5920,5920,-56,-56,0,0,20
2154,p1504,20140714,5966,5966,0,0,0,5934,5934,-32,-32,0,0,8
2310,p1505,20140714,5980,6002,5960,5960,5860,5894,5902,-108,-100,40354,2381883560,52562
2446,p1506,20140714,6038,6038,0,0,0,5954,5954,-84,-84,0,0,0
613,p1408,20140715,5982,5982,5744,5744,5744,5744,5744,-238,-238,2,114880,2
765,p1409,20140715,5604,5592,5628,5628,5568,5586,5586,-6,-6,69096,3860145000,115428
938,p1410,20140715,5704,5704,5560,5568,5560,5568,5562,-136,-142,6,333760,4
1132,p1411,20140715,5690,5690,0,0,0,5690,5690,0,0,0,0,4
1344,p1412,20140715,5746,5746,0,0,0,5604,5604,-142,-142,0,0,4
1566,p1501,20140715,5712,5716,5676,5718,5666,5684,5686,-32,-30,449586,25564049280,434764
1780,p1502,20140715,5860,5860,0,0,0,5830,5830,-30,-30,0,0,8
1978,p1503,20140715,5920,5920,0,0,0,5878,5878,-42,-42,0,0,20
2155,p1504,20140715,5934,5934,0,0,0,5886,5886,-48,-48,0,0,8
2311,p1505,20140715,5894,5902,5876,5900,5852,5868,5870,-34,-32,33972,1994780000,57742
2447,p1506,20140715,5954,5954,0,0,0,5954,5954,0,0,0,0,0
2563,p1507,20140715,6000,6000,0,0,0,6000,6000,0,0,0,0,0
614,p1408,20140716,5744,5744,0,0,0,5744,5744,0,0,0,0,2
766,p1409,20140716,5586,5586,5592,5644,5576,5612,5614,26,28,46382,2604552760,113638
939,p1410,20140716,5568,5562,5566,5624,5566,5624,5588,62,26,18,1005840,6
1133,p1411,20140716,5690,5690,0,0,0,5716,5716,26,26,0,0,4
1345,p1412,20140716,5604,5604,0,0,0,5630,5630,26,26,0,0,4
1567,p1501,20140716,5684,5686,5682,5742,5674,5710,5708,24,22,469054,26774670120,451580
1781,p1502,20140716,5830,5830,5816,5858,5726,5830,5784,0,-46,16,925720,6
1979,p1503,20140716,5878,5878,0,0,0,5816,5816,-62,-62,0,0,20
2156,p1504,20140716,5886,5886,0,0,0,5886,5886,0,0,0,0,8
2312,p1505,20140716,5868,5870,5866,5922,5862,5890,5898,20,28,44182,2605912960,59808
2448,p1506,20140716,5954,5954,0,0,0,5954,5954,0,0,0,0,0
2564,p1507,20140716,6000,6000,0,0,0,6000,6000,0,0,0,0,0
615,p1408,20140717,5744,5744,0,0,0,5744,5744,0,0,0,0,2
767,p1409,20140717,5612,5614,5640,5644,5612,5634,5628,20,14,35640,2006154000,108466
940,p1410,20140717,5624,5588,5704,5710,5610,5626,5662,38,74,8,453000,4
1134,p1411,20140717,5716,5716,5720,5720,5652,5652,5686,-64,-30,4,227440,4
1346,p1412,20140717,5630,5630,0,0,0,5602,5602,-28,-28,0,0,4
1568,p1501,20140717,5710,5708,5720,5728,5702,5720,5716,12,8,269058,15383176440,450348
1782,p1502,20140717,5830,5784,0,0,0,5784,5784,0,0,0,0,6
1980,p1503,20140717,5816,5816,0,0,0,5816,5816,0,0,0,0,20
2157,p1504,20140717,5886,5886,5918,5918,5918,5918,5918,32,32,2,118360,10
2313,p1505,20140717,5890,5898,5910,5916,5810,5908,5902,10,4,18776,1108397080,60264
2449,p1506,20140717,5954,5954,0,0,0,5954,5954,0,0,0,0,0
2565,p1507,20140717,6000,6000,0,0,0,6000,6000,0,0,0,0,0
616,p1408,20140718,5744,5744,0,0,0,5744,5744,0,0,0,0,2
768,p1409,20140718,5634,5628,5622,5634,5598,5628,5622,0,-6,33766,1898588360,108298
941,p1410,20140718,5626,5662,0,0,0,5662,5662,0,0,0,0,4
1135,p1411,20140718,5652,5686,5708,5708,5634,5656,5680,-30,-6,50,2840920,2
1347,p1412,20140718,5602,5602,5698,5698,5698,5698,5698,96,96,2,113960,4
1569,p1501,20140718,5720,5716,5710,5714,5676,5694,5696,-22,-20,388586,22134096000,490272
1783,p1502,20140718,5784,5784,0,0,0,5784,5784,0,0,0,0,6
1981,p1503,20140718,5816,5816,0,0,0,5816,5816,0,0,0,0,20
2158,p1504,20140718,5918,5918,0,0,0,5886,5886,-32,-32,0,0,10
2314,p1505,20140718,5908,5902,5890,5902,5858,5870,5878,-32,-24,29912,1758705600,65930
2450,p1506,20140718,5954,5954,0,0,0,5954,5954,0,0,0,0,0
2566,p1507,20140718,6000,6000,0,0,0,6000,6000,0,0,0,0,0
617,p1408,20140721,5744,5744,0,0,0,5744,5744,0,0,0,0,2
769,p1409,20140721,5628,5622,5638,5694,5592,5604,5644,-18,22,59872,3380176720,103948
942,p1410,20140721,5662,5662,5656,5656,5592,5592,5624,-70,-38,20,1124800,14
1136,p1411,20140721,5656,5680,0,0,0,5680,5680,0,0,0,0,2
1348,p1412,20140721,5698,5698,5698,5730,5682,5682,5710,-16,12,8,456800,2
1570,p1501,20140721,5694,5696,5712,5736,5656,5670,5688,-26,-8,581670,33095041080,530660
1784,p1502,20140721,5784,5784,5756,5756,5756,5756,5756,-28,-28,2,115120,4
1982,p1503,20140721,5816,5816,5806,5806,5806,5806,5806,-10,-10,2,116120,22
2159,p1504,20140721,5886,5886,5900,5900,5900,5900,5900,14,14,2,118000,8
2315,p1505,20140721,5870,5878,5888,5908,5830,5834,5858,-44,-20,23324,1366643080,65684
2451,p1506,20140721,5954,5954,0,0,0,5954,5954,0,0,0,0,0
2567,p1507,20140721,6000,6000,5850,5978,5848,5962,5908,-38,-92,8,472760,2
618,p1408,20140722,5744,5744,0,0,0,5744,5744,0,0,0,0,2
770,p1409,20140722,5604,5644,5616,5616,5550,5584,5572,-60,-72,43368,2417278400,98362
943,p1410,20140722,5592,5624,5658,5658,5562,5562,5594,-62,-30,14,783320,4
1137,p1411,20140722,5680,5680,0,0,0,5680,5680,0,0,0,0,2
1349,p1412,20140722,5682,5710,0,0,0,5710,5710,0,0,0,0,2
1571,p1501,20140722,5670,5688,5668,5676,5592,5644,5632,-44,-56,564984,31822179720,533390
1785,p1502,20140722,5756,5756,5754,5754,5652,5652,5692,-104,-64,62,3529200,4
1983,p1503,20140722,5806,5806,0,0,0,5748,5748,-58,-58,0,0,22
2160,p1504,20140722,5900,5900,5762,5802,5762,5800,5788,-100,-112,6,347280,8
2316,p1505,20140722,5834,5858,5850,5850,5762,5804,5798,-54,-60,31972,1853802560,64968
2452,p1506,20140722,5954,5954,5800,5846,5800,5810,5824,-144,-130,8,466040,0
2568,p1507,20140722,5962,5908,0,0,0,5908,5908,0,0,0,0,2
619,p1408,20140723,5744,5744,0,0,0,5744,5744,0,0,0,0,2
771,p1409,20140723,5584,5572,5576,5578,5526,5544,5546,-28,-26,43114,2391230720,89448
944,p1410,20140723,5562,5594,5608,5610,5566,5566,5602,-28,8,30,1680680,22
1138,p1411,20140723,5680,5680,0,0,0,5652,5652,-28,-28,0,0,2
1350,p1412,20140723,5710,5710,0,0,0,5710,5710,0,0,0,0,2
1572,p1501,20140723,5644,5632,5644,5644,5558,5594,5596,-38,-36,687958,38509548640,560372
1786,p1502,20140723,5652,5692,0,0,0,5692,5692,0,0,0,0,4
1984,p1503,20140723,5748,5748,5786,5786,5732,5732,5756,-16,8,10,575600,24
2161,p1504,20140723,5800,5788,5786,5786,5786,5786,5786,-2,-2,2,115720,6
2317,p1505,20140723,5804,5798,5798,5798,5728,5754,5764,-44,-34,21340,1230327400,65636
2453,p1506,20140723,5810,5824,0,0,0,5824,5824,0,0,0,0,0
2569,p1507,20140723,5908,5908,0,0,0,5874,5874,-34,-34,0,0,2
620,p1408,20140724,5744,5744,0,0,0,5744,5744,0,0,0,0,2
772,p1409,20140724,5544,5546,5550,5602,5520,5580,5566,34,20,29594,1647737840,82372
945,p1410,20140724,5566,5602,5618,5618,5618,5618,5618,16,16,14,786520,8
1139,p1411,20140724,5652,5652,5490,5598,5490,5598,5558,-54,-94,12,667120,0
1351,p1412,20140724,5710,5710,0,0,0,5708,5708,-2,-2,0,0,2
1573,p1501,20140724,5594,5596,5586,5668,5572,5646,5628,50,32,454604,25588910240,484648
1787,p1502,20140724,5692,5692,0,0,0,5692,5692,0,0,0,0,4
1985,p1503,20140724,5732,5756,5764,5764,5764,5764,5764,8,8,2,115280,24
2162,p1504,20140724,5786,5786,0,0,0,5786,5786,0,0,0,0,6
2318,p1505,20140724,5754,5764,5752,5812,5738,5800,5786,36,22,22958,1328554640,65756
2454,p1506,20140724,5824,5824,0,0,0,5824,5824,0,0,0,0,0
2570,p1507,20140724,5874,5874,0,0,0,5896,5896,22,22,0,0,2
621,p1408,20140725,5744,5744,0,0,0,5744,5744,0,0,0,0,2
773,p1409,20140725,5580,5566,5612,5622,5548,5566,5574,0,8,23274,1297613840,78476
946,p1410,20140725,5618,5618,0,0,0,5618,5618,0,0,0,0,8
1140,p1411,20140725,5598,5558,0,0,0,5558,5558,0,0,0,0,0
1352,p1412,20140725,5708,5708,0,0,0,5692,5692,-16,-16,0,0,2
1574,p1501,20140725,5646,5628,5690,5690,5634,5650,5652,22,24,438800,24806918520,481858
1788,p1502,20140725,5692,5692,5766,5766,5724,5724,5746,32,54,34,1953920,6
1986,p1503,20140725,5764,5764,0,0,0,5764,5764,0,0,0,0,24
2163,p1504,20140725,5786,5786,0,0,0,5792,5792,6,6,0,0,6
2319,p1505,20140725,5800,5786,5830,5840,5792,5802,5810,16,24,40478,2352067360,64766
2455,p1506,20140725,5824,5824,0,0,0,5824,5824,0,0,0,0,0
2571,p1507,20140725,5896,5896,0,0,0,5920,5920,24,24,0,0,2
622,p1408,20140728,5744,5744,0,0,0,5744,5744,0,0,0,0,2
774,p1409,20140728,5566,5574,5520,5564,5496,5528,5526,-46,-48,40374,2231099480,77360
947,p1410,20140728,5618,5618,0,0,0,5570,5570,-48,-48,0,0,8
1141,p1411,20140728,5558,5558,0,0,0,5558,5558,0,0,0,0,0
1353,p1412,20140728,5692,5692,5674,5674,5580,5658,5634,-34,-58,10,563440,2
1575,p1501,20140728,5650,5652,5616,5662,5572,5628,5606,-24,-46,645854,36210924680,525612
1789,p1502,20140728,5724,5746,5680,5680,5634,5634,5656,-112,-90,4,226280,6
1987,p1503,20140728,5764,5764,5680,5680,5646,5646,5654,-118,-110,8,452360,24
2164,p1504,20140728,5792,5792,0,0,0,5792,5792,0,0,0,0,6
2320,p1505,20140728,5802,5810,5780,5816,5728,5780,5768,-30,-42,43664,2519029320,67718
2456,p1506,20140728,5824,5824,0,0,0,5824,5824,0,0,0,0,0
2572,p1507,20140728,5920,5920,0,0,0,5920,5920,0,0,0,0,2
623,p1408,20140729,5744,5744,5518,5518,5518,5518,5518,-226,-226,2,110360,0
775,p1409,20140729,5528,5526,5536,5560,5514,5548,5540,22,14,19746,1093932760,72516
948,p1410,20140729,5570,5570,0,0,0,5584,5584,14,14,0,0,8
1142,p1411,20140729,5558,5558,0,0,0,5558,5558,0,0,0,0,0
1354,p1412,20140729,5658,5634,0,0,0,5634,5634,0,0,0,0,2
1576,p1501,20140729,5628,5606,5610,5670,5610,5652,5642,46,36,395002,22286908520,526434
1790,p1502,20140729,5634,5656,5642,5742,5642,5696,5694,40,38,8,455560,4
1988,p1503,20140729,5646,5654,0,0,0,5654,5654,0,0,0,0,24
2165,p1504,20140729,5792,5792,5750,5808,5750,5808,5778,16,-14,4,231160,10
2321,p1505,20140729,5780,5768,5780,5828,5768,5820,5806,52,38,23740,1378495280,65636
2457,p1506,20140729,5824,5824,0,0,0,5824,5824,0,0,0,0,0
2573,p1507,20140729,5920,5920,0,0,0,5920,5920,0,0,0,0,2
624,p1408,20140730,5518,5518,0,0,0,5518,5518,0,0,0,0,0
776,p1409,20140730,5548,5540,5520,5546,5512,5544,5524,4,-16,26120,1443067440,63844
949,p1410,20140730,5584,5584,0,0,0,5568,5568,-16,-16,0,0,8
1143,p1411,20140730,5558,5558,0,0,0,5558,5558,0,0,0,0,0
1355,p1412,20140730,5634,5634,5646,5646,5646,5646,5646,12,12,2,112920,0
1577,p1501,20140730,5652,5642,5630,5662,5618,5654,5630,12,-12,591772,33318845480,505688
1791,p1502,20140730,5696,5694,0,0,0,5694,5694,0,0,0,0,4
1989,p1503,20140730,5654,5654,5746,5746,5746,5746,5746,92,92,2,114920,24
2166,p1504,20140730,5808,5778,0,0,0,5798,5798,20,20,0,0,10
2322,p1505,20140730,5820,5806,5800,5822,5780,5820,5798,14,-8,24214,1403971200,64736
2458,p1506,20140730,5824,5824,0,0,0,5824,5824,0,0,0,0,0
2574,p1507,20140730,5920,5920,0,0,0,5912,5912,-8,-8,0,0,2
625,p1408,20140731,5518,5518,0,0,0,5518,5518,0,0,0,0,0
777,p1409,20140731,5544,5524,5530,5560,5516,5530,5532,6,8,20902,1156705200,64822
950,p1410,20140731,5568,5568,0,0,0,5568,5568,0,0,0,0,8
1144,p1411,20140731,5558,5558,0,0,0,5558,5558,0,0,0,0,0
1356,p1412,20140731,5646,5646,5678,5678,5650,5650,5664,4,18,4,226560,2
1578,p1501,20140731,5654,5630,5660,5678,5636,5656,5656,26,26,459968,26016637640,526438
1792,p1502,20140731,5694,5694,0,0,0,5694,5694,0,0,0,0,4
1990,p1503,20140731,5746,5746,5732,5732,5732,5732,5732,-14,-14,2,114640,24
2167,p1504,20140731,5798,5798,5802,5802,5802,5802,5802,4,4,2,116040,10
2323,p1505,20140731,5820,5798,5808,5838,5798,5818,5818,20,20,23898,1390639600,65980
2459,p1506,20140731,5824,5824,0,0,0,5824,5824,0,0,0,0,0
2575,p1507,20140731,5912,5912,0,0,0,5912,5912,0,0,0,0,2
626,p1408,20140801,5518,5518,0,0,0,5518,5518,0,0,0,0,0
778,p1409,20140801,5530,5532,5522,5540,5516,5538,5524,6,-8,11732,648295600,62516
951,p1410,20140801,5568,5568,0,0,0,5560,5560,-8,-8,0,0,8
1145,p1411,20140801,5558,5558,0,0,0,5558,5558,0,0,0,0,0
1357,p1412,20140801,5650,5664,0,0,0,5664,5664,0,0,0,0,2
1579,p1501,20140801,5656,5656,5640,5660,5636,5656,5646,0,-10,295872,16708320240,506970
1793,p1502,20140801,5694,5694,0,0,0,5694,5694,0,0,0,0,4
1991,p1503,20140801,5732,5732,0,0,0,5732,5732,0,0,0,0,24
2168,p1504,20140801,5802,5802,5802,5802,5802,5802,5802,0,0,2,116040,8
2324,p1505,20140801,5818,5818,5802,5824,5798,5814,5808,-4,-10,19954,1159025720,69288
2460,p1506,20140801,5824,5824,0,0,0,5824,5824,0,0,0,0,0
2576,p1507,20140801,5912,5912,5882,5882,5882,5882,5882,-30,-30,2,117640,4
627,p1408,20140804,5518,5518,0,0,0,5518,5518,0,0,0,0,0
779,p1409,20140804,5538,5524,5534,5540,5502,5528,5520,4,-4,14484,799798760,56474
952,p1410,20140804,5560,5560,0,0,0,5556,5556,-4,-4,0,0,8
1146,p1411,20140804,5558,5558,0,0,0,5558,5558,0,0,0,0,0
1358,p1412,20140804,5664,5664,0,0,0,5664,5664,0,0,0,0,2
1580,p1501,20140804,5656,5646,5656,5666,5610,5634,5630,-12,-16,353896,19924900520,508868
1794,p1502,20140804,5694,5694,5608,5710,5606,5708,5612,14,-82,108,6061440,102
1992,p1503,20140804,5732,5732,0,0,0,5732,5732,0,0,0,0,24
2169,p1504,20140804,5802,5802,5762,5762,5762,5762,5762,-40,-40,4,230480,4
2325,p1505,20140804,5814,5808,5816,5824,5768,5792,5786,-16,-22,23462,1357683200,73096
2461,p1506,20140804,5824,5824,0,0,0,5824,5824,0,0,0,0,0
2577,p1507,20140804,5882,5882,0,0,0,5860,5860,-22,-22,0,0,4
628,p1408,20140805,5518,5518,0,0,0,5518,5518,0,0,0,0,0
780,p1409,20140805,5528,5520,5530,5548,5520,5530,5532,10,12,6738,372799040,55706
953,p1410,20140805,5556,5556,0,0,0,5568,5568,12,12,0,0,8
1147,p1411,20140805,5558,5558,0,0,0,5558,5558,0,0,0,0,0
1359,p1412,20140805,5664,5664,5690,5692,5652,5660,5676,-4,12,10,567720,6
1581,p1501,20140805,5634,5630,5638,5656,5614,5628,5632,-2,2,323646,18228617160,536606
1795,p1502,20140805,5708,5612,0,0,0,5664,5664,52,52,0,0,102
1993,p1503,20140805,5732,5732,0,0,0,5732,5732,0,0,0,0,24
2170,p1504,20140805,5762,5762,5698,5820,5698,5820,5740,58,-22,50,2870960,6
2326,p1505,20140805,5792,5786,5800,5818,5778,5786,5792,0,6,20388,1181254760,71914
2462,p1506,20140805,5824,5824,0,0,0,5824,5824,0,0,0,0,0
2578,p1507,20140805,5860,5860,5828,5828,5828,5828,5828,-32,-32,2,116560,6
629,p1408,20140806,5518,5518,0,0,0,5518,5518,0,0,0,0,0
781,p1409,20140806,5530,5532,5512,5540,5512,5522,5524,-10,-8,9460,522594320,53300
954,p1410,20140806,5568,5568,0,0,0,5560,5560,-8,-8,0,0,8
1148,p1411,20140806,5558,5558,0,0,0,5558,5558,0,0,0,0,0
1360,p1412,20140806,5660,5676,0,0,0,5676,5676,0,0,0,0,6
1582,p1501,20140806,5628,5632,5608,5624,5600,5606,5612,-26,-20,206854,11611734840,545446
1796,p1502,20140806,5664,5664,0,0,0,5664,5664,0,0,0,0,102
1994,p1503,20140806,5732,5732,5732,5732,5648,5648,5690,-84,-42,4,227600,24
2171,p1504,20140806,5820,5740,5894,5894,5752,5768,5790,28,50,10,579040,2
2327,p1505,20140806,5786,5792,5770,5784,5762,5762,5772,-30,-20,21944,1266886800,73560
2463,p1506,20140806,5824,5824,0,0,0,5824,5824,0,0,0,0,0
2579,p1507,20140806,5828,5828,0,0,0,5808,5808,-20,-20,0,0,6
630,p1408,20140807,5518,5518,0,0,0,5518,5518,0,0,0,0,0
782,p1409,20140807,5522,5524,5524,5546,5524,5544,5534,20,10,8188,453243600,52642
955,p1410,20140807,5560,5560,0,0,0,5570,5570,10,10,0,0,8
1149,p1411,20140807,5558,5558,0,0,0,5558,5558,0,0,0,0,0
1361,p1412,20140807,5676,5676,0,0,0,5676,5676,0,0,0,0,6
1583,p1501,20140807,5606,5612,5610,5646,5606,5626,5626,14,14,280002,15758351200,545460
1797,p1502,20140807,5664,5664,0,0,0,5664,5664,0,0,0,0,102
1995,p1503,20140807,5648,5690,5668,5724,5668,5724,5696,34,6,8,455680,24
2172,p1504,20140807,5768,5790,5790,5790,5782,5782,5786,-8,-4,4,231440,2
2328,p1505,20140807,5762,5772,5768,5802,5766,5788,5788,16,16,24866,1439451440,72530
2464,p1506,20140807,5824,5824,0,0,0,5824,5824,0,0,0,0,0
2580,p1507,20140807,5808,5808,0,0,0,5808,5808,0,0,0,0,6
631,p1408,20140808,5518,5518,0,0,0,5518,5518,0,0,0,0,0
783,p1409,20140808,5544,5534,5546,5562,5538,5544,5544,10,10,5214,289144160,50426
956,p1410,20140808,5570,5570,0,0,0,5580,5580,10,10,0,0,8
1150,p1411,20140808,5558,5558,0,0,0,5558,5558,0,0,0,0,0
1362,p1412,20140808,5676,5676,0,0,0,5676,5676,0,0,0,0,6
1584,p1501,20140808,5626,5626,5632,5648,5612,5626,5628,0,2,203530,11458696920,547160
1798,p1502,20140808,5664,5664,0,0,0,5666,5666,2,2,0,0,102
1996,p1503,20140808,5724,5696,0,0,0,5696,5696,0,0,0,0,24
2173,p1504,20140808,5782,5786,5826,5826,5826,5826,5826,40,40,2,116520,4
2329,p1505,20140808,5788,5788,5788,5808,5772,5788,5788,0,0,14630,846997240,71700
2465,p1506,20140808,5824,5824,0,0,0,5824,5824,0,0,0,0,0
2581,p1507,20140808,5808,5808,5950,5950,5812,5812,5880,4,72,4,235240,6
632,p1408,20140811,5518,5518,0,0,0,5518,5518,0,0,0,0,0
784,p1409,20140811,5544,5544,5530,5546,5516,5522,5528,-22,-16,7586,419364280,46096
957,p1410,20140811,5580,5580,5612,5612,5560,5560,5586,-20,6,4,223440,8
1151,p1411,20140811,5558,5558,0,0,0,5558,5558,0,0,0,0,0
1363,p1412,20140811,5676,5676,5682,5682,5682,5682,5682,6,6,4,227280,10
1585,p1501,20140811,5626,5628,5608,5642,5592,5612,5614,-16,-14,344956,19370217720,537166
1799,p1502,20140811,5666,5666,5692,5694,5690,5694,5690,28,24,100,5691040,2
1997,p1503,20140811,5696,5696,0,0,0,5696,5696,0,0,0,0,24
2174,p1504,20140811,5826,5826,5758,5860,5758,5860,5808,34,-18,4,232360,6
2330,p1505,20140811,5788,5788,5770,5798,5748,5756,5766,-32,-22,55440,3197690520,85264
2466,p1506,20140811,5824,5824,0,0,0,5824,5824,0,0,0,0,0
2582,p1507,20140811,5812,5880,0,0,0,5858,5858,-22,-22,0,0,6
633,p1408,20140812,5518,5518,0,0,0,5518,5518,0,0,0,0,0
785,p1409,20140812,5522,5528,5502,5510,5472,5494,5496,-34,-32,16038,881660000,40690
958,p1410,20140812,5560,5586,0,0,0,5554,5554,-32,-32,0,0,8
1152,p1411,20140812,5558,5558,0,0,0,5558,5558,0,0,0,0,0
1364,p1412,20140812,5682,5682,5610,5610,5608,5608,5608,-74,-74,6,336520,6
1586,p1501,20140812,5612,5614,5570,5590,5544,5570,5570,-44,-44,419232,23354038480,535044
1800,p1502,20140812,5694,5690,5600,5600,5600,5600,5600,-90,-90,2,112000,4
1998,p1503,20140812,5696,5696,0,0,0,5696,5696,0,0,0,0,24
2175,p1504,20140812,5860,5808,0,0,0,5740,5740,-68,-68,0,0,6
2331,p1505,20140812,5756,5766,5730,5734,5690,5708,5710,-58,-56,51212,2924314000,86902
2467,p1506,20140812,5824,5824,0,0,0,5824,5824,0,0,0,0,0
2583,p1507,20140812,5858,5858,0,0,0,5802,5802,-56,-56,0,0,6
634,p1408,20140813,5518,5518,0,0,0,5518,5518,0,0,0,0,0
786,p1409,20140813,5494,5496,5506,5510,5474,5484,5488,-12,-8,9112,500102280,36804
959,p1410,20140813,5554,5554,0,0,0,5546,5546,-8,-8,0,0,8
1153,p1411,20140813,5558,5558,0,0,0,5558,5558,0,0,0,0,0
1365,p1412,20140813,5608,5608,5628,5628,5590,5598,5608,-10,0,8,448680,6
1587,p1501,20140813,5570,5570,5578,5582,5556,5564,5566,-6,-4,263474,14668987560,527076
1801,p1502,20140813,5600,5600,5678,5678,5560,5622,5608,22,8,30,1682680,2
1999,p1503,20140813,5696,5696,0,0,0,5696,5696,0,0,0,0,24
2176,p1504,20140813,5740,5740,0,0,0,5730,5730,-10,-10,0,0,6
2332,p1505,20140813,5708,5710,5706,5714,5684,5692,5696,-18,-14,43032,2451838200,94202
2468,p1506,20140813,5824,5824,0,0,0,5782,5782,-42,-42,0,0,0
2584,p1507,20140813,5802,5802,0,0,0,5802,5802,0,0,0,0,6
635,p1408,20140814,5518,5518,0,0,0,5518,5518,0,0,0,0,0
787,p1409,20140814,5484,5488,5494,5494,5308,5350,5354,-138,-134,26720,1431009240,30584
960,p1410,20140814,5546,5546,5466,5534,5342,5468,5438,-78,-108,10,543920,12
1154,p1411,20140814,5558,5558,0,0,0,5450,5450,-108,-108,0,0,0
1366,p1412,20140814,5598,5608,0,0,0,5522,5522,-86,-86,0,0,6
1588,p1501,20140814,5564,5566,5566,5574,5412,5440,5470,-126,-96,686360,37547531240,528860
1802,p1502,20140814,5622,5608,0,0,0,5562,5562,-46,-46,0,0,2
2000,p1503,20140814,5696,5696,0,0,0,5532,5532,-164,-164,0,0,24
2177,p1504,20140814,5730,5730,5562,5562,5540,5540,5550,-190,-180,4,222040,4
2333,p1505,20140814,5692,5696,5700,5702,5554,5570,5590,-126,-106,77588,4337681800,99664
2469,p1506,20140814,5782,5782,5650,5718,5650,5718,5684,-64,-98,12,682080,0
2585,p1507,20140814,5802,5802,0,0,0,5704,5704,-98,-98,0,0,6
788,p1409,20140815,5350,5354,5332,5390,5288,5298,5322,-56,-32,10858,577980200,27916
961,p1410,20140815,5468,5438,5390,5390,5390,5390,5390,-48,-48,2,107800,10
1155,p1411,20140815,5450,5450,0,0,0,5450,5450,0,0,0,0,0
1367,p1412,20140815,5522,5522,5438,5446,5406,5446,5430,-76,-92,32,1737800,4
1589,p1501,20140815,5440,5470,5448,5466,5376,5382,5402,-88,-68,730258,39460461120,603074
1803,p1502,20140815,5562,5562,0,0,0,5516,5516,-46,-46,0,0,2
2001,p1503,20140815,5532,5532,5504,5504,5504,5504,5504,-28,-28,6,330240,24
2178,p1504,20140815,5540,5550,5632,5632,5552,5552,5584,2,34,6,335080,4
2334,p1505,20140815,5570,5590,5590,5590,5512,5522,5546,-68,-44,73146,4057099200,101148
2470,p1506,20140815,5718,5684,0,0,0,5588,5588,-96,-96,0,0,0
2586,p1507,20140815,5704,5704,0,0,0,5660,5660,-44,-44,0,0,6
2679,p1508,20140815,5694,5694,0,0,0,5694,5694,0,0,0,0,0
789,p1409,20140818,5298,5322,5272,5300,5206,5224,5240,-98,-82,5928,310725800,27620
962,p1410,20140818,5390,5390,0,0,0,5390,5390,0,0,0,0,10
1156,p1411,20140818,5450,5450,5438,5438,5232,5232,5282,-218,-168,8,422680,4
1368,p1412,20140818,5446,5430,0,0,0,5376,5376,-54,-54,0,0,4
1590,p1501,20140818,5382,5402,5372,5378,5284,5298,5312,-104,-90,722948,38410614800,620438
1804,p1502,20140818,5516,5516,0,0,0,5428,5428,-88,-88,0,0,2
2002,p1503,20140818,5504,5504,0,0,0,5390,5390,-114,-114,0,0,24
2179,p1504,20140818,5552,5584,0,0,0,5492,5492,-92,-92,0,0,4
2335,p1505,20140818,5522,5546,5520,5524,5456,5466,5478,-80,-68,83038,4549137240,98770
2471,p1506,20140818,5588,5588,0,0,0,5588,5588,0,0,0,0,0
2587,p1507,20140818,5660,5660,0,0,0,5592,5592,-68,-68,0,0,6
2680,p1508,20140818,5694,5694,0,0,0,5626,5626,-68,-68,0,0,0
790,p1409,20140819,5224,5240,5230,5264,5218,5250,5246,10,6,2636,138286800,26372
963,p1410,20140819,5390,5390,0,0,0,5396,5396,6,6,0,0,10
1157,p1411,20140819,5232,5282,5394,5394,5394,5394,5394,112,112,2,107880,2
1369,p1412,20140819,5376,5376,5318,5318,5246,5246,5282,-130,-94,4,211280,6
1591,p1501,20140819,5298,5312,5296,5314,5288,5306,5302,-6,-10,299832,15898394800,577694
1805,p1502,20140819,5428,5428,0,0,0,5428,5428,0,0,0,0,2
2003,p1503,20140819,5390,5390,5420,5424,5372,5380,5394,-10,4,10,539400,26
2180,p1504,20140819,5492,5492,0,0,0,5492,5492,0,0,0,0,4
2336,p1505,20140819,5466,5478,5468,5488,5468,5482,5478,4,0,27252,1493012760,101122
2472,p1506,20140819,5588,5588,0,0,0,5588,5588,0,0,0,0,0
2588,p1507,20140819,5592,5592,0,0,0,5592,5592,0,0,0,0,6
2681,p1508,20140819,5626,5626,0,0,0,5626,5626,0,0,0,0,0
791,p1409,20140820,5250,5246,5212,5226,5188,5226,5208,-20,-38,5472,285014720,23080
964,p1410,20140820,5396,5396,5318,5318,5194,5194,5236,-202,-160,8,418960,6
1158,p1411,20140820,5394,5394,0,0,0,5362,5362,-32,-32,0,0,2
1370,p1412,20140820,5246,5282,5310,5310,5310,5310,5310,28,28,2,106200,6
1592,p1501,20140820,5306,5302,5286,5286,5236,5252,5248,-50,-54,542058,28451821320,602712
1806,p1502,20140820,5428,5428,5268,5336,5268,5336,5302,-92,-126,4,212080,2
2004,p1503,20140820,5380,5394,0,0,0,5394,5394,0,0,0,0,26
2181,p1504,20140820,5492,5492,5424,5448,5424,5448,5440,-44,-52,10,544160,6
2337,p1505,20140820,5482,5478,5458,5470,5418,5430,5432,-48,-46,43354,2355391440,100612
2473,p1506,20140820,5588,5588,0,0,0,5562,5562,-26,-26,0,0,0
2589,p1507,20140820,5592,5592,5382,5382,5382,5382,5382,-210,-210,2,107640,4
2682,p1508,20140820,5626,5626,0,0,0,5626,5626,0,0,0,0,0
792,p1409,20140821,5226,5208,5208,5272,5208,5262,5252,54,44,4882,256481080,20634
965,p1410,20140821,5194,5236,5178,5328,5178,5328,5272,92,36,22,1160200,6
1159,p1411,20140821,5362,5362,0,0,0,5362,5362,0,0,0,0,2
1371,p1412,20140821,5310,5310,5300,5348,5250,5348,5302,38,-8,110,5832600,10
1593,p1501,20140821,5252,5248,5236,5302,5230,5262,5256,14,8,816092,42901726880,615294
1807,p1502,20140821,5336,5302,0,0,0,5302,5302,0,0,0,0,2
2005,p1503,20140821,5394,5394,0,0,0,5394,5394,0,0,0,0,26
2182,p1504,20140821,5448,5440,0,0,0,5440,5440,0,0,0,0,6
2338,p1505,20140821,5430,5432,5410,5476,5410,5444,5442,12,10,49746,2708105080,101408
2474,p1506,20140821,5562,5562,0,0,0,5562,5562,0,0,0,0,0
2590,p1507,20140821,5382,5382,0,0,0,5426,5426,44,44,0,0,4
2683,p1508,20140821,5626,5626,0,0,0,5626,5626,0,0,0,0,0
793,p1409,20140822,5262,5252,5256,5310,5242,5308,5272,56,20,7008,369477720,18588
966,p1410,20140822,5328,5272,5334,5334,5300,5300,5320,28,48,6,319280,10
1160,p1411,20140822,5362,5362,0,0,0,5362,5362,0,0,0,0,2
1372,p1412,20140822,5348,5302,0,0,0,5302,5302,0,0,0,0,10
1594,p1501,20140822,5262,5256,5250,5276,5240,5254,5258,-2,2,303492,15960657120,617776
1808,p1502,20140822,5302,5302,5346,5346,5288,5346,5320,44,18,8,425640,4
2006,p1503,20140822,5394,5394,0,0,0,5394,5394,0,0,0,0,26
2183,p1504,20140822,5440,5440,0,0,0,5440,5440,0,0,0,0,6
2339,p1505,20140822,5444,5442,5430,5458,5422,5428,5436,-14,-6,34304,1865333000,102410
2475,p1506,20140822,5562,5562,0,0,0,5562,5562,0,0,0,0,0
2591,p1507,20140822,5426,5426,0,0,0,5426,5426,0,0,0,0,4
2684,p1508,20140822,5626,5626,0,0,0,5626,5626,0,0,0,0,0
794,p1409,20140825,5308,5272,5272,5282,5184,5226,5230,-46,-42,5084,265905920,16236
967,p1410,20140825,5300,5320,5176,5318,5176,5308,5256,-12,-64,18,946320,12
1161,p1411,20140825,5362,5362,5288,5288,5288,5288,5288,-74,-74,2,105760,4
1373,p1412,20140825,5302,5302,0,0,0,5274,5274,-28,-28,0,0,10
1595,p1501,20140825,5254,5258,5212,5216,5104,5174,5152,-84,-106,1021220,52632260800,613296
1809,p1502,20140825,5346,5320,0,0,0,5300,5300,-20,-20,0,0,4
2007,p1503,20140825,5394,5394,5238,5260,5238,5260,5248,-134,-146,8,419960,26
2184,p1504,20140825,5440,5440,0,0,0,5440,5440,0,0,0,0,6
2340,p1505,20140825,5428,5436,5384,5388,5296,5350,5332,-86,-104,140814,7508965480,118372
2476,p1506,20140825,5562,5562,0,0,0,5488,5488,-74,-74,0,0,0
2592,p1507,20140825,5426,5426,0,0,0,5426,5426,0,0,0,0,4
2685,p1508,20140825,5626,5626,0,0,0,5538,5538,-88,-88,0,0,0
795,p1409,20140826,5226,5230,5256,5272,5182,5198,5226,-32,-4,1890,98805080,15078
968,p1410,20140826,5308,5256,5222,5388,5180,5180,5282,-76,26,30,1585160,8
1162,p1411,20140826,5288,5288,0,0,0,5288,5288,0,0,0,0,4
1374,p1412,20140826,5274,5274,5240,5240,5240,5240,5240,-34,-34,2,104800,10
1596,p1501,20140826,5174,5152,5208,5228,5160,5166,5196,14,44,489172,25420843640,629200
1810,p1502,20140826,5300,5300,5224,5232,5224,5232,5228,-68,-72,4,209120,4
2008,p1503,20140826,5260,5248,0,0,0,5248,5248,0,0,0,0,26
2185,p1504,20140826,5440,5440,5386,5386,5330,5330,5366,-110,-74,42,2254280,8
2341,p1505,20140826,5350,5332,5374,5396,5340,5346,5366,14,34,77736,4171353920,114066
2477,p1506,20140826,5488,5488,5518,5520,5384,5426,5436,-62,-52,18,978600,4
2593,p1507,20140826,5426,5426,0,0,0,5426,5426,0,0,0,0,4
2686,p1508,20140826,5538,5538,5536,5536,5402,5426,5458,-112,-80,22,1200960,6
796,p1409,20140827,5198,5226,5206,5264,5160,5242,5210,16,-16,8456,440598760,14696
969,p1410,20140827,5180,5282,5126,5340,5126,5340,5200,58,-82,32,1664560,2
1163,p1411,20140827,5288,5288,0,0,0,5206,5206,-82,-82,0,0,4
1375,p1412,20140827,5240,5240,5186,5186,5186,5186,5186,-54,-54,2,103720,12
1597,p1501,20140827,5166,5196,5178,5260,5116,5222,5192,26,-4,1259478,65415493880,626626
1811,p1502,20140827,5232,5228,0,0,0,5228,5228,0,0,0,0,4
2009,p1503,20140827,5248,5248,5400,5400,5302,5302,5350,54,102,4,214040,24
2186,p1504,20140827,5330,5366,5474,5474,5474,5474,5474,108,108,6,328440,12
2342,p1505,20140827,5346,5366,5356,5434,5306,5404,5386,38,20,112582,6063908320,113708
2478,p1506,20140827,5426,5436,0,0,0,5436,5436,0,0,0,0,4
2594,p1507,20140827,5426,5426,0,0,0,5446,5446,20,20,0,0,4
2687,p1508,20140827,5426,5458,0,0,0,5500,5500,42,42,0,0,6
797,p1409,20140828,5242,5210,5194,5228,5162,5180,5192,-30,-18,1058,54933040,13964
970,p1410,20140828,5340,5200,5286,5286,5286,5286,5286,86,86,2,105720,0
1164,p1411,20140828,5206,5206,0,0,0,5206,5206,0,0,0,0,4
1376,p1412,20140828,5186,5186,5198,5264,5198,5256,5236,70,50,10,523600,14
1598,p1501,20140828,5222,5192,5186,5212,5168,5198,5194,6,2,493170,25620864280,621438
1812,p1502,20140828,5228,5228,5228,5284,5228,5284,5256,56,28,4,210240,4
2010,p1503,20140828,5302,5350,5146,5312,5146,5312,5228,-38,-122,4,209160,26
2187,p1504,20140828,5474,5474,5394,5394,5394,5394,5394,-80,-80,2,107880,12
2343,p1505,20140828,5404,5386,5354,5400,5352,5392,5382,6,-4,71324,3839628600,115594
2479,p1506,20140828,5436,5436,0,0,0,5436,5436,0,0,0,0,4
2595,p1507,20140828,5446,5446,5450,5450,5382,5448,5422,2,-24,18,976000,8
2688,p1508,20140828,5500,5500,5460,5460,5360,5412,5418,-88,-82,44,2384720,6
798,p1409,20140829,5180,5192,5192,5200,4986,5098,5114,-94,-78,4828,246908120,13698
971,p1410,20140829,5286,5286,0,0,0,5286,5286,0,0,0,0,0
1165,p1411,20140829,5206,5206,0,0,0,5206,5206,0,0,0,0,4
1377,p1412,20140829,5256,5236,5250,5250,5250,5250,5250,14,14,2,105000,12
1599,p1501,20140829,5198,5194,5194,5216,5170,5196,5192,2,-2,384972,19993323600,604182
1813,p1502,20140829,5284,5256,0,0,0,5256,5256,0,0,0,0,4
2011,p1503,20140829,5312,5228,5242,5242,5242,5242,5242,14,14,4,209680,24
2188,p1504,20140829,5394,5394,0,0,0,5394,5394,0,0,0,0,12
2344,p1505,20140829,5392,5382,5388,5408,5368,5382,5386,0,4,49188,2649593600,113728
2480,p1506,20140829,5436,5436,0,0,0,5440,5440,4,4,0,0,4
2596,p1507,20140829,5448,5422,5422,5422,5422,5422,5422,0,0,4,216880,4
2689,p1508,20140829,5412,5418,0,0,0,5418,5418,0,0,0,0,6
799,p1409,20140901,5098,5114,4990,5100,4980,5100,5050,-14,-64,468,23639120,13698
972,p1410,20140901,5286,5286,5246,5246,5082,5176,5174,-110,-112,26,1345600,0
1166,p1411,20140901,5206,5206,0,0,0,5096,5096,-110,-110,0,0,4
1378,p1412,20140901,5250,5250,0,0,0,5250,5250,0,0,0,0,12
1600,p1501,20140901,5196,5192,5148,5166,5124,5156,5146,-36,-46,559378,28788278160,580052
1814,p1502,20140901,5256,5256,5156,5156,5156,5156,5156,-100,-100,2,103120,2
2012,p1503,20140901,5242,5242,0,0,0,5242,5242,0,0,0,0,24
2189,p1504,20140901,5394,5394,0,0,0,5394,5394,0,0,0,0,12
2345,p1505,20140901,5382,5386,5320,5352,5320,5348,5334,-38,-52,49918,2663453920,116518
2481,p1506,20140901,5440,5440,0,0,0,5388,5388,-52,-52,0,0,4
2597,p1507,20140901,5422,5422,5374,5374,5374,5374,5374,-48,-48,2,107480,2
2690,p1508,20140901,5418,5418,0,0,0,5418,5418,0,0,0,0,6
800,p1409,20140902,5100,5050,5090,5150,5090,5140,5138,90,88,252,12947800,13554
973,p1410,20140902,5176,5174,0,0,0,5264,5264,90,90,0,0,0
1167,p1411,20140902,5096,5096,0,0,0,5184,5184,88,88,0,0,4
1379,p1412,20140902,5250,5250,5196,5196,5196,5196,5196,-54,-54,2,103920,10
1601,p1501,20140902,5156,5146,5160,5196,5140,5182,5166,36,20,435856,22517645120,605748
1815,p1502,20140902,5156,5156,5252,5288,5200,5246,5228,90,72,122,6380000,6
2013,p1503,20140902,5242,5242,0,0,0,5242,5242,0,0,0,0,24
2190,p1504,20140902,5394,5394,0,0,0,5468,5468,74,74,0,0,12
2346,p1505,20140902,5348,5334,5352,5392,5332,5384,5366,50,32,42646,2288513480,117304
2482,p1506,20140902,5388,5388,5340,5378,5260,5378,5328,-10,-60,24,1279120,2
2598,p1507,20140902,5374,5374,0,0,0,5374,5374,0,0,0,0,2
2691,p1508,20140902,5418,5418,0,0,0,5358,5358,-60,-60,0,0,6
801,p1409,20140903,5140,5138,5150,5240,5150,5160,5198,22,60,362,18817640,13550
974,p1410,20140903,5264,5264,0,0,0,5324,5324,60,60,0,0,0
1168,p1411,20140903,5184,5184,5160,5342,5160,5342,5250,158,66,4,210040,4
1380,p1412,20140903,5196,5196,5276,5278,5260,5262,5274,66,78,40,2110120,10
1602,p1501,20140903,5182,5166,5188,5238,5172,5188,5206,22,40,474940,24727233280,585742
1816,p1502,20140903,5246,5228,5270,5270,5270,5270,5270,42,42,2,105400,4
2014,p1503,20140903,5242,5242,5330,5330,5330,5330,5330,88,88,2,106600,24
2191,p1504,20140903,5468,5468,5372,5372,5372,5372,5372,-96,-96,2,107440,10
2347,p1505,20140903,5384,5366,5390,5430,5376,5388,5406,22,40,55760,3014746200,113262
2483,p1506,20140903,5378,5328,5410,5410,5410,5410,5410,82,82,2,108200,2
2599,p1507,20140903,5374,5374,0,0,0,5374,5374,0,0,0,0,2
2692,p1508,20140903,5358,5358,5420,5492,5420,5492,5444,134,86,6,326640,4
802,p1409,20140904,5160,5198,5152,5152,5152,5152,5152,-46,-46,20,1030400,13548
975,p1410,20140904,5324,5324,0,0,0,5278,5278,-46,-46,0,0,0
1169,p1411,20140904,5342,5250,5246,5246,5246,5246,5246,-4,-4,2,104920,2
1381,p1412,20140904,5262,5274,0,0,0,5274,5274,0,0,0,0,10
1603,p1501,20140904,5188,5206,5202,5222,5180,5194,5200,-12,-6,431824,22458737400,601178
1817,p1502,20140904,5270,5270,0,0,0,5270,5270,0,0,0,0,4
2015,p1503,20140904,5330,5330,0,0,0,5330,5330,0,0,0,0,24
2192,p1504,20140904,5372,5372,5476,5476,5348,5366,5410,-6,38,206,11146040,10
2348,p1505,20140904,5388,5406,5396,5420,5370,5382,5390,-24,-16,72018,3881893760,115204
2484,p1506,20140904,5410,5410,0,0,0,5394,5394,-16,-16,0,0,2
2600,p1507,20140904,5374,5374,0,0,0,5374,5374,0,0,0,0,2
2693,p1508,20140904,5492,5444,5414,5414,5414,5414,5414,-30,-30,2,108280,4
803,p1409,20140905,5152,5152,5150,5150,5150,5150,5150,-2,-2,30,1545000,13558
976,p1410,20140905,5278,5278,0,0,0,5276,5276,-2,-2,0,0,0
1170,p1411,20140905,5246,5246,5388,5388,5314,5314,5350,68,104,4,214040,4
1382,p1412,20140905,5274,5274,5246,5246,5246,5246,5246,-28,-28,2,104920,8
1604,p1501,20140905,5194,5200,5250,5268,5204,5230,5240,30,40,459236,24064528280,621712
1818,p1502,20140905,5270,5270,0,0,0,5270,5270,0,0,0,0,4
2016,p1503,20140905,5330,5330,5310,5368,5300,5300,5326,-30,-4,6,319560,24
2193,p1504,20140905,5366,5410,0,0,0,5410,5410,0,0,0,0,10
2349,p1505,20140905,5382,5390,5438,5454,5380,5400,5418,10,28,93236,5052799400,118048
2485,p1506,20140905,5394,5394,5440,5458,5440,5458,5450,64,56,6,327080,2
2601,p1507,20140905,5374,5374,0,0,0,5398,5398,24,24,0,0,2
2694,p1508,20140905,5414,5414,5458,5458,5458,5458,5458,44,44,2,109160,2
804,p1409,20140909,5150,5150,5150,5162,5080,5080,5146,-70,-4,116,5969960,13548
977,p1410,20140909,5276,5276,0,0,0,5272,5272,-4,-4,0,0,0
1171,p1411,20140909,5314,5350,0,0,0,5346,5346,-4,-4,0,0,4
1383,p1412,20140909,5246,5246,0,0,0,5246,5246,0,0,0,0,8
1605,p1501,20140909,5230,5240,5230,5250,5184,5188,5212,-52,-28,172444,8989107960,604102
1819,p1502,20140909,5270,5270,0,0,0,5242,5242,-28,-28,0,0,4
2017,p1503,20140909,5300,5326,0,0,0,5326,5326,0,0,0,0,24
2194,p1504,20140909,5410,5410,0,0,0,5392,5392,-18,-18,0,0,10
2350,p1505,20140909,5400,5418,5392,5420,5350,5352,5384,-66,-34,40104,2159620280,119200
2486,p1506,20140909,5458,5450,0,0,0,5438,5438,-12,-12,0,0,2
2602,p1507,20140909,5398,5398,0,0,0,5398,5398,0,0,0,0,2
2695,p1508,20140909,5458,5458,0,0,0,5424,5424,-34,-34,0,0,2
805,p1409,20140910,5080,5146,5098,5100,5000,5000,5098,-146,-48,186,9483920,13548
978,p1410,20140910,5272,5272,5358,5358,5074,5154,5172,-118,-100,90,4654880,0
1172,p1411,20140910,5346,5346,5178,5288,5178,5288,5232,-58,-114,4,209320,4
1384,p1412,20140910,5246,5246,5160,5160,5160,5160,5160,-86,-86,2,103200,8
1606,p1501,20140910,5188,5212,5192,5196,5090,5130,5138,-82,-74,731582,37598945040,613004
1820,p1502,20140910,5242,5242,0,0,0,5242,5242,0,0,0,0,4
2018,p1503,20140910,5326,5326,5164,5224,5164,5224,5194,-102,-132,4,207760,22
2195,p1504,20140910,5392,5392,0,0,0,5392,5392,0,0,0,0,10
2351,p1505,20140910,5352,5384,5366,5366,5264,5294,5302,-90,-82,102328,5427085520,124000
2487,p1506,20140910,5438,5438,0,0,0,5438,5438,0,0,0,0,2
2603,p1507,20140910,5398,5398,0,0,0,5398,5398,0,0,0,0,2
2696,p1508,20140910,5424,5424,0,0,0,5342,5342,-82,-82,0,0,2
806,p1409,20140911,5000,5098,5120,5120,5120,5120,5120,22,22,2,102400,13548
979,p1410,20140911,5154,5172,0,0,0,5194,5194,22,22,0,0,0
1173,p1411,20140911,5288,5232,0,0,0,5232,5232,0,0,0,0,4
1385,p1412,20140911,5160,5160,0,0,0,5160,5160,0,0,0,0,8
1607,p1501,20140911,5130,5138,5142,5178,5128,5160,5150,22,12,505750,26051686400,626302
1821,p1502,20140911,5242,5242,0,0,0,5242,5242,0,0,0,0,4
2019,p1503,20140911,5224,5194,0,0,0,5194,5194,0,0,0,0,22
2196,p1504,20140911,5392,5392,0,0,0,5386,5386,-6,-6,0,0,10
2352,p1505,20140911,5294,5302,5318,5332,5288,5326,5314,24,12,72400,3847640800,127646
2488,p1506,20140911,5438,5438,5256,5256,5256,5256,5256,-182,-182,2,105120,2
2604,p1507,20140911,5398,5398,0,0,0,5398,5398,0,0,0,0,2
2697,p1508,20140911,5342,5342,0,0,0,5164,5164,-178,-178,0,0,2
807,p1409,20140912,5120,5120,5000,5000,5000,5000,5000,-120,-120,2,100000,13548
980,p1410,20140912,5194,5194,0,0,0,5074,5074,-120,-120,0,0,0
1174,p1411,20140912,5232,5232,0,0,0,5232,5232,0,0,0,0,4
1386,p1412,20140912,5160,5160,0,0,0,5160,5160,0,0,0,0,8
1608,p1501,20140912,5160,5150,5182,5202,5152,5198,5182,48,32,564972,29278487520,666402
1822,p1502,20140912,5242,5242,5314,5314,5232,5276,5274,34,32,6,316440,6
2020,p1503,20140912,5194,5194,0,0,0,5226,5226,32,32,0,0,22
2197,p1504,20140912,5386,5386,5338,5360,5338,5348,5346,-38,-40,14,748480,10
2353,p1505,20140912,5326,5314,5350,5366,5312,5360,5344,46,30,95218,5090236080,125090
2489,p1506,20140912,5256,5256,5332,5400,5332,5384,5356,128,100,10,535600,4
2605,p1507,20140912,5398,5398,5332,5448,5304,5444,5374,46,-24,22,1182600,6
2698,p1508,20140912,5164,5164,5342,5342,5342,5342,5342,178,178,2,106840,2
808,p1409,20140915,5000,5000,5058,5058,5058,5058,5120,58,120,2,101160,0
981,p1410,20140915,5074,5074,0,0,0,5194,5194,120,120,0,0,0
1175,p1411,20140915,5232,5232,0,0,0,5232,5232,0,0,0,0,4
1387,p1412,20140915,5160,5160,0,0,0,5170,5170,10,10,0,0,8
1609,p1501,20140915,5198,5182,5210,5260,5182,5240,5212,58,30,522472,27234679000,669756
1823,p1502,20140915,5276,5274,0,0,0,5290,5290,16,16,0,0,6
2021,p1503,20140915,5226,5226,5354,5354,5296,5296,5324,70,98,4,213000,22
2198,p1504,20140915,5348,5346,0,0,0,5346,5346,0,0,0,0,10
2354,p1505,20140915,5360,5344,5366,5416,5344,5402,5374,58,30,100790,5417797000,127592
2490,p1506,20140915,5384,5356,0,0,0,5356,5356,0,0,0,0,4
2606,p1507,20140915,5444,5374,5386,5424,5386,5424,5404,50,30,4,216200,6
2699,p1508,20140915,5342,5342,5440,5440,5352,5384,5376,42,34,52,2796200,2
982,p1410,20140916,5194,5194,0,0,0,5194,5194,0,0,0,0,0
1176,p1411,20140916,5232,5232,5196,5348,5196,5234,5264,2,32,10,526480,2
1388,p1412,20140916,5170,5170,5210,5274,5198,5254,5240,84,70,26,1362400,10
1610,p1501,20140916,5240,5212,5216,5298,5188,5226,5236,14,24,733594,38416124240,668376
1824,p1502,20140916,5290,5290,5282,5354,5250,5288,5282,-2,-8,26,1373760,4
2022,p1503,20140916,5296,5324,5342,5366,5264,5362,5322,38,-2,18,958040,20
2199,p1504,20140916,5346,5346,5392,5512,5272,5512,5384,166,38,22,1184680,12
2355,p1505,20140916,5402,5374,5388,5464,5360,5392,5408,18,34,114216,6178536120,128176
2491,p1506,20140916,5356,5356,5400,5418,5372,5418,5390,62,34,8,431280,6
2607,p1507,20140916,5424,5404,5418,5452,5404,5434,5422,30,18,18,976080,4
2700,p1508,20140916,5384,5376,5458,5458,5360,5414,5408,38,32,18,973640,2
2772,p1509,20140916,5366,5366,5572,5572,5486,5494,5514,128,148,708,39043440,304
983,p1410,20140917,5194,5194,0,0,0,5194,5194,0,0,0,0,0
1177,p1411,20140917,5234,5264,0,0,0,5264,5264,0,0,0,0,2
1389,p1412,20140917,5254,5240,0,0,0,5240,5240,0,0,0,0,10
1611,p1501,20140917,5226,5236,5228,5248,5212,5238,5232,2,-4,438936,22966027640,689882
1825,p1502,20140917,5288,5282,0,0,0,5282,5282,0,0,0,0,4
2023,p1503,20140917,5362,5322,0,0,0,5322,5322,0,0,0,0,20
2200,p1504,20140917,5512,5384,5422,5422,5402,5404,5410,20,26,28,1515280,10
2356,p1505,20140917,5392,5408,5400,5416,5380,5402,5398,-6,-10,70302,3795705320,130238
2492,p1506,20140917,5418,5390,5388,5388,5388,5388,5388,-2,-2,2,107760,4
2608,p1507,20140917,5434,5422,0,0,0,5420,5420,-2,-2,0,0,4
2701,p1508,20140917,5414,5408,0,0,0,5408,5408,0,0,0,0,2
2773,p1509,20140917,5494,5514,5506,5510,5486,5498,5498,-16,-16,156,8579360,358
984,p1410,20140918,5194,5194,0,0,0,5194,5194,0,0,0,0,0
1178,p1411,20140918,5264,5264,0,0,0,5264,5264,0,0,0,0,2
1390,p1412,20140918,5240,5240,0,0,0,5240,5240,0,0,0,0,10
1612,p1501,20140918,5238,5232,5258,5288,5250,5278,5268,46,36,654990,34510622960,709142
1826,p1502,20140918,5282,5282,5378,5378,5322,5322,5334,40,52,38,2027320,4
2024,p1503,20140918,5322,5322,5294,5294,5294,5294,5294,-28,-28,2,105880,18
2201,p1504,20140918,5404,5410,0,0,0,5410,5410,0,0,0,0,10
2357,p1505,20140918,5402,5398,5426,5448,5416,5432,5430,34,32,88518,4807804960,129334
2493,p1506,20140918,5388,5388,5436,5436,5436,5436,5436,48,48,2,108720,4
2609,p1507,20140918,5420,5420,5498,5498,5490,5490,5494,70,74,4,219760,6
2702,p1508,20140918,5408,5408,5436,5436,5436,5436,5436,28,28,2,108720,2
2774,p1509,20140918,5498,5498,5518,5530,5494,5496,5504,-2,6,698,38425440,818
985,p1410,20140919,5194,5194,0,0,0,5194,5194,0,0,0,0,0
1179,p1411,20140919,5264,5264,0,0,0,5264,5264,0,0,0,0,2
1391,p1412,20140919,5240,5240,0,0,0,5240,5240,0,0,0,0,10
1613,p1501,20140919,5278,5268,5252,5262,5182,5196,5224,-72,-44,557042,29107761040,658036
1827,p1502,20140919,5322,5334,5306,5384,5306,5306,5330,-28,-4,8,426520,6
2025,p1503,20140919,5294,5294,5308,5354,5308,5354,5334,60,40,12,640160,16
2202,p1504,20140919,5410,5410,5418,5418,5418,5418,5418,8,8,2,108360,10
2358,p1505,20140919,5432,5430,5408,5418,5336,5340,5372,-90,-58,72992,3921235160,129884
2494,p1506,20140919,5436,5436,0,0,0,5410,5410,-26,-26,0,0,4
2610,p1507,20140919,5490,5494,0,0,0,5472,5472,-22,-22,0,0,6
2703,p1508,20140919,5436,5436,0,0,0,5436,5436,0,0,0,0,2
2775,p1509,20140919,5496,5504,5486,5486,5400,5404,5432,-100,-72,738,40094880,942
986,p1410,20140922,5194,5194,0,0,0,5194,5194,0,0,0,0,0
1180,p1411,20140922,5264,5264,5076,5294,5076,5294,5182,30,-82,10,518320,2
1392,p1412,20140922,5240,5240,5236,5236,5236,5236,5236,-4,-4,2,104720,8
1614,p1501,20140922,5196,5224,5172,5198,5062,5076,5134,-148,-90,751222,38572245920,533222
1828,p1502,20140922,5306,5330,5304,5304,5150,5164,5238,-166,-92,16,838240,4
2026,p1503,20140922,5354,5334,0,0,0,5252,5252,-82,-82,0,0,16
2203,p1504,20140922,5418,5418,5226,5232,5218,5232,5224,-186,-194,12,626880,8
2359,p1505,20140922,5340,5372,5330,5342,5194,5208,5256,-164,-116,133188,7001521080,128698
2495,p1506,20140922,5410,5410,0,0,0,5294,5294,-116,-116,0,0,4
2611,p1507,20140922,5472,5472,0,0,0,5354,5354,-118,-118,0,0,6
2704,p1508,20140922,5436,5436,0,0,0,5320,5320,-116,-116,0,0,2
2776,p1509,20140922,5404,5432,5396,5402,5280,5290,5310,-142,-122,1702,90406040,1226
987,p1410,20140923,5194,5194,0,0,0,5194,5194,0,0,0,0,0
1181,p1411,20140923,5294,5182,0,0,0,5182,5182,0,0,0,0,2
1393,p1412,20140923,5236,5236,5204,5204,5082,5082,5122,-154,-114,6,307360,8
1615,p1501,20140923,5076,5134,5084,5138,5036,5116,5084,-18,-50,1180588,60032289480,522302
1829,p1502,20140923,5164,5238,0,0,0,5230,5230,-8,-8,0,0,4
2027,p1503,20140923,5252,5252,0,0,0,5252,5252,0,0,0,0,16
2204,p1504,20140923,5232,5224,0,0,0,5224,5224,0,0,0,0,8
2360,p1505,20140923,5208,5256,5206,5260,5172,5244,5224,-12,-32,108394,5664338840,134522
2496,p1506,20140923,5294,5294,5198,5198,5176,5176,5190,-118,-104,6,311440,6
2612,p1507,20140923,5354,5354,5248,5248,5192,5192,5220,-162,-134,4,208800,2
2705,p1508,20140923,5320,5320,0,0,0,5320,5320,0,0,0,0,2
2777,p1509,20140923,5290,5310,5298,5336,5262,5308,5308,-2,-2,1054,55955680,1632
988,p1410,20140924,5194,5194,0,0,0,5194,5194,0,0,0,0,0
1182,p1411,20140924,5182,5182,5264,5264,5264,5264,5264,82,82,2,105280,4
1394,p1412,20140924,5082,5122,5210,5214,5194,5214,5202,92,80,12,624400,8
1616,p1501,20140924,5116,5084,5126,5162,5124,5140,5144,56,60,531248,27335222520,550504
1830,p1502,20140924,5230,5230,0,0,0,5230,5230,0,0,0,0,4
2028,p1503,20140924,5252,5252,0,0,0,5252,5252,0,0,0,0,16
2205,p1504,20140924,5224,5224,0,0,0,5252,5252,28,28,0,0,8
2361,p1505,20140924,5244,5224,5260,5280,5246,5250,5264,26,40,85784,4516882720,148236
2497,p1506,20140924,5176,5190,5262,5262,5258,5258,5260,68,70,4,210400,6
2613,p1507,20140924,5192,5220,0,0,0,5220,5220,0,0,0,0,2
2706,p1508,20140924,5320,5320,0,0,0,5320,5320,0,0,0,0,2
2778,p1509,20140924,5308,5308,5330,5344,5314,5314,5326,6,18,366,19496560,1780
989,p1410,20140925,5194,5194,0,0,0,5194,5194,0,0,0,0,0
1183,p1411,20140925,5264,5264,5266,5266,5266,5266,5266,2,2,4,210640,0
1395,p1412,20140925,5214,5202,5214,5318,5214,5302,5280,100,78,14,739280,4
1617,p1501,20140925,5140,5144,5170,5268,5164,5250,5218,106,74,891632,46531278840,564002
1831,p1502,20140925,5230,5230,5272,5272,5272,5272,5272,42,42,2,105440,2
2029,p1503,20140925,5252,5252,0,0,0,5252,5252,0,0,0,0,16
2206,p1504,20140925,5252,5252,0,0,0,5268,5268,16,16,0,0,8
2362,p1505,20140925,5250,5264,5276,5346,5266,5336,5306,72,42,124268,6594727400,124854
2498,p1506,20140925,5258,5260,5276,5296,5266,5296,5278,36,18,6,316760,6
2614,p1507,20140925,5220,5220,0,0,0,5230,5230,10,10,0,0,2
2707,p1508,20140925,5320,5320,0,0,0,5320,5320,0,0,0,0,2
2779,p1509,20140925,5314,5326,5346,5394,5324,5390,5372,64,46,2554,137235520,3208
990,p1410,20140926,5194,5194,0,0,0,5194,5194,0,0,0,0,0
1184,p1411,20140926,5266,5266,0,0,0,5266,5266,0,0,0,0,0
1396,p1412,20140926,5302,5280,5176,5308,5176,5308,5268,28,-12,18,948320,4
1618,p1501,20140926,5250,5218,5270,5278,5154,5218,5210,0,-8,1219522,63548726560,622920
1832,p1502,20140926,5272,5272,5358,5358,5268,5268,5296,-4,24,16,847360,6
2030,p1503,20140926,5252,5252,0,0,0,5252,5252,0,0,0,0,16
2207,p1504,20140926,5268,5268,0,0,0,5292,5292,24,24,0,0,8
2363,p1505,20140926,5336,5306,5360,5360,5252,5310,5294,4,-12,115776,6131383360,121274
2499,p1506,20140926,5296,5278,5226,5250,5226,5250,5228,-28,-50,46,2405160,46
2615,p1507,20140926,5230,5230,0,0,0,5230,5230,0,0,0,0,2
2708,p1508,20140926,5320,5320,0,0,0,5320,5320,0,0,0,0,2
2780,p1509,20140926,5390,5372,5406,5406,5294,5356,5338,-16,-34,1076,57438840,3554
991,p1410,20140929,5194,5194,0,0,0,5194,5194,0,0,0,0,0
1185,p1411,20140929,5266,5266,0,0,0,5266,5266,0,0,0,0,0
1397,p1412,20140929,5308,5268,5176,5256,5176,5256,5216,-12,-52,4,208640,6
1619,p1501,20140929,5218,5210,5170,5188,5148,5166,5168,-44,-42,486696,25157695720,571194
1833,p1502,20140929,5268,5296,5228,5228,5228,5228,5228,-68,-68,2,104560,4
2031,p1503,20140929,5252,5252,0,0,0,5252,5252,0,0,0,0,16
2208,p1504,20140929,5292,5292,0,0,0,5292,5292,0,0,0,0,8
2364,p1505,20140929,5310,5294,5280,5280,5242,5262,5262,-32,-32,63962,3366310800,119112
2500,p1506,20140929,5250,5228,5236,5240,5236,5240,5238,12,10,42,2200480,10
2616,p1507,20140929,5230,5230,0,0,0,5230,5230,0,0,0,0,2
2709,p1508,20140929,5320,5320,0,0,0,5330,5330,10,10,0,0,2
2781,p1509,20140929,5356,5338,5306,5314,5240,5300,5278,-38,-60,976,51516160,3718
992,p1410,20140930,5194,5194,0,0,0,5194,5194,0,0,0,0,0
1186,p1411,20140930,5266,5266,0,0,0,5266,5266,0,0,0,0,0
1398,p1412,20140930,5256,5216,5214,5310,5192,5310,5252,94,36,32,1681240,4
1620,p1501,20140930,5166,5168,5188,5250,5176,5240,5222,72,54,558414,29162237840,592796
1834,p1502,20140930,5228,5228,0,0,0,5282,5282,54,54,0,0,4
2032,p1503,20140930,5252,5252,0,0,0,5252,5252,0,0,0,0,16
2209,p1504,20140930,5292,5292,0,0,0,5292,5292,0,0,0,0,8
2365,p1505,20140930,5262,5262,5276,5344,5272,5332,5320,70,58,71306,3794902200,117116
2501,p1506,20140930,5240,5238,5442,5442,5250,5310,5316,72,78,26,1382400,6
2617,p1507,20140930,5230,5230,0,0,0,5238,5238,8,8,0,0,2
2710,p1508,20140930,5330,5330,0,0,0,5330,5330,0,0,0,0,2
2782,p1509,20140930,5300,5278,5320,5378,5318,5336,5336,58,58,2282,121783360,5072
993,p1410,20141008,5194,5194,0,0,0,5194,5194,0,0,0,0,0
1187,p1411,20141008,5266,5266,0,0,0,5266,5266,0,0,0,0,0
1399,p1412,20141008,5310,5252,5238,5238,5238,5238,5238,-14,-14,2,104760,4
1621,p1501,20141008,5240,5222,5234,5270,5214,5238,5240,16,18,211470,11083943720,578068
1835,p1502,20141008,5282,5282,0,0,0,5282,5282,0,0,0,0,4
2033,p1503,20141008,5252,5252,0,0,0,5252,5252,0,0,0,0,16
2210,p1504,20141008,5292,5292,5302,5402,5302,5402,5334,110,42,6,320120,6
2366,p1505,20141008,5332,5320,5330,5354,5304,5338,5332,18,12,38366,2045700200,115548
2502,p1506,20141008,5310,5316,5454,5454,5336,5336,5394,20,78,4,215800,4
2618,p1507,20141008,5238,5238,0,0,0,5238,5238,0,0,0,0,2
2711,p1508,20141008,5330,5330,0,0,0,5330,5330,0,0,0,0,2
2783,p1509,20141008,5336,5336,5340,5368,5324,5330,5332,-6,-4,3478,185513480,7696
994,p1410,20141009,5194,5194,0,0,0,5194,5194,0,0,0,0,0
1188,p1411,20141009,5266,5266,0,0,0,5266,5266,0,0,0,0,0
1400,p1412,20141009,5238,5238,5320,5320,5264,5264,5288,26,50,6,317320,4
1622,p1501,20141009,5238,5240,5242,5284,5218,5276,5240,36,0,475438,24916697000,601562
1836,p1502,20141009,5282,5282,0,0,0,5298,5298,16,16,0,0,4
2034,p1503,20141009,5252,5252,0,0,0,5252,5252,0,0,0,0,16
2211,p1504,20141009,5402,5334,0,0,0,5334,5334,0,0,0,0,6
2367,p1505,20141009,5338,5332,5340,5374,5322,5370,5338,38,6,74198,3961431480,122428
2503,p1506,20141009,5336,5394,0,0,0,5394,5394,0,0,0,0,4
2619,p1507,20141009,5238,5238,0,0,0,5242,5242,4,4,0,0,2
2712,p1508,20141009,5330,5330,0,0,0,5330,5330,0,0,0,0,2
2784,p1509,20141009,5330,5332,5346,5360,5310,5360,5324,28,-8,6006,319827040,10618
995,p1410,20141010,5194,5194,0,0,0,5194,5194,0,0,0,0,0
1189,p1411,20141010,5266,5266,0,0,0,5266,5266,0,0,0,0,0
1401,p1412,20141010,5264,5288,0,0,0,5288,5288,0,0,0,0,4
1623,p1501,20141010,5276,5240,5260,5264,5194,5230,5230,-10,-10,809672,42346311240,626804
1837,p1502,20141010,5298,5298,0,0,0,5298,5298,0,0,0,0,4
2035,p1503,20141010,5252,5252,0,0,0,5252,5252,0,0,0,0,16
2212,p1504,20141010,5334,5334,5324,5324,5322,5322,5322,-12,-12,14,745240,4
2368,p1505,20141010,5370,5338,5368,5368,5274,5302,5316,-36,-22,112208,5965141160,146520
2504,p1506,20141010,5394,5394,0,0,0,5394,5394,0,0,0,0,4
2620,p1507,20141010,5242,5242,5386,5386,5232,5232,5308,-10,66,4,212360,2
2713,p1508,20141010,5330,5330,0,0,0,5330,5330,0,0,0,0,2
2785,p1509,20141010,5360,5324,5354,5370,5260,5284,5312,-40,-12,5600,297574760,12422
996,p1410,20141013,5194,5194,0,0,0,5194,5194,0,0,0,0,0
1190,p1411,20141013,5266,5266,0,0,0,5266,5266,0,0,0,0,0
1402,p1412,20141013,5288,5288,5202,5252,5114,5236,5180,-52,-108,46,2382920,2
1624,p1501,20141013,5230,5230,5222,5228,5184,5218,5206,-12,-24,888604,46273721680,653384
1838,p1502,20141013,5298,5298,5270,5308,5258,5262,5284,-36,-14,46,2431000,8
2036,p1503,20141013,5252,5252,0,0,0,5252,5252,0,0,0,0,16
2213,p1504,20141013,5322,5322,0,0,0,5322,5322,0,0,0,0,4
2369,p1505,20141013,5302,5316,5270,5302,5260,5264,5280,-52,-36,113332,5984252120,154920
2505,p1506,20141013,5394,5394,0,0,0,5316,5316,-78,-78,0,0,4
2621,p1507,20141013,5232,5308,0,0,0,5308,5308,0,0,0,0,2
2714,p1508,20141013,5330,5330,0,0,0,5294,5294,-36,-36,0,0,2
2786,p1509,20141013,5284,5312,5282,5292,5248,5262,5272,-50,-40,4042,213138640,12280
997,p1410,20141014,5194,5194,0,0,0,5194,5194,0,0,0,0,0
1191,p1411,20141014,5266,5266,0,0,0,5266,5266,0,0,0,0,0
1403,p1412,20141014,5236,5180,5194,5254,5182,5254,5218,74,38,16,834880,6
1625,p1501,20141014,5218,5206,5200,5276,5184,5264,5238,58,32,671528,35177013000,658488
1839,p1502,20141014,5262,5284,5254,5324,5230,5324,5266,40,-18,26,1369560,10
2037,p1503,20141014,5252,5252,5274,5348,5274,5348,5302,96,50,6,318120,20
2214,p1504,20141014,5322,5322,0,0,0,5322,5322,0,0,0,0,4
2370,p1505,20141014,5264,5280,5250,5300,5230,5294,5276,14,-4,113530,5989963800,159480
2506,p1506,20141014,5316,5316,0,0,0,5316,5316,0,0,0,0,4
2622,p1507,20141014,5308,5308,0,0,0,5308,5308,0,0,0,0,2
2715,p1508,20141014,5294,5294,0,0,0,5294,5294,0,0,0,0,2
2787,p1509,20141014,5262,5272,5252,5292,5230,5286,5264,14,-8,2966,156188160,12632
998,p1410,20141015,5194,5194,0,0,0,5194,5194,0,0,0,0,0
1192,p1411,20141015,5266,5266,0,0,0,5266,5266,0,0,0,0,0
1404,p1412,20141015,5254,5218,5300,5300,5230,5282,5266,64,48,28,1474920,2
1626,p1501,20141015,5264,5238,5258,5324,5222,5244,5256,6,18,1282604,67429929280,630058
1840,p1502,20141015,5324,5266,5276,5316,5276,5298,5290,32,24,8,423320,12
2038,p1503,20141015,5348,5302,5340,5340,5274,5286,5310,-16,8,138,7329640,48
2215,p1504,20141015,5322,5322,0,0,0,5330,5330,8,8,0,0,4
2371,p1505,20141015,5294,5276,5290,5310,5212,5226,5246,-50,-30,147420,7734358000,174830
2507,p1506,20141015,5316,5316,5342,5342,5336,5336,5338,20,22,4,213560,4
2623,p1507,20141015,5308,5308,0,0,0,5308,5308,0,0,0,0,2
2716,p1508,20141015,5294,5294,0,0,0,5294,5294,0,0,0,0,2
2788,p1509,20141015,5286,5264,5286,5306,5216,5240,5250,-24,-14,5852,307310120,13746
999,p1410,20141016,5194,5194,0,0,0,5194,5194,0,0,0,0,0
1193,p1411,20141016,5266,5266,0,0,0,5266,5266,0,0,0,0,0
1405,p1412,20141016,5282,5266,0,0,0,5266,5266,0,0,0,0,2
1627,p1501,20141016,5244,5256,5220,5232,5180,5188,5208,-68,-48,650980,33914616080,598040
1841,p1502,20141016,5298,5290,0,0,0,5238,5238,-52,-52,0,0,12
2039,p1503,20141016,5286,5310,5262,5262,5246,5246,5250,-64,-60,6,315080,46
2216,p1504,20141016,5330,5330,0,0,0,5286,5286,-44,-44,0,0,4
2372,p1505,20141016,5226,5246,5202,5230,5166,5172,5200,-74,-46,114358,5947532640,179604
2508,p1506,20141016,5336,5338,0,0,0,5244,5244,-94,-94,0,0,4
2624,p1507,20141016,5308,5308,0,0,0,5248,5248,-60,-60,0,0,2
2717,p1508,20141016,5294,5294,0,0,0,5242,5242,-52,-52,0,0,2
2789,p1509,20141016,5240,5250,5202,5220,5170,5192,5200,-58,-50,12196,634316760,15468
1000,p1410,20141017,5194,5194,0,0,0,5194,5194,0,0,0,0,0
1194,p1411,20141017,5266,5266,0,0,0,5266,5266,0,0,0,0,0
1406,p1412,20141017,5266,5266,0,0,0,5266,5266,0,0,0,0,2
1628,p1501,20141017,5188,5208,5170,5236,5158,5190,5200,-18,-8,999212,51966234040,562374
1842,p1502,20141017,5238,5238,5236,5236,5236,5236,5236,-2,-2,4,209440,8
2040,p1503,20141017,5246,5250,5218,5306,5218,5264,5252,14,2,8,420280,46
2217,p1504,20141017,5286,5286,0,0,0,5286,5286,0,0,0,0,4
2373,p1505,20141017,5172,5200,5188,5248,5156,5224,5218,24,18,237528,12397922440,174564
2509,p1506,20141017,5244,5244,0,0,0,5244,5244,0,0,0,0,4
2625,p1507,20141017,5248,5248,0,0,0,5248,5248,0,0,0,0,2
2718,p1508,20141017,5242,5242,0,0,0,5242,5242,0,0,0,0,2
2790,p1509,20141017,5192,5200,5190,5248,5178,5222,5222,22,22,11336,592168560,18820
1001,p1410,20141020,5194,5194,0,0,0,5194,5194,0,0,0,0,0
1195,p1411,20141020,5266,5266,0,0,0,5266,5266,0,0,0,0,0
1407,p1412,20141020,5266,5266,5358,5358,5154,5204,5238,-62,-28,6,314320,2
1629,p1501,20141020,5190,5200,5200,5208,5128,5138,5160,-62,-40,514696,26565432840,554534
1843,p1502,20141020,5236,5236,0,0,0,5206,5206,-30,-30,0,0,8
2041,p1503,20141020,5264,5252,5232,5232,5144,5218,5206,-34,-46,30,1562160,26
2218,p1504,20141020,5286,5286,5286,5286,5090,5090,5210,-196,-76,26,1354640,10
2374,p1505,20141020,5224,5218,5236,5236,5168,5174,5194,-44,-24,112688,5854962800,183334
2510,p1506,20141020,5244,5244,5248,5248,5202,5202,5224,-42,-20,4,209000,4
2626,p1507,20141020,5248,5248,0,0,0,5248,5248,0,0,0,0,2
2719,p1508,20141020,5242,5242,5130,5170,5130,5170,5150,-72,-92,12,618000,2
2791,p1509,20141020,5222,5222,5226,5232,5184,5192,5202,-30,-20,8182,425672600,16802
1002,p1410,20141021,5194,5194,0,0,0,5194,5194,0,0,0,0,0
1196,p1411,20141021,5266,5266,0,0,0,5266,5266,0,0,0,0,0
1408,p1412,20141021,5204,5238,5198,5198,5136,5166,5152,-72,-86,20,1030400,2
1630,p1501,20141021,5138,5160,5142,5160,5108,5118,5134,-42,-26,533512,27394547080,543736
1844,p1502,20141021,5206,5206,5208,5208,5208,5208,5208,2,2,2,104160,6
2042,p1503,20141021,5218,5206,5224,5224,5224,5224,5224,18,18,2,104480,24
2219,p1504,20141021,5090,5210,0,0,0,5180,5180,-30,-30,0,0,10
2375,p1505,20141021,5174,5194,5170,5176,5128,5132,5154,-62,-40,146884,7570971040,183976
2511,p1506,20141021,5202,5224,0,0,0,5196,5196,-28,-28,0,0,4
2627,p1507,20141021,5248,5248,0,0,0,5248,5248,0,0,0,0,2
2720,p1508,20141021,5170,5150,0,0,0,5112,5112,-38,-38,0,0,2
2792,p1509,20141021,5192,5202,5188,5192,5164,5166,5178,-36,-24,13296,688687720,14522
1197,p1411,20141022,5266,5266,0,0,0,5266,5266,0,0,0,0,0
1409,p1412,20141022,5166,5152,5116,5162,5116,5162,5138,10,-14,4,205560,2
1631,p1501,20141022,5118,5134,5124,5144,5110,5140,5128,6,-6,556062,28516763360,511712
1845,p1502,20141022,5208,5208,5132,5182,5132,5160,5152,-48,-56,26,1339600,4
2043,p1503,20141022,5224,5224,0,0,0,5224,5224,0,0,0,0,24
2220,p1504,20141022,5180,5180,0,0,0,5180,5180,0,0,0,0,10
2376,p1505,20141022,5132,5154,5128,5172,5128,5158,5152,4,-2,87576,4513027000,179020
2512,p1506,20141022,5196,5196,0,0,0,5196,5196,0,0,0,0,4
2628,p1507,20141022,5248,5248,0,0,0,5248,5248,0,0,0,0,2
2721,p1508,20141022,5112,5112,0,0,0,5112,5112,0,0,0,0,2
2793,p1509,20141022,5166,5178,5166,5188,5166,5180,5176,2,-2,4244,219724440,13796
2844,p1510,20141022,5200,5200,0,0,0,5200,5200,0,0,0,0,0
1198,p1411,20141023,5266,5266,0,0,0,5266,5266,0,0,0,0,0
1410,p1412,20141023,5162,5138,0,0,0,5140,5140,2,2,0,0,2
1632,p1501,20141023,5140,5128,5158,5196,5150,5170,5166,42,38,600892,31050996520,504342
1846,p1502,20141023,5160,5152,5164,5164,5164,5164,5164,12,12,2,103280,6
2044,p1503,20141023,5224,5224,0,0,0,5224,5224,0,0,0,0,24
2221,p1504,20141023,5180,5180,5194,5194,5194,5194,5194,14,14,2,103880,8
2377,p1505,20141023,5158,5152,5180,5208,5162,5206,5186,54,34,113380,5881713120,175720
2513,p1506,20141023,5196,5196,5220,5264,5218,5240,5232,44,36,10,523240,2
2629,p1507,20141023,5248,5248,5248,5248,5168,5180,5220,-68,-28,18,939760,2
2722,p1508,20141023,5112,5112,0,0,0,5178,5178,66,66,0,0,2
2794,p1509,20141023,5180,5176,5190,5220,5182,5216,5200,40,24,5664,294590720,15156
2845,p1510,20141023,5200,5200,5150,5238,5140,5208,5186,8,-14,12,622480,0
1199,p1411,20141024,5266,5266,0,0,0,5266,5266,0,0,0,0,0
1411,p1412,20141024,5140,5140,0,0,0,5174,5174,34,34,0,0,2
1633,p1501,20141024,5170,5166,5170,5206,5168,5178,5182,12,16,449324,23286787320,465016
1847,p1502,20141024,5164,5164,0,0,0,5164,5164,0,0,0,0,6
2045,p1503,20141024,5224,5224,0,0,0,5224,5224,0,0,0,0,24
2222,p1504,20141024,5194,5194,0,0,0,5194,5194,0,0,0,0,8
2378,p1505,20141024,5206,5186,5206,5246,5200,5218,5222,32,36,146368,7645389400,185048
2514,p1506,20141024,5240,5232,5320,5320,5320,5320,5320,88,88,2,106400,4
2630,p1507,20141024,5180,5220,0,0,0,5220,5220,0,0,0,0,2
2723,p1508,20141024,5178,5178,0,0,0,5178,5178,0,0,0,0,2
2795,p1509,20141024,5216,5200,5222,5268,5216,5234,5236,34,36,7966,417132200,17408
2846,p1510,20141024,5208,5186,5270,5344,5164,5164,5256,-22,70,8,420520,0
1200,p1411,20141027,5266,5266,0,0,0,5266,5266,0,0,0,0,0
1412,p1412,20141027,5174,5174,0,0,0,5174,5174,0,0,0,0,2
1634,p1501,20141027,5178,5182,5172,5180,5120,5140,5152,-42,-30,289706,14926186840,430748
1848,p1502,20141027,5164,5164,5200,5200,5134,5186,5176,22,12,10,517600,4
2046,p1503,20141027,5224,5224,5188,5188,5188,5188,5188,-36,-36,2,103760,26
2223,p1504,20141027,5194,5194,5184,5188,5180,5188,5184,-6,-10,38,1969960,8
2379,p1505,20141027,5218,5222,5216,5226,5168,5182,5190,-40,-32,105674,5485091040,193532
2515,p1506,20141027,5320,5320,5274,5274,5182,5186,5214,-134,-106,6,312840,4
2631,p1507,20141027,5220,5220,0,0,0,5220,5220,0,0,0,0,2
2724,p1508,20141027,5178,5178,0,0,0,5178,5178,0,0,0,0,2
2796,p1509,20141027,5234,5236,5230,5240,5190,5194,5204,-42,-32,11910,619980000,19786
2847,p1510,20141027,5164,5256,5298,5338,5220,5234,5272,-22,16,8,421800,2
1201,p1411,20141028,5266,5266,0,0,0,5266,5266,0,0,0,0,0
1413,p1412,20141028,5174,5174,5130,5318,5130,5318,5224,144,50,4,208960,2
1635,p1501,20141028,5140,5152,5130,5152,5114,5150,5134,-2,-18,277966,14271167400,421522
1849,p1502,20141028,5186,5176,0,0,0,5176,5176,0,0,0,0,4
2047,p1503,20141028,5188,5188,0,0,0,5188,5188,0,0,0,0,26
2224,p1504,20141028,5188,5184,5186,5186,5144,5148,5160,-36,-24,10,516160,8
2380,p1505,20141028,5182,5190,5170,5208,5166,5202,5188,12,-2,94456,4902222960,201908
2516,p1506,20141028,5186,5214,0,0,0,5212,5212,-2,-2,0,0,4
2632,p1507,20141028,5220,5220,0,0,0,5218,5218,-2,-2,0,0,2
2725,p1508,20141028,5178,5178,0,0,0,5178,5178,0,0,0,0,2
2797,p1509,20141028,5194,5204,5192,5224,5186,5216,5202,12,-2,4242,220726720,19546
2848,p1510,20141028,5234,5272,5228,5228,5228,5228,5228,-44,-44,2,104560,2
1202,p1411,20141029,5266,5266,0,0,0,5266,5266,0,0,0,0,0
1414,p1412,20141029,5318,5224,0,0,0,5224,5224,0,0,0,0,2
1636,p1501,20141029,5150,5134,5178,5298,5166,5294,5212,160,78,944372,49238239200,456898
1850,p1502,20141029,5176,5176,5226,5300,5148,5266,5248,90,72,14,734840,4
2048,p1503,20141029,5188,5188,5248,5266,5222,5244,5244,56,56,18,944200,26
2225,p1504,20141029,5148,5160,5202,5290,5202,5290,5246,130,86,4,209840,8
2381,p1505,20141029,5202,5188,5248,5346,5226,5344,5268,156,80,312296,16455464000,254574
2517,p1506,20141029,5212,5212,0,0,0,5292,5292,80,80,0,0,4
2633,p1507,20141029,5218,5218,0,0,0,5242,5242,24,24,0,0,2
2726,p1508,20141029,5178,5178,0,0,0,5256,5256,78,78,0,0,2
2798,p1509,20141029,5216,5202,5260,5364,5244,5360,5298,158,96,8328,441301080,21840
2849,p1510,20141029,5228,5228,0,0,0,5292,5292,64,64,0,0,2
1203,p1411,20141030,5266,5266,0,0,0,5266,5266,0,0,0,0,0
1415,p1412,20141030,5224,5224,5324,5324,5324,5324,5324,100,100,2,106480,0
1637,p1501,20141030,5294,5212,5316,5402,5296,5362,5350,150,138,1218258,65182722400,470318
1851,p1502,20141030,5266,5248,5394,5444,5362,5444,5398,196,150,28,1511840,12
2049,p1503,20141030,5244,5244,5338,5338,5288,5288,5324,44,80,8,426040,26
2226,p1504,20141030,5290,5246,0,0,0,5398,5398,152,152,0,0,8
2382,p1505,20141030,5344,5268,5354,5478,5344,5436,5430,168,162,624334,33903252520,291040
2518,p1506,20141030,5292,5292,5368,5498,5368,5498,5450,206,158,38,2071400,20
2634,p1507,20141030,5242,5242,0,0,0,5398,5398,156,156,0,0,2
2727,p1508,20141030,5256,5256,5406,5406,5406,5406,5406,150,150,2,108120,2
2799,p1509,20141030,5360,5298,5382,5508,5366,5476,5468,178,170,27958,1529220440,27212
2850,p1510,20141030,5292,5292,5444,5444,5444,5444,5444,152,152,2,108880,0
1204,p1411,20141031,5266,5266,0,0,0,5266,5266,0,0,0,0,0
1416,p1412,20141031,5324,5324,5264,5346,5264,5330,5310,6,-14,100,5310160,4
1638,p1501,20141031,5362,5350,5342,5402,5324,5396,5358,46,8,704750,37761329080,452780
1852,p1502,20141031,5444,5398,5390,5416,5372,5416,5388,18,-10,12,646760,4
2050,p1503,20141031,5288,5324,5424,5426,5352,5384,5390,60,66,50,2695120,26
2227,p1504,20141031,5398,5398,0,0,0,5464,5464,66,66,0,0,8
2383,p1505,20141031,5436,5430,5426,5520,5390,5512,5454,82,24,540676,29493939360,335246
2519,p1506,20141031,5498,5450,5466,5504,5410,5504,5468,54,18,20,1093760,20
2635,p1507,20141031,5398,5398,5476,5520,5452,5500,5486,102,88,8,438960,6
2728,p1508,20141031,5406,5406,0,0,0,5448,5448,42,42,0,0,2
2800,p1509,20141031,5476,5468,5466,5554,5430,5552,5488,84,20,17166,942281040,32364
2851,p1510,20141031,5444,5444,5548,5548,5416,5416,5482,-28,38,4,219280,0
1205,p1411,20141103,5266,5266,0,0,0,5266,5266,0,0,0,0,0
1417,p1412,20141103,5330,5310,0,0,0,5310,5310,0,0,0,0,4
1639,p1501,20141103,5396,5358,5374,5430,5366,5394,5398,36,40,779432,42086272280,416770
1853,p1502,20141103,5416,5388,0,0,0,5388,5388,0,0,0,0,4
2051,p1503,20141103,5384,5390,5396,5396,5396,5396,5396,6,6,2,107920,26
2228,p1504,20141103,5464,5464,0,0,0,5470,5470,6,6,0,0,8
2384,p1505,20141103,5512,5454,5480,5538,5460,5480,5496,26,42,570128,31340261920,343106
2520,p1506,20141103,5504,5468,0,0,0,5470,5470,2,2,0,0,20
2636,p1507,20141103,5500,5486,0,0,0,5502,5502,16,16,0,0,6
2729,p1508,20141103,5448,5448,0,0,0,5448,5448,0,0,0,0,2
2801,p1509,20141103,5552,5488,5530,5574,5508,5522,5536,34,48,10200,564819600,32178
2852,p1510,20141103,5416,5482,5634,5634,5530,5530,5582,48,100,4,223280,0
1206,p1411,20141104,5266,5266,0,0,0,5266,5266,0,0,0,0,0
1418,p1412,20141104,5310,5310,0,0,0,5310,5310,0,0,0,0,4
1640,p1501,20141104,5394,5398,5410,5422,5314,5338,5368,-60,-30,629582,33799941520,365366
1854,p1502,20141104,5388,5388,0,0,0,5388,5388,0,0,0,0,4
2052,p1503,20141104,5396,5396,5394,5396,5364,5364,5384,-32,-12,6,323080,22
2229,p1504,20141104,5470,5470,0,0,0,5470,5470,0,0,0,0,8
2385,p1505,20141104,5480,5496,5506,5514,5396,5424,5452,-72,-44,511480,27886928480,336446
2521,p1506,20141104,5470,5470,5502,5554,5502,5508,5514,38,44,12,661760,14
2637,p1507,20141104,5502,5502,5498,5502,5490,5490,5496,-12,-6,10,549760,6
2730,p1508,20141104,5448,5448,0,0,0,5448,5448,0,0,0,0,2
2802,p1509,20141104,5522,5536,5546,5556,5430,5458,5482,-78,-54,11076,607287000,34466
2853,p1510,20141104,5530,5582,0,0,0,5578,5578,-4,-4,0,0,0
1207,p1411,20141105,5266,5266,0,0,0,5266,5266,0,0,0,0,0
1419,p1412,20141105,5310,5310,0,0,0,5310,5310,0,0,0,0,4
1641,p1501,20141105,5338,5368,5316,5316,5176,5178,5264,-190,-104,730156,38448331480,290814
1855,p1502,20141105,5388,5388,5248,5248,5248,5248,5248,-140,-140,2,104960,6
2053,p1503,20141105,5364,5384,5380,5380,5362,5362,5376,-22,-8,16,860440,22
2230,p1504,20141105,5470,5470,5382,5384,5290,5290,5340,-180,-130,22,1174880,8
2386,p1505,20141105,5424,5452,5370,5388,5238,5242,5326,-210,-126,792424,42217495440,315640
2522,p1506,20141105,5508,5514,5394,5394,5360,5364,5368,-150,-146,12,644200,14
2638,p1507,20141105,5490,5496,5416,5416,5416,5416,5416,-80,-80,2,108320,4
2731,p1508,20141105,5448,5448,0,0,0,5370,5370,-78,-78,0,0,2
2803,p1509,20141105,5458,5482,5410,5416,5264,5266,5354,-216,-128,15374,823384200,34912
2854,p1510,20141105,5578,5578,0,0,0,5448,5448,-130,-130,0,0,0
1208,p1411,20141106,5266,5266,0,0,0,5266,5266,0,0,0,0,0
1420,p1412,20141106,5310,5310,5192,5192,5102,5156,5150,-154,-160,16,824000,0
1642,p1501,20141106,5178,5264,5180,5240,5164,5220,5204,-44,-60,517010,26911741640,266752
1856,p1502,20141106,5248,5248,5250,5250,5250,5250,5250,2,2,2,105000,6
2054,p1503,20141106,5362,5376,5240,5288,5240,5280,5264,-96,-112,10,526480,18
2231,p1504,20141106,5290,5340,0,0,0,5230,5230,-110,-110,0,0,8
2387,p1505,20141106,5242,5326,5268,5318,5230,5296,5280,-30,-46,761432,40208633160,282214
2523,p1506,20141106,5364,5368,5270,5294,5270,5294,5286,-74,-82,12,634320,8
2639,p1507,20141106,5416,5416,0,0,0,5334,5334,-82,-82,0,0,4
2732,p1508,20141106,5370,5370,0,0,0,5370,5370,0,0,0,0,2
2804,p1509,20141106,5266,5354,5260,5334,5250,5318,5294,-36,-60,26412,1398289480,29668
2855,p1510,20141106,5448,5448,5346,5360,5278,5358,5314,-90,-134,20,1062840,2
1209,p1411,20141107,5266,5266,0,0,0,5266,5266,0,0,0,0,0
1421,p1412,20141107,5156,5150,5206,5206,5156,5156,5180,6,30,4,207240,0
1643,p1501,20141107,5220,5204,5176,5280,5176,5258,5230,54,26,416944,21808076520,246826
1857,p1502,20141107,5250,5250,5270,5276,5240,5240,5260,-10,10,194,10204400,4
2055,p1503,20141107,5280,5264,5280,5368,5264,5368,5316,104,52,54,2871480,18
2232,p1504,20141107,5230,5230,5300,5402,5268,5318,5350,88,120,16,856000,10
2388,p1505,20141107,5296,5280,5260,5368,5252,5336,5304,56,24,793754,42101005200,294780
2524,p1506,20141107,5294,5286,5316,5418,5284,5358,5344,72,58,8,427520,8
2640,p1507,20141107,5334,5334,0,0,0,5350,5350,16,16,0,0,4
2733,p1508,20141107,5370,5370,5364,5364,5274,5274,5318,-96,-52,4,212760,2
2805,p1509,20141107,5318,5294,5298,5384,5280,5354,5322,60,28,17756,945141200,30470
2856,p1510,20141107,5358,5314,0,0,0,5314,5314,0,0,0,0,2
1210,p1411,20141110,5266,5266,0,0,0,5266,5266,0,0,0,0,0
1422,p1412,20141110,5156,5180,5130,5150,5130,5150,5140,-30,-40,4,205600,0
1644,p1501,20141110,5258,5230,5220,5282,5206,5280,5238,50,8,331400,17359899360,215050
1858,p1502,20141110,5240,5260,0,0,0,5260,5260,0,0,0,0,4
2056,p1503,20141110,5368,5316,5294,5382,5292,5352,5348,36,32,14,748720,18
2233,p1504,20141110,5318,5350,5310,5310,5310,5310,5310,-40,-40,2,106200,8
2389,p1505,20141110,5336,5304,5300,5368,5280,5366,5320,62,16,764366,40667342240,283248
2525,p1506,20141110,5358,5344,5298,5378,5288,5344,5310,0,-34,202,10726720,16
2641,p1507,20141110,5350,5350,0,0,0,5360,5360,10,10,0,0,4
2734,p1508,20141110,5274,5318,0,0,0,5286,5286,-32,-32,0,0,2
2806,p1509,20141110,5354,5322,5314,5394,5306,5392,5336,70,14,20816,1111073760,31858
2857,p1510,20141110,5314,5314,0,0,0,5326,5326,12,12,0,0,2
1211,p1411,20141111,5266,5266,0,0,0,5266,5266,0,0,0,0,0
1423,p1412,20141111,5150,5140,0,0,0,5140,5140,0,0,0,0,0
1645,p1501,20141111,5280,5238,5306,5338,5250,5270,5294,32,56,275640,14593243480,203684
1859,p1502,20141111,5260,5260,5338,5338,5274,5316,5300,56,40,32,1696320,2
2057,p1503,20141111,5352,5348,5402,5418,5306,5344,5364,-4,16,12,643840,18
2234,p1504,20141111,5310,5310,5498,5498,5334,5334,5404,24,94,16,864880,4
2390,p1505,20141111,5366,5320,5388,5426,5324,5342,5374,22,54,838286,45061913480,303394
2526,p1506,20141111,5344,5310,5344,5430,5344,5430,5386,120,76,4,215480,14
2642,p1507,20141111,5360,5360,0,0,0,5360,5360,0,0,0,0,4
2735,p1508,20141111,5286,5286,0,0,0,5360,5360,74,74,0,0,2
2807,p1509,20141111,5392,5336,5402,5444,5346,5364,5386,28,50,15028,809664360,32926
2858,p1510,20141111,5326,5326,5498,5498,5498,5498,5498,172,172,2,109960,4
1212,p1411,20141112,5266,5266,0,0,0,5266,5266,0,0,0,0,0
1424,p1412,20141112,5140,5140,0,0,0,5140,5140,0,0,0,0,0
1646,p1501,20141112,5270,5294,5306,5352,5304,5328,5332,34,38,236172,12594485360,184986
1860,p1502,20141112,5316,5300,0,0,0,5300,5300,0,0,0,0,2
2058,p1503,20141112,5344,5364,5440,5440,5440,5440,5440,76,76,2,108800,18
2235,p1504,20141112,5334,5404,0,0,0,5480,5480,76,76,0,0,4
2391,p1505,20141112,5342,5374,5380,5450,5380,5420,5420,46,46,941992,51058033520,296988
2527,p1506,20141112,5430,5386,5420,5538,5420,5478,5454,92,68,74,4036320,12
2643,p1507,20141112,5360,5360,5430,5430,5430,5430,5430,70,70,2,108600,4
2736,p1508,20141112,5360,5360,5420,5498,5420,5498,5458,138,98,4,218360,4
2808,p1509,20141112,5364,5386,5408,5478,5404,5446,5448,60,62,18626,1014769840,36252
2859,p1510,20141112,5498,5498,0,0,0,5560,5560,62,62,0,0,4
1213,p1411,20141113,5266,5266,0,0,0,5266,5266,0,0,0,0,0
1425,p1412,20141113,5140,5140,0,0,0,5140,5140,0,0,0,0,0
1647,p1501,20141113,5328,5332,5318,5346,5272,5296,5308,-36,-24,231290,12278487920,178350
1861,p1502,20141113,5300,5300,0,0,0,5300,5300,0,0,0,0,2
2059,p1503,20141113,5440,5440,0,0,0,5440,5440,0,0,0,0,18
2236,p1504,20141113,5480,5480,0,0,0,5440,5440,-40,-40,0,0,4
2392,p1505,20141113,5420,5420,5410,5442,5348,5374,5394,-46,-26,985602,53171195400,314742
2528,p1506,20141113,5478,5454,5422,5510,5416,5436,5446,-18,-8,32,1742840,14
2644,p1507,20141113,5430,5430,0,0,0,5430,5430,0,0,0,0,4
2737,p1508,20141113,5498,5458,0,0,0,5456,5456,-2,-2,0,0,4
2809,p1509,20141113,5446,5448,5442,5470,5364,5390,5394,-58,-54,26394,1424161000,43566
2860,p1510,20141113,5560,5560,0,0,0,5506,5506,-54,-54,0,0,4
1214,p1411,20141114,5266,5266,0,0,0,5266,5266,0,0,0,0,0
1426,p1412,20141114,5140,5140,0,0,0,5140,5140,0,0,0,0,0
1648,p1501,20141114,5296,5308,5286,5308,5260,5262,5282,-46,-26,217558,11492064920,167448
1862,p1502,20141114,5300,5300,5350,5352,5316,5352,5344,52,44,10,534440,8
2060,p1503,20141114,5440,5440,0,0,0,5440,5440,0,0,0,0,18
2237,p1504,20141114,5440,5440,0,0,0,5384,5384,-56,-56,0,0,4
2393,p1505,20141114,5374,5394,5352,5388,5330,5332,5358,-62,-36,1043538,55918510920,336318
2529,p1506,20141114,5436,5446,5354,5414,5354,5370,5386,-76,-60,12,646480,16
2645,p1507,20141114,5430,5430,5364,5420,5364,5372,5384,-58,-46,6,323120,6
2738,p1508,20141114,5456,5456,0,0,0,5422,5422,-34,-34,0,0,4
2810,p1509,20141114,5390,5394,5362,5404,5350,5356,5372,-38,-22,32020,1720482240,38834
2861,p1510,20141114,5506,5506,0,0,0,5484,5484,-22,-22,0,0,4
1427,p1412,20141117,5140,5140,0,0,0,5140,5140,0,0,0,0,0
1649,p1501,20141117,5262,5282,5250,5300,5246,5260,5270,-22,-12,129090,6803721280,155738
1863,p1502,20141117,5352,5344,5280,5294,5280,5288,5284,-56,-60,12,634200,4
2061,p1503,20141117,5440,5440,0,0,0,5380,5380,-60,-60,0,0,18
2238,p1504,20141117,5384,5384,0,0,0,5384,5384,0,0,0,0,4
2394,p1505,20141117,5332,5358,5320,5384,5314,5340,5348,-18,-10,889232,47558825320,344340
2530,p1506,20141117,5370,5386,5396,5418,5354,5400,5394,14,8,56,3020840,16
2646,p1507,20141117,5372,5384,0,0,0,5384,5384,0,0,0,0,6
2739,p1508,20141117,5422,5422,0,0,0,5408,5408,-14,-14,0,0,4
2811,p1509,20141117,5356,5372,5352,5406,5340,5366,5368,-6,-4,30076,1614938400,41780
2862,p1510,20141117,5484,5484,0,0,0,5480,5480,-4,-4,0,0,4
2895,p1511,20141117,5394,5394,0,0,0,5390,5390,-4,-4,0,0,0
1428,p1412,20141118,5140,5140,0,0,0,5140,5140,0,0,0,0,0
1650,p1501,20141118,5260,5270,5266,5278,5206,5248,5242,-22,-28,96306,5049026640,146052
1864,p1502,20141118,5288,5284,5296,5296,5296,5296,5296,12,12,2,105920,2
2062,p1503,20141118,5380,5380,5322,5324,5322,5324,5322,-56,-58,4,212920,18
2239,p1504,20141118,5384,5384,0,0,0,5384,5384,0,0,0,0,4
2395,p1505,20141118,5340,5348,5346,5366,5286,5334,5330,-14,-18,732726,39055687640,346736
2531,p1506,20141118,5400,5394,5364,5396,5364,5374,5378,-20,-16,14,752960,10
2647,p1507,20141118,5384,5384,0,0,0,5384,5384,0,0,0,0,6
2740,p1508,20141118,5408,5408,0,0,0,5384,5384,-24,-24,0,0,4
2812,p1509,20141118,5366,5368,5374,5418,5326,5372,5358,4,-10,39530,2118591080,39162
2863,p1510,20141118,5480,5480,0,0,0,5470,5470,-10,-10,0,0,4
2896,p1511,20141118,5390,5390,0,0,0,5390,5390,0,0,0,0,0
1429,p1412,20141119,5140,5140,0,0,0,5140,5140,0,0,0,0,0
1651,p1501,20141119,5248,5242,5266,5284,5230,5256,5260,14,18,98678,5191008880,146298
1865,p1502,20141119,5296,5296,0,0,0,5314,5314,18,18,0,0,2
2063,p1503,20141119,5324,5322,0,0,0,5322,5322,0,0,0,0,18
2240,p1504,20141119,5384,5384,0,0,0,5402,5402,18,18,0,0,4
2396,p1505,20141119,5334,5330,5366,5378,5318,5344,5352,14,22,856430,45848810560,353274
2532,p1506,20141119,5374,5378,5386,5410,5358,5358,5372,-20,-6,30,1611760,8
2648,p1507,20141119,5384,5384,0,0,0,5378,5378,-6,-6,0,0,6
2741,p1508,20141119,5384,5384,0,0,0,5378,5378,-6,-6,0,0,4
2813,p1509,20141119,5372,5358,5396,5412,5356,5376,5382,18,24,35712,1922196280,45314
2864,p1510,20141119,5470,5470,5370,5370,5370,5370,5370,-100,-100,2,107400,2
2897,p1511,20141119,5390,5390,0,0,0,5390,5390,0,0,0,0,0
1430,p1412,20141120,5140,5140,0,0,0,5140,5140,0,0,0,0,0
1652,p1501,20141120,5256,5260,5254,5260,5194,5202,5232,-58,-28,82514,4318474200,144932
1866,p1502,20141120,5314,5314,0,0,0,5314,5314,0,0,0,0,2
2064,p1503,20141120,5322,5322,5332,5332,5322,5322,5326,0,4,4,213080,18
2241,p1504,20141120,5402,5402,0,0,0,5402,5402,0,0,0,0,4
2397,p1505,20141120,5344,5352,5340,5352,5276,5286,5322,-66,-30,800408,42601648480,391262
2533,p1506,20141120,5358,5372,5356,5368,5286,5320,5346,-52,-26,40,2138760,12
2649,p1507,20141120,5378,5378,0,0,0,5378,5378,0,0,0,0,6
2742,p1508,20141120,5378,5378,0,0,0,5378,5378,0,0,0,0,4
2814,p1509,20141120,5376,5382,5382,5382,5312,5322,5354,-60,-28,31638,1694005000,48536
2865,p1510,20141120,5370,5370,0,0,0,5370,5370,0,0,0,0,2
2898,p1511,20141120,5390,5390,0,0,0,5390,5390,0,0,0,0,0
1431,p1412,20141121,5140,5140,0,0,0,5140,5140,0,0,0,0,0
1653,p1501,20141121,5202,5232,5202,5226,5196,5216,5210,-16,-22,69962,3645645240,140174
1867,p1502,20141121,5314,5314,0,0,0,5314,5314,0,0,0,0,2
2065,p1503,20141121,5322,5326,0,0,0,5326,5326,0,0,0,0,18
2242,p1504,20141121,5402,5402,5402,5616,5264,5316,5384,-86,-18,32,1723480,4
2398,p1505,20141121,5286,5322,5296,5314,5280,5306,5296,-16,-26,708290,37522605360,381202
2534,p1506,20141121,5320,5346,5314,5344,5296,5310,5324,-36,-22,176,9373320,16
2650,p1507,20141121,5378,5378,0,0,0,5378,5378,0,0,0,0,6
2743,p1508,20141121,5378,5378,0,0,0,5378,5378,0,0,0,0,4
2815,p1509,20141121,5322,5354,5328,5352,5320,5340,5338,-14,-16,22474,1199756840,46174
2866,p1510,20141121,5370,5370,0,0,0,5370,5370,0,0,0,0,2
2899,p1511,20141121,5390,5390,0,0,0,5390,5390,0,0,0,0,0
1432,p1412,20141124,5140,5140,0,0,0,5140,5140,0,0,0,0,0
1654,p1501,20141124,5216,5210,5270,5278,5214,5216,5246,6,36,93750,4918748440,134306
1868,p1502,20141124,5314,5314,5312,5312,5268,5268,5290,-46,-24,8,423200,2
2066,p1503,20141124,5326,5326,0,0,0,5326,5326,0,0,0,0,18
2243,p1504,20141124,5316,5384,5338,5338,5338,5338,5338,-46,-46,2,106760,6
2399,p1505,20141124,5306,5296,5356,5368,5306,5306,5344,10,48,1043598,55775750600,400916
2535,p1506,20141124,5310,5324,5358,5372,5358,5364,5364,40,40,38,2038840,12
2651,p1507,20141124,5378,5378,0,0,0,5378,5378,0,0,0,0,6
2744,p1508,20141124,5378,5378,0,0,0,5368,5368,-10,-10,0,0,4
2816,p1509,20141124,5340,5338,5388,5406,5348,5354,5376,16,38,35056,1885264480,47628
2867,p1510,20141124,5370,5370,0,0,0,5370,5370,0,0,0,0,2
2900,p1511,20141124,5390,5390,0,0,0,5390,5390,0,0,0,0,0
1433,p1412,20141125,5140,5140,5032,5342,5032,5234,5202,94,62,18,936480,0
1655,p1501,20141125,5216,5246,5218,5240,5198,5226,5220,-20,-26,62312,3252970360,127704
1869,p1502,20141125,5268,5290,0,0,0,5264,5264,-26,-26,0,0,2
2067,p1503,20141125,5326,5326,5284,5284,5284,5284,5284,-42,-42,2,105680,18
2244,p1504,20141125,5338,5338,5296,5296,5296,5296,5296,-42,-42,2,105920,8
2400,p1505,20141125,5306,5344,5298,5336,5286,5318,5308,-26,-36,751214,39878482880,387818
2536,p1506,20141125,5364,5364,5280,5318,5248,5316,5296,-48,-68,138,7310440,16
2652,p1507,20141125,5378,5378,0,0,0,5376,5376,-2,-2,0,0,6
2745,p1508,20141125,5368,5368,5340,5340,5340,5340,5340,-28,-28,2,106800,2
2817,p1509,20141125,5354,5376,5350,5388,5330,5370,5362,-6,-14,23750,1273575840,43550
2868,p1510,20141125,5370,5370,5442,5442,5342,5342,5392,-28,22,4,215680,2
2901,p1511,20141125,5390,5390,0,0,0,5412,5412,22,22,0,0,0
1434,p1412,20141126,5234,5202,0,0,0,5202,5202,0,0,0,0,0
1656,p1501,20141126,5226,5220,5250,5252,5212,5216,5230,-4,10,53472,2797274880,123932
1870,p1502,20141126,5264,5264,5260,5286,5260,5286,5272,22,8,4,210920,4
2068,p1503,20141126,5284,5284,5350,5396,5278,5366,5340,82,56,44,2349640,16
2245,p1504,20141126,5296,5296,5350,5368,5326,5360,5346,64,50,24,1283480,10
2401,p1505,20141126,5318,5308,5338,5350,5302,5306,5328,-2,20,649236,34595165160,378394
2537,p1506,20141126,5316,5296,5366,5374,5344,5348,5358,52,62,12,643080,18
2653,p1507,20141126,5376,5376,0,0,0,5376,5376,0,0,0,0,6
2746,p1508,20141126,5340,5340,0,0,0,5340,5340,0,0,0,0,2
2818,p1509,20141126,5370,5362,5398,5398,5356,5360,5372,-2,10,23204,1246730520,43760
2869,p1510,20141126,5342,5392,5422,5422,5416,5416,5418,24,26,4,216760,2
2902,p1511,20141126,5412,5412,0,0,0,5412,5412,0,0,0,0,0
1435,p1412,20141127,5202,5202,0,0,0,5202,5202,0,0,0,0,0
1657,p1501,20141127,5216,5230,5230,5240,5182,5234,5218,4,-12,58700,3063548200,118170
1871,p1502,20141127,5286,5272,5236,5236,5230,5230,5232,-42,-40,16,837160,10
2069,p1503,20141127,5366,5340,5332,5332,5332,5332,5332,-8,-8,2,106640,16
2246,p1504,20141127,5360,5346,0,0,0,5346,5346,0,0,0,0,10
2402,p1505,20141127,5306,5328,5330,5338,5278,5334,5314,6,-14,694232,36903537400,357404
2538,p1506,20141127,5348,5358,5326,5372,5292,5336,5332,-22,-26,118,6294080,12
2654,p1507,20141127,5376,5376,0,0,0,5376,5376,0,0,0,0,6
2747,p1508,20141127,5340,5340,0,0,0,5358,5358,18,18,0,0,2
2819,p1509,20141127,5360,5372,5376,5384,5326,5376,5358,4,-14,26238,1406275280,46602
2870,p1510,20141127,5416,5418,0,0,0,5404,5404,-14,-14,0,0,2
2903,p1511,20141127,5412,5412,0,0,0,5404,5404,-8,-8,0,0,0
1436,p1412,20141128,5202,5202,0,0,0,5202,5202,0,0,0,0,0
1658,p1501,20141128,5234,5218,5210,5218,5112,5124,5148,-94,-70,92906,4783884040,110076
1872,p1502,20141128,5230,5232,5246,5246,5246,5246,5246,14,14,2,104920,8
2070,p1503,20141128,5332,5332,0,0,0,5244,5244,-88,-88,0,0,16
2247,p1504,20141128,5346,5346,5336,5336,5336,5336,5336,-10,-10,2,106720,10
2403,p1505,20141128,5334,5314,5308,5320,5196,5200,5252,-114,-62,1089450,57235696800,472464
2539,p1506,20141128,5336,5332,5316,5346,5200,5200,5278,-132,-54,46,2428400,20
2655,p1507,20141128,5376,5376,0,0,0,5376,5376,0,0,0,0,6
2748,p1508,20141128,5358,5358,0,0,0,5352,5352,-6,-6,0,0,2
2820,p1509,20141128,5376,5358,5352,5356,5246,5256,5292,-102,-66,46890,2481902720,42168
2871,p1510,20141128,5404,5404,0,0,0,5372,5372,-32,-32,0,0,2
2904,p1511,20141128,5404,5404,0,0,0,5284,5284,-120,-120,0,0,0
1437,p1412,20141201,5202,5202,0,0,0,5202,5202,0,0,0,0,0
1659,p1501,20141201,5124,5148,5142,5142,4944,4944,5036,-204,-112,91296,4599146280,106384
1873,p1502,20141201,5246,5246,5100,5146,5038,5038,5110,-208,-136,14,715480,6
2071,p1503,20141201,5244,5244,0,0,0,5110,5110,-134,-134,0,0,16
2248,p1504,20141201,5336,5336,5252,5252,5124,5124,5174,-212,-162,12,621080,18
2404,p1505,20141201,5200,5252,5208,5218,5042,5042,5148,-210,-104,919968,47376260400,458946
2540,p1506,20141201,5200,5278,5244,5244,5080,5080,5192,-198,-86,22,1142520,16
2656,p1507,20141201,5376,5376,0,0,0,5162,5162,-214,-214,0,0,6
2749,p1508,20141201,5352,5352,0,0,0,5266,5266,-86,-86,0,0,2
2821,p1509,20141201,5256,5292,5260,5270,5082,5082,5176,-210,-116,20970,1085538200,42458
2872,p1510,20141201,5372,5372,0,0,0,5256,5256,-116,-116,0,0,2
2905,p1511,20141201,5284,5284,5202,5202,4878,4922,5016,-362,-268,28,1404800,24
1438,p1412,20141202,5202,5202,0,0,0,5202,5202,0,0,0,0,0
1660,p1501,20141202,4944,5036,4962,5060,4962,4990,5008,-46,-28,94496,4733523440,86352
1874,p1502,20141202,5038,5110,5032,5102,5020,5102,5048,-8,-62,8,403880,6
2072,p1503,20141202,5110,5110,0,0,0,5050,5050,-60,-60,0,0,16
2249,p1504,20141202,5124,5174,5078,5140,5078,5140,5112,-34,-62,10,511360,10
2405,p1505,20141202,5042,5148,5060,5160,5030,5062,5076,-86,-72,1436244,72930458680,468622
2541,p1506,20141202,5080,5192,5088,5182,5088,5156,5126,-36,-66,26,1332760,18
2657,p1507,20141202,5162,5162,0,0,0,5162,5162,0,0,0,0,6
2750,p1508,20141202,5266,5266,0,0,0,5200,5200,-66,-66,0,0,2
2822,p1509,20141202,5082,5176,5092,5208,5088,5124,5136,-52,-40,34138,1753444960,40604
2873,p1510,20141202,5256,5256,5150,5220,5150,5220,5184,-36,-72,4,207400,2
2906,p1511,20141202,4922,5016,5082,5136,5052,5082,5102,66,86,36,1836920,26
1439,p1412,20141203,5202,5202,0,0,0,5202,5202,0,0,0,0,0
1661,p1501,20141203,4990,5008,4980,5034,4936,4990,4970,-18,-38,59240,2945333080,78268
1875,p1502,20141203,5102,5048,5102,5102,5000,5032,5044,-16,-4,126,6355600,6
2073,p1503,20141203,5050,5050,5062,5062,5028,5028,5044,-22,-6,4,201800,16
2250,p1504,20141203,5140,5112,5104,5104,5096,5096,5100,-16,-12,8,408000,10
2406,p1505,20141203,5062,5076,5050,5116,4980,5044,5046,-32,-30,1746002,88135697800,533298
2542,p1506,20141203,5156,5126,5060,5126,5054,5086,5110,-40,-16,142,7258520,124
2658,p1507,20141203,5162,5162,0,0,0,5162,5162,0,0,0,0,6
2751,p1508,20141203,5200,5200,0,0,0,5176,5176,-24,-24,0,0,2
2823,p1509,20141203,5124,5136,5130,5168,5032,5092,5084,-44,-52,56898,2892709200,44096
2874,p1510,20141203,5220,5184,0,0,0,5132,5132,-52,-52,0,0,2
2907,p1511,20141203,5082,5102,5120,5148,5052,5088,5092,-14,-10,26,1324040,14
1440,p1412,20141204,5202,5202,0,0,0,5202,5202,0,0,0,0,0
1662,p1501,20141204,4990,4970,5014,5014,4958,4982,4992,12,22,53638,2678357400,69000
1876,p1502,20141204,5032,5044,0,0,0,5044,5044,0,0,0,0,6
2074,p1503,20141204,5028,5044,5082,5082,5082,5082,5082,38,38,2,101640,16
2251,p1504,20141204,5096,5100,5084,5084,5084,5084,5084,-16,-16,2,101680,8
2407,p1505,20141204,5044,5046,5062,5084,5022,5038,5054,-8,8,1157050,58486097640,559908
2543,p1506,20141204,5086,5110,5144,5144,5064,5106,5104,-4,-6,14,714560,126
2659,p1507,20141204,5162,5162,0,0,0,5162,5162,0,0,0,0,6
2752,p1508,20141204,5176,5176,0,0,0,5170,5170,-6,-6,0,0,2
2824,p1509,20141204,5092,5084,5100,5132,5076,5090,5102,6,18,33422,1705294080,45296
2875,p1510,20141204,5132,5132,0,0,0,5132,5132,0,0,0,0,2
2908,p1511,20141204,5088,5092,5090,5124,5090,5124,5114,32,22,8,409120,16
1441,p1412,20141205,5202,5202,0,0,0,5202,5202,0,0,0,0,0
1663,p1501,20141205,4982,4992,4974,4998,4944,4994,4974,2,-18,37420,1861834880,64364
1877,p1502,20141205,5044,5044,5036,5036,5026,5028,5032,-16,-12,142,7145880,10
2075,p1503,20141205,5082,5082,5016,5074,5016,5068,5038,-14,-44,52,2620520,18
2252,p1504,20141205,5084,5084,0,0,0,5084,5084,0,0,0,0,8
2408,p1505,20141205,5038,5054,5020,5050,5002,5044,5028,-10,-26,1126866,56678407080,556656
2544,p1506,20141205,5106,5104,5076,5108,5076,5108,5092,4,-12,42,2139000,126
2660,p1507,20141205,5162,5162,0,0,0,5162,5162,0,0,0,0,6
2753,p1508,20141205,5170,5170,0,0,0,5158,5158,-12,-12,0,0,2
2825,p1509,20141205,5090,5102,5064,5102,5056,5096,5078,-6,-24,24920,1265635840,44326
2876,p1510,20141205,5132,5132,0,0,0,5108,5108,-24,-24,0,0,2
2909,p1511,20141205,5124,5114,5074,5074,5074,5074,5074,-40,-40,2,101480,16
1442,p1412,20141208,5202,5202,0,0,0,5202,5202,0,0,0,0,0
1664,p1501,20141208,4994,4974,4984,5020,4984,5002,5004,28,30,32054,1604274000,62490
1878,p1502,20141208,5028,5032,5028,5038,5028,5038,5030,6,-2,6,301880,4
2076,p1503,20141208,5068,5038,0,0,0,5036,5036,-2,-2,0,0,18
2253,p1504,20141208,5084,5084,5110,5110,4976,5082,5064,-2,-20,16,810360,10
2409,p1505,20141208,5044,5028,5046,5066,5034,5038,5050,10,22,892934,45099147560,546196
2545,p1506,20141208,5108,5092,5108,5142,5106,5138,5118,46,26,20,1023960,124
2661,p1507,20141208,5162,5162,0,0,0,5162,5162,0,0,0,0,6
2754,p1508,20141208,5158,5158,0,0,0,5154,5154,-4,-4,0,0,2
2826,p1509,20141208,5096,5078,5092,5124,5090,5092,5104,14,26,25454,1299672600,43340
2877,p1510,20141208,5108,5108,0,0,0,5108,5108,0,0,0,0,2
2910,p1511,20141208,5074,5074,5116,5116,5116,5116,5116,42,42,2,102320,14
1443,p1412,20141209,5202,5202,0,0,0,5202,5202,0,0,0,0,0
1665,p1501,20141209,5002,5004,4996,5010,4954,4972,4978,-32,-26,26412,1315110680,55594
1879,p1502,20141209,5038,5030,0,0,0,5030,5030,0,0,0,0,4
2077,p1503,20141209,5036,5036,0,0,0,5036,5036,0,0,0,0,18
2254,p1504,20141209,5082,5064,5032,5032,5032,5032,5032,-32,-32,2,100640,8
2410,p1505,20141209,5038,5050,5022,5030,4986,5010,5010,-40,-40,1046450,52439119240,525330
2546,p1506,20141209,5138,5118,5080,5092,5070,5070,5078,-48,-40,32,1625160,124
2662,p1507,20141209,5162,5162,0,0,0,5162,5162,0,0,0,0,6
2755,p1508,20141209,5154,5154,0,0,0,5154,5154,0,0,0,0,2
2827,p1509,20141209,5092,5104,5076,5084,5042,5062,5064,-42,-40,26474,1341040760,47684
2878,p1510,20141209,5108,5108,0,0,0,5108,5108,0,0,0,0,2
2911,p1511,20141209,5116,5116,5060,5080,5010,5060,5052,-56,-64,10,505240,14
1444,p1412,20141210,5202,5202,0,0,0,5202,5202,0,0,0,0,0
1666,p1501,20141210,4972,4978,4960,5032,4960,5024,5002,46,24,18728,937052200,53576
1880,p1502,20141210,5030,5030,5032,5124,5018,5018,5072,-12,42,14,710120,6
2078,p1503,20141210,5036,5036,5042,5084,5042,5084,5058,48,22,56,2833480,22
2255,p1504,20141210,5032,5032,5064,5064,5038,5038,5050,6,18,6,303080,4
2411,p1505,20141210,5010,5010,5002,5058,5002,5044,5036,34,26,1087636,54790144240,560520
2547,p1506,20141210,5070,5078,5098,5134,5090,5120,5110,42,32,38,1942400,120
2663,p1507,20141210,5162,5162,0,0,0,5162,5162,0,0,0,0,6
2756,p1508,20141210,5154,5154,0,0,0,5154,5154,0,0,0,0,2
2828,p1509,20141210,5062,5064,5064,5100,5054,5082,5078,18,14,39544,2008780720,55226
2879,p1510,20141210,5108,5108,0,0,0,5108,5108,0,0,0,0,2
2912,p1511,20141210,5060,5052,0,0,0,5062,5062,10,10,0,0,14
1445,p1412,20141211,5202,5202,0,0,0,5202,5202,0,0,0,0,0
1667,p1501,20141211,5024,5002,5028,5050,4980,4994,5002,-8,0,17668,884048000,47000
1881,p1502,20141211,5018,5072,0,0,0,5072,5072,0,0,0,0,6
2079,p1503,20141211,5084,5058,5088,5088,5088,5088,5088,30,30,2,101760,20
2256,p1504,20141211,5038,5050,0,0,0,5050,5050,0,0,0,0,4
2412,p1505,20141211,5044,5036,5048,5078,4990,4998,5030,-38,-6,1109528,55810230880,567164
2548,p1506,20141211,5120,5110,5144,5154,5068,5078,5116,-32,6,46,2353800,122
2664,p1507,20141211,5162,5162,0,0,0,5148,5148,-14,-14,0,0,6
2757,p1508,20141211,5154,5154,0,0,0,5154,5154,0,0,0,0,2
2829,p1509,20141211,5082,5078,5088,5116,5034,5044,5064,-34,-14,41138,2083716280,47588
2880,p1510,20141211,5108,5108,0,0,0,5108,5108,0,0,0,0,2
2913,p1511,20141211,5062,5062,0,0,0,5074,5074,12,12,0,0,14
1446,p1412,20141212,5202,5202,0,0,0,5202,5202,0,0,0,0,0
1668,p1501,20141212,4994,5002,5030,5030,4964,4976,5006,-26,4,18244,913334360,39862
1882,p1502,20141212,5072,5072,5026,5148,5024,5148,5086,76,14,8,406920,6
2080,p1503,20141212,5088,5088,5054,5054,5054,5054,5054,-34,-34,2,101080,18
2257,p1504,20141212,5050,5050,0,0,0,5050,5050,0,0,0,0,4
2413,p1505,20141212,4998,5030,5030,5054,5002,5010,5028,-20,-2,841794,42336106040,531804
2549,p1506,20141212,5078,5116,5110,5160,5094,5120,5112,4,-4,42,2147840,118
2665,p1507,20141212,5148,5148,0,0,0,5148,5148,0,0,0,0,6
2758,p1508,20141212,5154,5154,0,0,0,5124,5124,-30,-30,0,0,2
2830,p1509,20141212,5044,5064,5064,5100,5054,5060,5076,-4,12,27504,1396431680,46976
2881,p1510,20141212,5108,5108,0,0,0,5108,5108,0,0,0,0,2
2914,p1511,20141212,5074,5074,5138,5140,5138,5140,5138,66,64,4,205560,14
1669,p1501,20141215,4976,5006,4966,4988,4960,4962,4970,-44,-36,10554,524725080,34122
1883,p1502,20141215,5148,5086,0,0,0,5086,5086,0,0,0,0,6
2081,p1503,20141215,5054,5054,0,0,0,5018,5018,-36,-36,0,0,18
2258,p1504,20141215,5050,5050,0,0,0,5014,5014,-36,-36,0,0,4
2414,p1505,20141215,5010,5028,5004,5050,4992,5028,5016,0,-12,797124,39986219040,503922
2550,p1506,20141215,5120,5112,5090,5116,5090,5100,5104,-12,-8,42,2143720,118
2666,p1507,20141215,5148,5148,0,0,0,5148,5148,0,0,0,0,6
2759,p1508,20141215,5124,5124,5124,5124,5124,5124,5124,0,0,4,204960,6
2831,p1509,20141215,5060,5076,5062,5098,5050,5082,5074,6,-2,29534,1498559880,44272
2882,p1510,20141215,5108,5108,0,0,0,5108,5108,0,0,0,0,2
2915,p1511,20141215,5140,5138,0,0,0,5138,5138,0,0,0,0,14
2928,p1512,20141215,5064,5064,0,0,0,5064,5064,0,0,0,0,0
1670,p1501,20141216,4962,4970,4964,4972,4876,4880,4924,-90,-46,8856,436136840,29798
1884,p1502,20141216,5086,5086,0,0,0,5064,5064,-22,-22,0,0,6
2082,p1503,20141216,5018,5018,0,0,0,5018,5018,0,0,0,0,18
2259,p1504,20141216,5014,5014,0,0,0,4968,4968,-46,-46,0,0,4
2415,p1505,20141216,5028,5016,5022,5038,4948,4952,4988,-64,-28,831622,41491984080,577812
2551,p1506,20141216,5100,5104,5050,5134,5050,5068,5096,-36,-8,40,2038480,120
2667,p1507,20141216,5148,5148,0,0,0,5140,5140,-8,-8,0,0,6
2760,p1508,20141216,5124,5124,0,0,0,5104,5104,-20,-20,0,0,6
2832,p1509,20141216,5082,5074,5064,5086,5004,5014,5036,-60,-38,32416,1632888560,42302
2883,p1510,20141216,5108,5108,0,0,0,5070,5070,-38,-38,0,0,2
2916,p1511,20141216,5138,5138,0,0,0,5138,5138,0,0,0,0,14
2929,p1512,20141216,5064,5064,5000,5218,5000,5002,5060,-62,-4,8,404800,2
1671,p1501,20141217,4880,4924,4850,4888,4850,4866,4870,-58,-54,7622,371321240,25622
1885,p1502,20141217,5064,5064,0,0,0,5010,5010,-54,-54,0,0,6
2083,p1503,20141217,5018,5018,0,0,0,4964,4964,-54,-54,0,0,18
2260,p1504,20141217,4968,4968,5052,5060,4962,4962,5008,-6,40,16,801280,4
2416,p1505,20141217,4952,4988,4928,4976,4920,4940,4946,-48,-42,698988,34572627960,557568
2552,p1506,20141217,5068,5096,4948,5074,4948,5008,5026,-88,-70,50,2513560,122
2668,p1507,20141217,5140,5140,0,0,0,5070,5070,-70,-70,0,0,6
2761,p1508,20141217,5104,5104,0,0,0,5034,5034,-70,-70,0,0,6
2833,p1509,20141217,5014,5036,4996,5030,4976,4990,4998,-46,-38,49010,2449780960,42204
2884,p1510,20141217,5070,5070,0,0,0,5032,5032,-38,-38,0,0,2
2917,p1511,20141217,5138,5138,5066,5066,5066,5066,5066,-72,-72,8,405280,14
2930,p1512,20141217,5002,5060,0,0,0,4990,4990,-70,-70,0,0,2
1672,p1501,20141218,4866,4870,4868,4876,4790,4794,4830,-76,-40,11274,544714160,23540
1886,p1502,20141218,5010,5010,4974,4974,4898,4898,4936,-112,-74,4,197440,6
2084,p1503,20141218,4964,4964,4936,4950,4936,4950,4942,-14,-22,4,197720,14
2261,p1504,20141218,4962,5008,0,0,0,5006,5006,-2,-2,0,0,4
2417,p1505,20141218,4940,4946,4940,4970,4892,4926,4926,-20,-20,801738,39503778360,550182
2553,p1506,20141218,5008,5026,5034,5056,4990,5042,5026,16,0,82,4122280,116
2669,p1507,20141218,5070,5070,0,0,0,5070,5070,0,0,0,0,6
2762,p1508,20141218,5034,5034,4940,4940,4940,4940,4940,-94,-94,4,197600,4
2834,p1509,20141218,4990,4998,4992,5030,4944,4978,4986,-20,-12,61948,3089160320,52872
2885,p1510,20141218,5032,5032,0,0,0,5032,5032,0,0,0,0,2
2918,p1511,20141218,5066,5066,5038,5040,5038,5040,5038,-26,-28,6,302320,14
2931,p1512,20141218,4990,4990,5004,5006,5000,5000,5002,10,12,6,300200,2
1673,p1501,20141219,4794,4830,4820,4838,4646,4750,4714,-80,-116,14854,700403560,21072
1887,p1502,20141219,4898,4936,0,0,0,4818,4818,-118,-118,0,0,6
2085,p1503,20141219,4950,4942,0,0,0,4942,4942,0,0,0,0,14
2262,p1504,20141219,5006,5006,0,0,0,5006,5006,0,0,0,0,4
2418,p1505,20141219,4926,4926,4950,4974,4898,4912,4930,-14,4,606440,29902073440,552678
2554,p1506,20141219,5042,5026,5042,5060,5016,5030,5040,4,14,62,3125960,114
2670,p1507,20141219,5070,5070,0,0,0,5060,5060,-10,-10,0,0,6
2763,p1508,20141219,4940,4940,0,0,0,4940,4940,0,0,0,0,4
2835,p1509,20141219,4978,4986,5010,5024,4954,4966,4978,-20,-8,30634,1525305880,53558
2886,p1510,20141219,5032,5032,5076,5076,5024,5034,5044,2,12,18,908160,2
2919,p1511,20141219,5040,5038,0,0,0,5038,5038,0,0,0,0,14
2932,p1512,20141219,5000,5002,0,0,0,5012,5012,10,10,0,0,2
1674,p1501,20141222,4750,4714,4760,4766,4704,4752,4742,38,28,3854,182823560,20360
1888,p1502,20141222,4818,4818,0,0,0,4818,4818,0,0,0,0,6
2086,p1503,20141222,4942,4942,0,0,0,4970,4970,28,28,0,0,14
2263,p1504,20141222,5006,5006,0,0,0,5006,5006,0,0,0,0,4
2419,p1505,20141222,4912,4930,4924,4958,4912,4950,4934,20,4,581946,28718584880,540952
2555,p1506,20141222,5030,5040,5026,5050,5026,5046,5040,6,0,10,504160,114
2671,p1507,20141222,5060,5060,0,0,0,5060,5060,0,0,0,0,6
2764,p1508,20141222,4940,4940,0,0,0,4940,4940,0,0,0,0,4
2836,p1509,20141222,4966,4978,4978,5014,4970,5004,4992,26,14,48068,2399733200,58464
2887,p1510,20141222,5034,5044,0,0,0,5044,5044,0,0,0,0,2
2920,p1511,20141222,5038,5038,0,0,0,5052,5052,14,14,0,0,14
2933,p1512,20141222,5012,5012,0,0,0,5012,5012,0,0,0,0,2
1675,p1501,20141223,4752,4742,4738,4748,4702,4730,4730,-12,-12,5406,255732680,20454
1889,p1502,20141223,4818,4818,0,0,0,4818,4818,0,0,0,0,6
2087,p1503,20141223,4970,4970,0,0,0,4958,4958,-12,-12,0,0,14
2264,p1504,20141223,5006,5006,4942,4942,4942,4942,4942,-64,-64,8,395360,8
2420,p1505,20141223,4950,4934,4950,4950,4916,4924,4930,-10,-4,385620,19016982840,550616
2556,p1506,20141223,5046,5040,5030,5030,5030,5030,5030,-10,-10,4,201200,114
2672,p1507,20141223,5060,5060,5040,5082,4920,4976,4988,-84,-72,18,898000,10
2765,p1508,20141223,4940,4940,0,0,0,4940,4940,0,0,0,0,4
2837,p1509,20141223,5004,4992,5000,5008,4974,4994,4992,2,0,30304,1513059680,59724
2888,p1510,20141223,5044,5044,0,0,0,5044,5044,0,0,0,0,2
2921,p1511,20141223,5052,5052,0,0,0,5052,5052,0,0,0,0,14
2934,p1512,20141223,5012,5012,0,0,0,5012,5012,0,0,0,0,2
1676,p1501,20141224,4730,4730,4748,4754,4724,4750,4736,20,6,2328,110254440,20420
1890,p1502,20141224,4818,4818,0,0,0,4824,4824,6,6,0,0,6
2088,p1503,20141224,4958,4958,0,0,0,4964,4964,6,6,0,0,14
2265,p1504,20141224,4942,4942,0,0,0,4948,4948,6,6,0,0,8
2421,p1505,20141224,4924,4930,4938,4966,4918,4930,4940,0,10,587818,29046561800,561390
2557,p1506,20141224,5030,5030,5046,5058,5026,5046,5046,16,16,42,2119440,114
2673,p1507,20141224,4976,4988,0,0,0,4988,4988,0,0,0,0,10
2766,p1508,20141224,4940,4940,5038,5038,4922,4986,4982,46,42,6,298920,4
2838,p1509,20141224,4994,4992,5010,5030,4996,5000,5008,8,16,44896,2249168920,65350
2889,p1510,20141224,5044,5044,0,0,0,5060,5060,16,16,0,0,2
2922,p1511,20141224,5052,5052,0,0,0,5052,5052,0,0,0,0,14
2935,p1512,20141224,5012,5012,0,0,0,5028,5028,16,16,0,0,2
1677,p1501,20141225,4750,4736,4730,4770,4724,4758,4752,22,16,2360,112160800,19318
1891,p1502,20141225,4824,4824,0,0,0,4840,4840,16,16,0,0,6
2089,p1503,20141225,4964,4964,5014,5014,4946,4946,4980,-18,16,4,199200,14
2266,p1504,20141225,4948,4948,0,0,0,4948,4948,0,0,0,0,8
2422,p1505,20141225,4930,4940,4922,4946,4920,4934,4932,-6,-8,246104,12138099920,546662
2558,p1506,20141225,5046,5046,5042,5054,5042,5052,5048,6,2,6,302960,114
2674,p1507,20141225,4988,4988,0,0,0,4988,4988,0,0,0,0,10
2767,p1508,20141225,4986,4982,0,0,0,4982,4982,0,0,0,0,4
2839,p1509,20141225,5000,5008,4992,5010,4988,5000,4998,-8,-10,28420,1420662600,71252
2890,p1510,20141225,5060,5060,0,0,0,5060,5060,0,0,0,0,2
2923,p1511,20141225,5052,5052,0,0,0,5052,5052,0,0,0,0,14
2936,p1512,20141225,5028,5028,5054,5068,5054,5068,5060,40,32,20,1012200,2
1678,p1501,20141226,4758,4752,4768,4798,4746,4782,4772,30,20,3048,145472360,17000
1892,p1502,20141226,4840,4840,5032,5032,4728,4920,4950,80,110,16,792240,8
2090,p1503,20141226,4946,4980,0,0,0,4980,4980,0,0,0,0,14
2267,p1504,20141226,4948,4948,0,0,0,5060,5060,112,112,0,0,8
2423,p1505,20141226,4934,4932,4938,4956,4926,4932,4942,0,10,263076,13001419640,548274
2559,p1506,20141226,5052,5048,5054,5078,5040,5078,5056,30,8,32,1618280,114
2675,p1507,20141226,4988,4988,0,0,0,4988,4988,0,0,0,0,10
2768,p1508,20141226,4982,4982,0,0,0,4982,4982,0,0,0,0,4
2840,p1509,20141226,5000,4998,5000,5020,4994,5000,5006,2,8,10744,538029480,70800
2891,p1510,20141226,5060,5060,0,0,0,5060,5060,0,0,0,0,2
2924,p1511,20141226,5052,5052,0,0,0,5052,5052,0,0,0,0,14
2937,p1512,20141226,5068,5060,0,0,0,5060,5060,0,0,0,0,2
1679,p1501,20141229,4782,4772,4844,4888,4750,4888,4846,116,74,4518,218998040,16542
1893,p1502,20141229,4920,4950,4966,4966,4966,4966,4966,16,16,2,99320,6
2091,p1503,20141229,4980,4980,5138,5138,5000,5026,5054,46,74,6,303280,14
2268,p1504,20141229,5060,5060,0,0,0,5060,5060,0,0,0,0,8
2424,p1505,20141229,4932,4942,4952,5100,4944,5062,5030,120,88,873286,43931642160,553036
2560,p1506,20141229,5078,5056,5066,5196,5056,5138,5150,82,94,168,8655040,74
2676,p1507,20141229,4988,4988,0,0,0,5090,5090,102,102,0,0,10
2769,p1508,20141229,4982,4982,0,0,0,5096,5096,114,114,0,0,4
2841,p1509,20141229,5000,5006,5020,5166,5012,5136,5104,130,98,42652,2177038200,70536
2892,p1510,20141229,5060,5060,0,0,0,5092,5092,32,32,0,0,2
2925,p1511,20141229,5052,5052,5124,5176,5124,5176,5158,124,106,6,309520,12
2938,p1512,20141229,5060,5060,0,0,0,5124,5124,64,64,0,0,2
1680,p1501,20141230,4888,4846,4848,4908,4844,4876,4876,30,30,2432,118628680,16172
1894,p1502,20141230,4966,4966,0,0,0,4996,4996,30,30,0,0,6
2092,p1503,20141230,5026,5054,0,0,0,5084,5084,30,30,0,0,14
2269,p1504,20141230,5060,5060,5058,5058,5058,5058,5058,-2,-2,2,101160,8
2425,p1505,20141230,5062,5030,5066,5130,5046,5082,5078,52,48,580278,29473664120,541736
2561,p1506,20141230,5138,5150,5054,5150,5054,5114,5104,-36,-46,84,4288480,30
2677,p1507,20141230,5090,5090,0,0,0,5094,5094,4,4,0,0,10
2770,p1508,20141230,5096,5096,0,0,0,5096,5096,0,0,0,0,4
2842,p1509,20141230,5136,5104,5122,5208,5100,5154,5146,50,42,38662,1990027760,67570
2893,p1510,20141230,5092,5092,0,0,0,5092,5092,0,0,0,0,2
2926,p1511,20141230,5176,5158,5162,5162,5162,5162,5162,4,4,2,103240,10
2939,p1512,20141230,5124,5124,0,0,0,5126,5126,2,2,0,0,2
1681,p1501,20141231,4876,4876,4850,4898,4822,4898,4852,22,-24,2384,115698680,15256
1895,p1502,20141231,4996,4996,4996,4996,4996,4996,4996,0,0,2,99920,6
2093,p1503,20141231,5084,5084,0,0,0,5084,5084,0,0,0,0,14
2270,p1504,20141231,5058,5058,5184,5184,5086,5086,5134,28,76,8,410800,8
2426,p1505,20141231,5082,5078,5068,5098,5052,5078,5074,0,-4,382500,19408531120,525976
2562,p1506,20141231,5114,5104,5120,5138,5100,5100,5116,-4,12,12,614120,28
2678,p1507,20141231,5094,5094,0,0,0,5094,5094,0,0,0,0,10
2771,p1508,20141231,5096,5096,0,0,0,5096,5096,0,0,0,0,4
2843,p1509,20141231,5154,5146,5146,5168,5122,5152,5140,6,-6,24312,1250035280,68528
2894,p1510,20141231,5092,5092,0,0,0,5092,5092,0,0,0,0,2
2927,p1511,20141231,5162,5162,5172,5172,5172,5172,5172,10,10,2,103440,10
2940,p1512,20141231,5126,5126,0,0,0,5134,5134,8,8,0,0,2
